id	chr	start	end	len	strand	count
AT1G01010	1	3630	5899	2269	+	67
AT1G01020	1	5927	8737	2810	-	291
AT1G01030	1	11648	13714	2066	-	140
AT1G01040	1	23145	31227	8082	+	1385
AT1G01046	1	28499	28706	207	+	20
AT1G01050	1	31169	33153	1984	-	1766
AT1G01060	1	33378	37871	4493	-	1431
AT1G01070	1	38751	40944	2193	-	239
AT1G01073	1	44676	44787	111	+	0
AT1G01080	1	45295	47019	1724	-	2407
AT1G01090	1	47484	49286	1802	-	3762
AT1G01100	1	50074	51199	1125	-	3831
AT1G01110	1	52238	54692	2454	+	92
AT1G01115	1	56623	56740	117	+	0
AT1G01120	1	57268	59167	1899	-	1458
AT1G01130	1	61904	63811	1907	-	16
AT1G01140	1	64165	67625	3460	-	1720
AT1G01150	1	70114	72138	2024	-	4
AT1G01160	1	72338	74096	1758	+	517
AT1G01170	1	73930	74737	807	-	1001
AT1G01180	1	75582	76758	1176	+	217
AT1G01183	1	78931	79032	101	-	0
AT1G01190	1	83044	84864	1820	-	152
AT1G01200	1	86514	88213	1699	-	46
AT1G01210	1	88897	89745	848	+	131
AT1G01220	1	91375	95651	4276	+	811
AT1G01225	1	95986	97407	1421	+	81
AT1G01230	1	97455	99240	1785	+	393
AT1G01240	1	99893	101834	1941	+	693
AT1G01250	1	104490	105330	840	-	121
AT1G01260	1	108945	111609	2664	+	305
AT1G01270	1	111889	111961	72	-	0
AT1G01280	1	112262	113947	1685	+	0
AT1G01290	1	114285	116108	1823	+	336
AT1G01300	1	116942	118764	1822	+	863
AT1G01305	1	119396	119997	601	+	0
AT1G01310	1	120153	121130	977	+	1
AT1G01320	1	121066	130577	9511	-	13280
AT1G01340	1	132327	135831	3504	-	70
AT1G01350	1	136123	138162	2039	+	236
AT1G01355	1	138512	139568	1056	+	3
AT1G01360	1	141970	143183	1213	+	296
AT1G01370	1	143563	145684	2121	+	122
AT1G01380	1	147152	147942	790	+	20
AT1G01390	1	148119	149806	1687	-	400
AT1G01400	1	150688	152210	1522	-	0
AT1G01410	1	153112	154198	1086	+	0
AT1G01420	1	154491	156011	1520	-	281
AT1G01430	1	156800	158655	1855	-	1214
AT1G01440	1	159855	162572	2717	-	410
AT1G01448	1	163418	166239	2821	+	122
AT1G01450	1	164104	165517	1413	-	0
AT1G01453	1	166588	167842	1254	-	0
AT1G01460	1	168722	171165	2443	+	0
AT1G01470	1	172145	172948	803	-	1326
AT1G01471	1	173250	173466	216	+	0
AT1G01480	1	175781	178400	2619	+	1
AT1G01490	1	180058	182358	2300	-	1286
AT1G01500	1	185132	186923	1791	+	414
AT1G01510	1	187210	190056	2846	+	754
AT1G01520	1	190595	192139	1544	+	207
AT1G01530	1	192639	193670	1031	-	1
AT1G01540	1	195779	198684	2905	+	1907
AT1G01550	1	199638	201775	2137	+	2724
AT1G01560	1	202135	204335	2200	+	24
AT1G01570	1	205175	207435	2260	+	36
AT1G01580	1	209394	213041	3647	+	70
AT1G01590	1	214228	217304	3076	+	13
AT1G01600	1	218993	221286	2293	+	129
AT1G01610	1	221690	224340	2650	-	964
AT1G01620	1	225664	227302	1638	-	6810
AT1G01630	1	229012	230917	1905	+	1264
AT1G01640	1	230993	232508	1515	-	12
AT1G01650	1	232840	237817	4977	-	436
AT1G01660	1	240056	242608	2552	-	24
AT1G01670	1	242842	245988	3146	-	34
AT1G01680	1	246410	248367	1957	-	32
AT1G01690	1	249140	252462	3322	+	136
AT1G01695	1	252946	254495	1549	+	14
AT1G01700	1	259494	261474	1980	-	59
AT1G01710	1	262827	267771	4944	+	881
AT1G01720	1	268329	269819	1490	+	228
AT1G01725	1	269791	270775	984	-	120
AT1G01730	1	270955	272061	1106	+	245
AT1G01740	1	272110	274569	2459	-	204
AT1G01750	1	275365	276310	945	+	31
AT1G01760	1	276265	278448	2183	-	100
AT1G01770	1	278614	282891	4277	+	466
AT1G01780	1	282760	284245	1485	+	199
AT1G01790	1	284609	291094	6485	+	9132
AT1G01800	1	293341	295040	1699	+	1357
AT1G01810	1	295220	295859	639	+	7
AT1G01820	1	296000	298120	2120	-	650
AT1G01830	1	298534	302315	3781	-	529
AT1G01840	1	303536	304358	822	+	31
AT1G01860	1	304132	306287	2155	-	316
AT1G01870	1	306383	306456	73	+	0
AT1G01880	1	306479	309109	2630	-	37
AT1G01890	1	309274	309347	73	-	0
AT1G01900	1	310315	313130	2815	+	280
AT1G01910	1	313100	315902	2802	-	815
AT1G01920	1	316127	319650	3523	+	268
AT1G01930	1	319835	322860	3025	-	317
AT1G01940	1	323026	324917	1891	+	170
AT1G01950	1	325378	330619	5241	+	559
AT1G01960	1	330587	337582	6995	-	2171
AT1G01970	1	338290	340077	1787	+	996
AT1G01980	1	340171	341999	1828	-	0
AT1G01990	1	343165	344341	1176	-	358
AT1G02000	1	345811	347592	1781	+	235
AT1G02010	1	347890	352480	4590	+	407
AT1G02020	1	352636	354969	2333	-	420
AT1G02030	1	355320	357258	1938	-	2
AT1G02040	1	358103	359078	975	-	0
AT1G02050	1	359116	360518	1402	-	90
AT1G02060	1	360917	363094	2177	-	102
AT1G02065	1	365208	367340	2132	+	22
AT1G02070	1	370256	370967	711	-	3
AT1G02074	1	372063	372210	147	+	0
AT1G02080	1	373334	386847	13513	+	3251
AT1G02090	1	387276	389647	2371	-	594
AT1G02100	1	389811	392816	3005	+	598
AT1G02110	1	392830	395528	2698	+	549
AT1G02120	1	395760	399897	4137	+	1580
AT1G02130	1	400034	401882	1848	-	946
AT1G02136	1	402692	402961	269	-	0
AT1G02140	1	403189	404456	1267	-	1786
AT1G02145	1	404599	408619	4020	+	560
AT1G02150	1	408621	410611	1990	+	2831
AT1G02160	1	410747	411597	850	+	334
AT1G02170	1	411778	413554	1776	+	536
AT1G02180	1	413521	414645	1124	-	150
AT1G02190	1	415078	418010	2932	+	5
AT1G02205	1	418747	422438	3691	+	2870
AT1G02210	1	427547	427811	264	-	0
AT1G02220	1	428813	430647	1834	-	104
AT1G02228	1	433030	433819	789	-	0
AT1G02230	1	435173	436776	1603	-	9
AT1G02250	1	437950	439559	1609	-	0
AT1G02260	1	440440	442877	2437	-	289
AT1G02270	1	443148	446235	3087	-	673
AT1G02280	1	448462	450426	1964	-	1537
AT1G02290	1	450526	452737	2211	-	233
AT1G02300	1	453287	455463	2176	+	507
AT1G02305	1	455687	458164	2477	+	1529
AT1G02310	1	458132	460696	2564	-	1
AT1G02320	1	461827	461974	147	+	0
AT1G02330	1	462074	463612	1538	-	389
AT1G02335	1	463854	464924	1070	-	409
AT1G02340	1	465717	467844	2127	-	49
AT1G02350	1	469817	470693	876	+	46
AT1G02360	1	471989	473160	1171	-	21
AT1G02370	1	474499	476511	2012	+	96
AT1G02380	1	476999	478971	1972	+	77
AT1G02390	1	480851	483292	2441	+	91
AT1G02391	1	483763	483919	156	-	0
AT1G02400	1	486800	489577	2777	+	14
AT1G02405	1	489978	490505	527	-	2
AT1G02410	1	490924	492926	2002	+	422
AT1G02420	1	493682	495158	1476	+	71
AT1G02430	1	495049	496062	1013	-	22
AT1G02440	1	496585	497479	894	-	2
AT1G02450	1	497975	498516	541	-	7
AT1G02460	1	504672	507204	2532	-	66
AT1G02470	1	511764	513624	1860	-	19
AT1G02475	1	513842	515404	1562	-	1415
AT1G02480	1	515493	515566	73	+	0
AT1G02490	1	516617	516734	117	+	2
AT1G02500	1	518250	520437	2187	+	4184
AT1G02510	1	520497	521668	1171	-	0
AT1G02520	1	523650	528745	5095	+	10
AT1G02530	1	529794	534677	4883	+	4
AT1G02540	1	534826	535699	873	-	0
AT1G02550	1	536482	537211	729	+	0
AT1G02560	1	537859	540109	2250	+	6923
AT1G02570	1	541334	542240	906	+	0
AT1G02575	1	543109	544007	898	+	0
AT1G02580	1	544782	549202	4420	+	1
AT1G02590	1	552137	552761	624	-	0
AT1G02600	1	552639	552711	72	+	0
AT1G02610	1	553049	555994	2945	-	38
AT1G02620	1	557091	557986	895	+	0
AT1G02630	1	560609	562424	1815	-	20
AT1G02640	1	564204	567769	3565	+	254
AT1G02650	1	568703	570418	1715	+	14
AT1G02660	1	571954	574981	3027	-	111
AT1G02670	1	576045	580299	4254	+	37
AT1G02680	1	580624	582310	1686	+	206
AT1G02681	1	582412	582922	510	+	0
AT1G02690	1	584259	587219	2960	+	268
AT1G02700	1	588328	589480	1152	+	31
AT1G02710	1	589705	589996	291	-	40
AT1G02720	1	591825	594236	2411	+	257
AT1G02730	1	594572	598657	4085	-	952
AT1G02740	1	599415	602038	2623	-	145
AT1G02750	1	602496	604292	1796	+	170
AT1G02760	1	604401	604474	73	+	0
AT1G02770	1	604872	606693	1821	-	10
AT1G02780	1	607807	609465	1658	-	10552
AT1G02790	1	610390	612324	1934	-	0
AT1G02800	1	613215	616191	2976	-	142
AT1G02810	1	618264	620480	2216	+	10
AT1G02813	1	620677	621289	612	+	0
AT1G02816	1	621460	622469	1009	+	224
AT1G02820	1	623764	624475	711	-	1167
AT1G02830	1	625144	625608	464	-	0
AT1G02840	1	626740	629819	3079	+	1780
AT1G02850	1	630504	633259	2755	+	35
AT1G02860	1	635143	637262	2119	+	185
AT1G02870	1	637213	638677	1464	-	174
AT1G02880	1	642751	644903	2152	-	284
AT1G02890	1	645091	651907	6816	-	1909
AT1G02900	1	653764	654343	579	-	20
AT1G02910	1	655576	658148	2572	-	1698
AT1G02920	1	658656	659771	1115	-	111
AT1G02930	1	661176	662456	1280	-	584
AT1G02940	1	663078	664128	1050	-	2
AT1G02950	1	665151	666452	1301	-	127
AT1G02952	1	665353	666367	1014	+	0
AT1G02960	1	666871	669837	2966	-	493
AT1G02965	1	671660	672814	1154	-	0
AT1G02970	1	673305	676378	3073	+	95
AT1G02980	1	677868	681310	3442	+	0
AT1G02990	1	681395	687315	5920	-	613
AT1G03000	1	687889	692560	4671	-	780
AT1G03010	1	693479	696382	2903	+	8
AT1G03020	1	698206	698515	309	-	3
AT1G03022	1	699120	699246	126	+	0
AT1G03030	1	701477	703864	2387	+	377
AT1G03040	1	703905	706631	2726	-	802
AT1G03050	1	707725	710041	2316	+	0
AT1G03055	1	710017	711803	1786	-	340
AT1G03060	1	712472	726891	14419	-	1608
AT1G03070	1	729900	731557	1657	+	34
AT1G03080	1	731610	738056	6446	-	1782
AT1G03090	1	739678	744184	4506	+	773
AT1G03100	1	743884	746479	2595	-	40
AT1G03103	1	747196	748057	861	+	0
AT1G03106	1	748101	749034	933	-	1
AT1G03110	1	749245	751963	2718	+	244
AT1G03120	1	752270	753140	870	+	5
AT1G03130	1	753306	754198	892	-	35406
AT1G03140	1	754370	756303	1933	-	866
AT1G03150	1	756413	758612	2199	+	370
AT1G03160	1	761281	766158	4877	+	1920
AT1G03170	1	769631	770684	1053	+	9
AT1G03180	1	773410	775344	1934	+	60
AT1G03190	1	775526	780062	4536	+	261
AT1G03200	1	780601	781285	684	+	42
AT1G03210	1	782947	784240	1293	+	187
AT1G03220	1	787121	788651	1530	+	422
AT1G03230	1	790090	791592	1502	+	162
AT1G03240	1	792221	792986	765	-	5
AT1G03250	1	793352	795376	2024	-	595
AT1G03260	1	795531	798463	2932	-	168
AT1G03270	1	799190	802436	3246	+	132
AT1G03280	1	803034	807066	4032	+	693
AT1G03290	1	807360	810868	3508	+	594
AT1G03300	1	811032	813086	2054	-	155
AT1G03310	1	813470	816749	3279	+	2810
AT1G03320	1	817026	817767	741	+	14
AT1G03330	1	817982	819563	1581	-	485
AT1G03340	1	819661	821317	1656	+	85
AT1G03350	1	822637	824393	1756	-	766
AT1G03360	1	824536	826358	1822	+	160
AT1G03365	1	826568	830383	3815	+	490
AT1G03370	1	830626	835361	4735	+	545
AT1G03380	1	835784	840940	5156	+	1323
AT1G03390	1	841032	842418	1386	-	2
AT1G03400	1	842746	844190	1444	-	861
AT1G03410	1	844435	847683	3248	-	179
AT1G03420	1	846663	847739	1076	+	1
AT1G03430	1	847872	849500	1628	+	452
AT1G03440	1	852365	854032	1667	+	550
AT1G03445	1	854409	859701	5292	-	0
AT1G03457	1	860787	864125	3338	-	130
AT1G03470	1	865914	867733	1819	-	83
AT1G03475	1	869050	871211	2161	-	4872
AT1G03490	1	871873	872906	1033	+	0
AT1G03495	1	873183	874935	1752	+	76
AT1G03502	1	875357	875471	114	-	10
AT1G03506	1	875517	875604	87	-	2
AT1G03510	1	876257	877547	1290	-	17
AT1G03515	1	877647	877719	72	+	0
AT1G03520	1	877861	880158	2297	-	309
AT1G03530	1	880495	883391	2896	-	169
AT1G03540	1	883781	885611	1830	+	49
AT1G03545	1	885940	887906	1966	+	8
AT1G03550	1	885622	887956	2334	-	88
AT1G03560	1	890155	892410	2255	-	207
AT1G03570	1	892513	892585	72	+	0
AT1G03580	1	892846	894052	1206	+	5
AT1G03590	1	894253	897518	3265	-	390
AT1G03600	1	898875	899655	780	+	13474
AT1G03610	1	900886	903003	2117	+	766
AT1G03620	1	904318	906186	1868	-	9
AT1G03630	1	907641	909376	1735	+	10338
AT1G03640	1	909810	909883	73	-	0
AT1G03650	1	910022	911193	1171	-	12
AT1G03660	1	911435	911759	324	-	11
AT1G03670	1	914221	916222	2001	-	0
AT1G03680	1	916818	918064	1246	-	9018
AT1G03687	1	918298	920507	2209	+	341
AT1G03700	1	920949	921901	952	+	0
AT1G03710	1	923425	924726	1301	+	17
AT1G03720	1	924995	926373	1378	-	0
AT1G03730	1	930827	931895	1068	-	69
AT1G03740	1	933511	937043	3532	+	525
AT1G03743	1	937206	937287	81	-	0
AT1G03746	1	937400	937485	85	-	0
AT1G03750	1	937919	941162	3243	+	142
AT1G03760	1	941061	943377	2316	-	108
AT1G03770	1	944571	947483	2912	+	92
AT1G03780	1	947519	951827	4308	-	296
AT1G03790	1	954524	956097	1573	+	0
AT1G03800	1	957260	957998	738	-	8
AT1G03810	1	958758	959609	851	+	0
AT1G03820	1	959868	960728	860	-	199
AT1G03830	1	962015	966757	4742	-	227
AT1G03840	1	967502	970130	2628	-	22
AT1G03850	1	976096	977761	1665	-	34
AT1G03860	1	979307	981885	2578	-	924
AT1G03870	1	982505	983540	1035	-	855
AT1G03880	1	985750	988146	2396	+	0
AT1G03890	1	989197	991020	1823	+	0
AT1G03900	1	991138	993118	1980	+	1105
AT1G03905	1	993399	995784	2385	+	42
AT1G03910	1	996114	1000437	4323	+	917
AT1G03920	1	1001320	1004383	3063	+	43
AT1G03930	1	1004768	1008370	3602	+	1267
AT1G03935	1	1008809	1008896	87	+	11
AT1G03940	1	1009541	1011056	1515	-	99
AT1G03950	1	1011171	1013365	2194	-	280
AT1G03960	1	1013714	1017929	4215	+	216
AT1G03970	1	1018099	1019247	1148	+	131
AT1G03980	1	1018569	1022108	3539	-	9
AT1G03982	1	1022250	1023719	1469	-	0
AT1G03990	1	1024846	1027616	2770	+	92
AT1G04000	1	1028105	1029119	1014	-	236
AT1G04010	1	1031199	1036237	5038	-	240
AT1G04020	1	1036536	1040224	3688	+	336
AT1G04030	1	1040382	1042892	2510	+	74
AT1G04040	1	1042361	1043864	1503	-	943
AT1G04050	1	1045597	1049297	3700	-	97
AT1G04070	1	1050552	1051186	634	-	76
AT1G04080	1	1051311	1056827	5516	+	2156
AT1G04090	1	1057150	1059419	2269	+	18
AT1G04100	1	1059505	1061191	1686	+	126
AT1G04110	1	1061456	1063784	2328	-	162
AT1G04120	1	1064449	1071047	6598	-	1786
AT1G04130	1	1073426	1075568	2142	+	239
AT1G04140	1	1075542	1080630	5088	-	1723
AT1G04150	1	1081207	1084246	3039	-	2
AT1G04160	1	1086494	1096146	9652	+	409
AT1G04170	1	1096945	1099898	2953	+	1894
AT1G04171	1	1100443	1100608	165	-	0
AT1G04180	1	1104622	1105988	1366	+	1
AT1G04190	1	1106427	1108715	2288	-	472
AT1G04200	1	1109481	1114107	4626	+	623
AT1G04210	1	1114404	1119739	5335	+	1116
AT1G04220	1	1119698	1122526	2828	-	155
AT1G04230	1	1125517	1128168	2651	+	224
AT1G04240	1	1128187	1129551	1364	-	946
AT1G04250	1	1136257	1138613	2356	+	1939
AT1G04260	1	1140527	1141365	838	-	144
AT1G04270	1	1141603	1143053	1450	-	5093
AT1G04280	1	1143435	1146654	3219	-	355
AT1G04290	1	1147522	1148533	1011	-	69
AT1G04295	1	1147780	1148435	655	+	2
AT1G04300	1	1148596	1154652	6056	-	1362
AT1G04310	1	1154763	1157711	2948	-	70
AT1G04320	1	1159022	1159093	71	+	0
AT1G04330	1	1161310	1161982	672	-	12
AT1G04340	1	1163096	1164851	1755	-	375
AT1G04350	1	1165164	1166768	1604	+	2475
AT1G04360	1	1167456	1168878	1422	-	28
AT1G04370	1	1175176	1175578	402	+	0
AT1G04380	1	1176920	1178407	1487	-	6
AT1G04390	1	1179362	1183704	4342	-	321
AT1G04400	1	1185549	1188517	2968	-	2298
AT1G04410	1	1189077	1191412	2335	-	12913
AT1G04420	1	1191607	1193884	2277	+	3616
AT1G04425	1	1194186	1196889	2703	+	52
AT1G04430	1	1198117	1201527	3410	+	2290
AT1G04440	1	1202254	1205803	3549	+	1323
AT1G04445	1	1207343	1207862	519	+	1
AT1G04450	1	1208520	1209874	1354	+	0
AT1G04457	1	1210318	1210549	231	-	0
AT1G04470	1	1211048	1214662	3614	-	0
AT1G04480	1	1216094	1217467	1373	+	1688
AT1G04490	1	1217947	1220137	2190	-	19
AT1G04500	1	1221432	1224366	2934	-	2
AT1G04501	1	1224551	1224680	129	+	0
AT1G04510	1	1226574	1230827	4253	+	1114
AT1G04520	1	1231577	1234032	2455	+	529
AT1G04530	1	1234175	1236034	1859	-	2922
AT1G04540	1	1237255	1239061	1806	+	190
AT1G04550	1	1240374	1242121	1747	+	687
AT1G04555	1	1242557	1244244	1687	+	103
AT1G04560	1	1244946	1246059	1113	+	0
AT1G04570	1	1246727	1248775	2048	-	88
AT1G04580	1	1252121	1257510	5389	-	4
AT1G04590	1	1258576	1261426	2850	-	401
AT1G04600	1	1262122	1272376	10254	+	26
AT1G04610	1	1279387	1281618	2231	+	2
AT1G04620	1	1282740	1286584	3844	-	580
AT1G04625	1	1287830	1289820	1990	-	0
AT1G04630	1	1289733	1291112	1379	-	569
AT1G04635	1	1291313	1291995	682	+	19
AT1G04640	1	1292079	1293357	1278	+	751
AT1G04645	1	1293769	1294263	494	-	0
AT1G04650	1	1294892	1299002	4110	-	156
AT1G04660	1	1300485	1301773	1288	-	33
AT1G04670	1	1301860	1302724	864	+	0
AT1G04680	1	1303528	1307884	4356	-	1906
AT1G04684	1	1310429	1310579	150	-	0
AT1G04690	1	1313563	1315750	2187	+	1938
AT1G04700	1	1316253	1320919	4666	+	62
AT1G04710	1	1321903	1324782	2879	+	654
AT1G04720	1	1324922	1324960	38	+	0
AT1G04730	1	1325295	1331086	5791	-	196
AT1G04750	1	1331465	1333567	2102	-	1094
AT1G04760	1	1334759	1336070	1311	+	42
AT1G04770	1	1336370	1337849	1479	-	230
AT1G04778	1	1339891	1340327	436	+	3
AT1G04780	1	1340668	1343584	2916	-	773
AT1G04790	1	1345035	1348451	3416	+	581
AT1G04800	1	1348451	1349286	835	-	2496
AT1G04810	1	1350179	1355442	5263	+	1173
AT1G04820	1	1356190	1358386	2196	-	4789
AT1G04830	1	1358573	1362019	3446	-	378
AT1G04840	1	1362866	1364962	2096	-	12
AT1G04850	1	1365117	1368844	3727	-	1695
AT1G04860	1	1369053	1373101	4048	-	629
AT1G04870	1	1373233	1375762	2529	-	326
AT1G04880	1	1375960	1379185	3225	-	10
AT1G04890	1	1380381	1382599	2218	-	0
AT1G04900	1	1383840	1387895	4055	+	123
AT1G04910	1	1387870	1391187	3317	-	618
AT1G04920	1	1391501	1395864	4363	-	58
AT1G04930	1	1396290	1399053	2763	-	61
AT1G04940	1	1399181	1400770	1589	+	133
AT1G04945	1	1399173	1403112	3939	+	81
AT1G04950	1	1403084	1407501	4417	-	688
AT1G04960	1	1407800	1410868	3068	-	443
AT1G04970	1	1411169	1413627	2458	+	734
AT1G04980	1	1413643	1416144	2501	-	195
AT1G04985	1	1416342	1418482	2140	-	681
AT1G04990	1	1419079	1421789	2710	-	239
AT1G05000	1	1425592	1428782	3190	+	18
AT1G05010	1	1431189	1432858	1669	-	2573
AT1G05020	1	1435253	1437667	2414	-	14
AT1G05030	1	1438151	1441417	3266	-	376
AT1G05040	1	1447368	1448448	1080	-	0
AT1G05055	1	1448717	1450887	2170	-	241
AT1G05060	1	1451029	1452872	1843	-	331
AT1G05061	1	1453215	1454260	1045	-	1
AT1G05065	1	1454968	1455220	252	-	33
AT1G05070	1	1457062	1458744	1682	-	484
AT1G05080	1	1459090	1460579	1489	+	0
AT1G05085	1	1460987	1461670	683	+	0
AT1G05090	1	1463201	1465622	2421	+	6
AT1G05100	1	1469609	1470881	1272	+	16
AT1G05120	1	1471405	1476078	4673	-	417
AT1G05135	1	1477499	1478821	1322	-	227
AT1G05136	1	1478922	1479063	141	+	0
AT1G05140	1	1482547	1484056	1509	+	2023
AT1G05150	1	1484066	1486960	2894	-	817
AT1G05160	1	1487377	1490947	3570	-	253
AT1G05170	1	1491110	1494248	3138	-	605
AT1G05180	1	1498113	1501824	3711	-	504
AT1G05190	1	1502343	1503830	1487	-	12108
AT1G05200	1	1504959	1509152	4193	+	1633
AT1G05205	1	1509102	1510281	1179	-	290
AT1G05210	1	1510403	1511683	1280	+	83
AT1G05220	1	1511906	1513573	1667	+	4
AT1G05230	1	1512895	1518805	5910	-	545
AT1G05240	1	1521136	1522681	1545	+	0
AT1G05250	1	1525600	1527234	1634	-	0
AT1G05260	1	1529766	1531439	1673	+	32
AT1G05270	1	1531640	1534410	2770	-	533
AT1G05280	1	1535443	1537525	2082	-	0
AT1G05290	1	1539151	1540562	1411	-	0
AT1G05291	1	1541347	1542432	1085	-	0
AT1G05300	1	1545105	1547849	2744	-	116
AT1G05310	1	1550542	1552517	1975	-	172
AT1G05320	1	1553602	1557733	4131	+	726
AT1G05330	1	1558169	1558583	414	+	0
AT1G05340	1	1558843	1559903	1060	-	12
AT1G05350	1	1560677	1564123	3446	-	562
AT1G05360	1	1564597	1567465	2868	+	344
AT1G05370	1	1569191	1572280	3089	-	30
AT1G05380	1	1576862	1582614	5752	+	803
AT1G05385	1	1582670	1583718	1048	-	812
AT1G05390	1	1583771	1583845	74	-	0
AT1G05400	1	1584072	1585421	1349	+	17
AT1G05410	1	1585370	1587778	2408	-	370
AT1G05420	1	1590072	1590753	681	+	24
AT1G05430	1	1594056	1595818	1762	-	646
AT1G05440	1	1596006	1597848	1842	-	31
AT1G05450	1	1599910	1601214	1304	+	0
AT1G05460	1	1601147	1605027	3880	-	344
AT1G05470	1	1607356	1611703	4347	-	479
AT1G05490	1	1618601	1623452	4851	-	22
AT1G05500	1	1624954	1629224	4270	+	1270
AT1G05510	1	1629445	1630863	1418	+	2
AT1G05520	1	1630899	1635711	4812	-	774
AT1G05530	1	1636495	1637863	1368	-	0
AT1G05540	1	1639285	1640811	1526	+	232
AT1G05550	1	1640958	1643917	2959	-	7
AT1G05560	1	1645497	1647147	1650	-	115
AT1G05562	1	1645874	1647162	1288	+	3
AT1G05570	1	1647705	1659437	11732	-	617
AT1G05575	1	1661690	1662187	497	-	1
AT1G05577	1	1662369	1664398	2029	-	1
AT1G05580	1	1665432	1668904	3472	-	0
AT1G05590	1	1669349	1671876	2527	+	519
AT1G05600	1	1671935	1673856	1921	+	180
AT1G05610	1	1673860	1675934	2074	-	9
AT1G05615	1	1677506	1678270	764	-	0
AT1G05620	1	1679157	1681710	2553	+	194
AT1G05630	1	1682317	1687363	5046	+	606
AT1G05640	1	1687435	1689501	2066	-	57
AT1G05650	1	1690263	1692126	1863	-	0
AT1G05660	1	1694285	1696058	1773	-	0
AT1G05670	1	1697586	1701025	3439	-	242
AT1G05675	1	1701115	1702749	1634	-	7
AT1G05680	1	1703091	1704691	1600	-	19
AT1G05690	1	1707010	1709347	2337	+	240
AT1G05700	1	1709795	1713245	3450	+	3
AT1G05710	1	1714949	1717276	2327	+	138
AT1G05720	1	1717446	1718909	1463	-	195
AT1G05730	1	1718554	1720303	1749	+	12
AT1G05740	1	1720673	1721309	636	+	0
AT1G05750	1	1721508	1724734	3226	+	69
AT1G05760	1	1723733	1724486	753	-	0
AT1G05770	1	1725387	1726283	896	-	12
AT1G05780	1	1726607	1728404	1797	+	70
AT1G05785	1	1730248	1732626	2378	+	96
AT1G05790	1	1732870	1737489	4619	+	493
AT1G05800	1	1741203	1742619	1416	+	1
AT1G05805	1	1744772	1747693	2921	+	450
AT1G05810	1	1748313	1749460	1147	+	101
AT1G05820	1	1749681	1753990	4309	+	79
AT1G05830	1	1754243	1761817	7574	+	903
AT1G05835	1	1762223	1762814	591	+	153
AT1G05840	1	1762733	1766281	3548	-	538
AT1G05850	1	1766502	1768695	2193	-	10924
AT1G05860	1	1769013	1771115	2102	+	242
AT1G05870	1	1771456	1773293	1837	-	1322
AT1G05880	1	1775642	1778553	2911	+	7
AT1G05890	1	1779255	1784529	5274	+	949
AT1G05894	1	1784802	1786292	1490	+	22
AT1G05900	1	1786855	1789676	2821	+	703
AT1G05910	1	1790223	1796647	6424	+	668
AT1G05920	1	1796777	1798254	1477	+	0
AT1G05925	1	1798900	1799062	162	-	0
AT1G05930	1	1799417	1800933	1516	+	0
AT1G05940	1	1801161	1803984	2823	-	868
AT1G05950	1	1804400	1807471	3071	-	129
AT1G05960	1	1807972	1815474	7502	-	1021
AT1G05970	1	1816055	1817282	1227	-	124
AT1G05980	1	1817399	1817471	72	+	0
AT1G05990	1	1818446	1819040	594	+	0
AT1G06000	1	1820307	1821894	1587	-	343
AT1G06002	1	1820976	1821918	942	+	0
AT1G06010	1	1822617	1823997	1380	+	185
AT1G06020	1	1824547	1826101	1554	+	8
AT1G06030	1	1826879	1828161	1282	+	0
AT1G06040	1	1828412	1829890	1478	-	7383
AT1G06050	1	1830604	1832555	1951	-	131
AT1G06060	1	1832942	1834861	1919	+	427
AT1G06070	1	1834828	1837648	2820	-	362
AT1G06080	1	1843567	1846302	2735	+	37
AT1G06090	1	1847882	1849693	1811	+	22
AT1G06100	1	1851529	1853019	1490	+	101
AT1G06110	1	1853076	1855031	1955	-	716
AT1G06120	1	1855942	1857718	1776	+	0
AT1G06130	1	1857766	1860730	2964	-	754
AT1G06135	1	1862196	1862742	546	+	1
AT1G06137	1	1863543	1863750	207	-	0
AT1G06140	1	1864795	1866472	1677	+	14
AT1G06148	1	1874884	1877528	2644	-	8
AT1G06149	1	1868988	1873718	4730	-	0
AT1G06150	1	1867014	1873718	6704	-	67
AT1G06160	1	1883003	1883934	931	+	6
AT1G06170	1	1884980	1886897	1917	-	11
AT1G06180	1	1889407	1891158	1751	+	43
AT1G06190	1	1892272	1894148	1876	-	1867
AT1G06200	1	1894335	1896935	2600	-	838
AT1G06210	1	1897202	1899208	2006	+	671
AT1G06220	1	1899963	1904873	4910	+	1145
AT1G06225	1	1905974	1906226	252	+	0
AT1G06230	1	1906962	1910848	3886	+	1235
AT1G06240	1	1911121	1913205	2084	+	566
AT1G06250	1	1913255	1914895	1640	-	85
AT1G06260	1	1916429	1917585	1156	+	3
AT1G06265	1	1914942	1917661	2719	-	85
AT1G06270	1	1918087	1919760	1673	-	91
AT1G06280	1	1920306	1920949	643	-	0
AT1G06290	1	1922351	1926278	3927	+	1179
AT1G06310	1	1926790	1930258	3468	+	1
AT1G06320	1	1930522	1931449	927	+	0
AT1G06330	1	1931670	1932266	596	-	0
AT1G06340	1	1933283	1934014	731	-	1
AT1G06350	1	1935292	1936819	1527	-	12
AT1G06360	1	1938962	1940459	1497	-	1057
AT1G06370	1	1942842	1944934	2092	-	107
AT1G06380	1	1945123	1946076	953	+	97
AT1G06390	1	1946787	1950860	4073	+	1043
AT1G06400	1	1950843	1952785	1942	-	718
AT1G06410	1	1954849	1958756	3907	+	2534
AT1G06420	1	1958922	1959947	1025	+	45
AT1G06430	1	1960057	1963011	2954	-	7322
AT1G06440	1	1963379	1965051	1672	-	25
AT1G06450	1	1965839	1967219	1380	+	51
AT1G06460	1	1967086	1969561	2475	-	2212
AT1G06470	1	1969728	1973767	4039	+	565
AT1G06475	1	1973833	1974386	553	-	16
AT1G06480	1	1978083	1978157	74	+	0
AT1G06490	1	1978761	1989409	10648	+	232
AT1G06500	1	1989478	1990730	1252	+	181
AT1G06510	1	1992332	1993840	1508	+	656
AT1G06515	1	1990633	1992228	1595	-	245
AT1G06520	1	1993977	1996112	2135	-	21
AT1G06530	1	2001593	2002596	1003	+	776
AT1G06540	1	2002876	2003393	517	-	12
AT1G06550	1	2003626	2007190	3564	-	1215
AT1G06560	1	2007614	2012006	4392	+	212
AT1G06570	1	2011884	2013545	1661	-	1573
AT1G06580	1	2014002	2016054	2052	-	53
AT1G06590	1	2016307	2024662	8355	-	232
AT1G06610	1	2025355	2025428	73	+	0
AT1G06620	1	2025600	2027271	1671	+	28
AT1G06630	1	2027738	2031388	3650	+	431
AT1G06640	1	2032337	2034018	1681	+	1025
AT1G06645	1	2034155	2035626	1471	+	350
AT1G06650	1	2035838	2037366	1528	+	1396
AT1G06660	1	2037310	2040246	2936	-	68
AT1G06670	1	2040432	2047612	7180	+	1148
AT1G06680	1	2047824	2049418	1594	+	146751
AT1G06690	1	2049601	2052154	2553	-	3180
AT1G06700	1	2052480	2055548	3068	-	1307
AT1G06710	1	2056574	2060242	3668	-	115
AT1G06720	1	2060443	2067323	6880	-	423
AT1G06730	1	2067528	2070446	2918	+	327
AT1G06740	1	2070736	2073535	2799	+	83
AT1G06750	1	2072978	2076505	3527	+	1
AT1G06760	1	2076503	2077698	1195	-	3705
AT1G06770	1	2078910	2081939	3029	-	133
AT1G06780	1	2083310	2087131	3821	+	242
AT1G06790	1	2087231	2089786	2555	+	159
AT1G06800	1	2089416	2091686	2270	-	142
AT1G06810	1	2091737	2092528	791	-	1
AT1G06820	1	2092945	2096232	3287	-	1235
AT1G06830	1	2097150	2097655	505	+	108
AT1G06840	1	2097746	2103479	5733	-	360
AT1G06850	1	2105047	2106749	1702	+	150
AT1G06860	1	2107397	2107468	71	-	0
AT1G06870	1	2108592	2110986	2394	+	374
AT1G06880	1	2111147	2111218	71	-	0
AT1G06890	1	2111362	2114601	3239	-	570
AT1G06900	1	2114926	2120745	5819	-	974
AT1G06910	1	2120990	2123748	2758	+	143
AT1G06920	1	2124853	2125801	948	-	0
AT1G06923	1	2126748	2128060	1312	+	0
AT1G06925	1	2127703	2128611	908	-	0
AT1G06930	1	2128842	2129883	1041	+	0
AT1G06950	1	2130141	2135665	5524	-	4167
AT1G06960	1	2135850	2137732	1882	+	385
AT1G06970	1	2138108	2140818	2710	+	1
AT1G06980	1	2143030	2143821	791	-	141
AT1G06990	1	2148386	2150152	1766	+	0
AT1G07000	1	2150193	2152325	2132	-	189
AT1G07010	1	2152851	2155269	2418	+	2599
AT1G07020	1	2155212	2156008	796	-	155
AT1G07025	1	2157657	2158158	501	-	0
AT1G07030	1	2158419	2160809	2390	-	377
AT1G07040	1	2160937	2163308	2371	-	451
AT1G07050	1	2164187	2165239	1052	-	14
AT1G07051	1	2165516	2165746	230	+	0
AT1G07060	1	2167106	2168397	1291	-	2
AT1G07070	1	2168563	2169851	1288	+	316
AT1G07080	1	2169981	2172194	2213	+	1511
AT1G07090	1	2173951	2174894	943	-	160
AT1G07100	1	2177884	2177958	74	+	0
AT1G07110	1	2178103	2184148	6045	-	3932
AT1G07119	1	2184346	2186539	2193	+	8
AT1G07120	1	2184758	2186580	1822	-	10
AT1G07128	1	2187620	2188417	797	-	0
AT1G07130	1	2187775	2188733	958	+	8
AT1G07135	1	2189927	2190659	732	-	35
AT1G07140	1	2191722	2193793	2071	-	1708
AT1G07150	1	2193940	2195798	1858	-	34
AT1G07160	1	2197907	2199748	1841	-	1
AT1G07170	1	2200122	2201265	1143	+	214
AT1G07175	1	2202329	2202774	445	+	3
AT1G07180	1	2204319	2206934	2615	+	5297
AT1G07190	1	2208012	2208177	165	+	0
AT1G07200	1	2208718	2212546	3828	-	930
AT1G07210	1	2215222	2216982	1760	+	498
AT1G07220	1	2216924	2219474	2550	-	297
AT1G07230	1	2220252	2222982	2730	-	697
AT1G07240	1	2223690	2225452	1762	+	444
AT1G07250	1	2225899	2227566	1667	+	1162
AT1G07260	1	2227593	2229319	1726	-	19
AT1G07270	1	2229756	2232897	3141	-	34
AT1G07280	1	2238086	2241217	3131	+	3042
AT1G07290	1	2242255	2244428	2173	-	27
AT1G07300	1	2245757	2246492	735	-	129
AT1G07310	1	2247508	2248961	1453	-	523
AT1G07320	1	2249132	2250529	1397	+	9857
AT1G07330	1	2251130	2253585	2455	+	8
AT1G07340	1	2254821	2256850	2029	+	1
AT1G07350	1	2257424	2260101	2677	-	969
AT1G07360	1	2260388	2262865	2477	-	836
AT1G07370	1	2263139	2264551	1412	+	402
AT1G07380	1	2264828	2268306	3478	-	249
AT1G07390	1	2269892	2274820	4928	+	66
AT1G07400	1	2274942	2275758	816	+	38
AT1G07410	1	2276052	2277154	1102	+	26
AT1G07420	1	2277806	2280297	2491	+	331
AT1G07430	1	2280834	2282828	1994	-	83
AT1G07440	1	2286148	2287730	1582	-	1441
AT1G07450	1	2287925	2289336	1411	-	172
AT1G07460	1	2290200	2290977	777	+	0
AT1G07470	1	2291456	2294588	3132	+	212
AT1G07473	1	2294565	2295489	924	-	0
AT1G07476	1	2295750	2296497	747	+	0
AT1G07480	1	2296022	2299470	3448	-	243
AT1G07485	1	2301374	2302121	747	+	0
AT1G07490	1	2301379	2302021	642	-	10
AT1G07500	1	2304765	2305031	266	-	1
AT1G07510	1	2305377	2309544	4167	+	914
AT1G07520	1	2309563	2311805	2242	-	117
AT1G07530	1	2313581	2316469	2888	-	685
AT1G07540	1	2318432	2321048	2616	-	0
AT1G07550	1	2322652	2326561	3909	-	0
AT1G07560	1	2327319	2331096	3777	+	0
AT1G07570	1	2331169	2333738	2569	-	393
AT1G07580	1	2334821	2334894	73	+	0
AT1G07590	1	2336522	2339391	2869	-	3212
AT1G07600	1	2338903	2339321	418	-	0
AT1G07610	1	2341541	2342123	582	+	298
AT1G07615	1	2342197	2344271	2074	-	101
AT1G07620	1	2344389	2346842	2453	-	71
AT1G07630	1	2349096	2351692	2596	+	331
AT1G07640	1	2354353	2356227	1874	-	708
AT1G07645	1	2367436	2368385	949	-	0
AT1G07650	1	2359548	2366561	7013	-	1041
AT1G07660	1	2368836	2369734	898	+	242
AT1G07670	1	2370051	2374545	4494	-	916
AT1G07680	1	2376011	2377186	1175	+	0
AT1G07690	1	2378075	2379000	925	+	0
AT1G07700	1	2379646	2381362	1716	+	2111
AT1G07702	1	2382250	2382331	81	-	0
AT1G07705	1	2381614	2386092	4478	+	512
AT1G07710	1	2386274	2387986	1712	-	6
AT1G07720	1	2390654	2392453	1799	-	1088
AT1G07725	1	2394800	2397272	2472	-	0
AT1G07728	1	2395450	2397345	1895	+	3
AT1G07730	1	2397526	2398696	1170	-	0
AT1G07740	1	2397441	2400508	3067	-	36
AT1G07745	1	2400588	2402873	2285	-	130
AT1G07747	1	2403557	2403845	288	+	0
AT1G07750	1	2404036	2405943	1907	-	681
AT1G07760	1	2406833	2406905	72	-	0
AT1G07770	1	2408202	2409580	1378	-	3714
AT1G07780	1	2410055	2412677	2622	-	84
AT1G07790	1	2412979	2413708	729	+	1070
AT1G07795	1	2414285	2414967	682	+	0
AT1G07800	1	2415040	2415970	930	+	0
AT1G07810	1	2416264	2420757	4493	+	546
AT1G07820	1	2421215	2421947	732	-	828
AT1G07830	1	2422240	2423655	1415	+	187
AT1G07840	1	2424053	2426676	2623	+	311
AT1G07850	1	2426744	2428719	1975	+	1
AT1G07860	1	2428910	2429431	521	-	0
AT1G07870	1	2428772	2432057	3285	-	195
AT1G07880	1	2434029	2435763	1734	-	121
AT1G07885	1	2436466	2436959	493	-	2
AT1G07890	1	2437329	2439665	2336	+	15672
AT1G07900	1	2442621	2443632	1011	+	14
AT1G07901	1	2443970	2444123	153	-	15
AT1G07910	1	2445469	2454645	9176	+	565
AT1G07920	1	2454845	2457321	2476	+	1829
AT1G07930	1	2458243	2460790	2547	+	2508
AT1G07940	1	2462952	2465504	2552	-	1725
AT1G07950	1	2465769	2467022	1253	-	239
AT1G07960	1	2467160	2469154	1994	+	376
AT1G07970	1	2469285	2472628	3343	-	292
AT1G07980	1	2473164	2474927	1763	-	265
AT1G07985	1	2475404	2476155	751	+	3
AT1G07990	1	2477156	2483138	5982	+	1123
AT1G08000	1	2483239	2485109	1870	-	197
AT1G08005	1	2485343	2485511	168	+	2
AT1G08010	1	2485905	2488027	2122	-	344
AT1G08030	1	2489500	2493250	3750	-	476
AT1G08032	1	2494122	2494315	193	+	0
AT1G08035	1	2494401	2495149	748	+	1
AT1G08040	1	2495341	2498764	3423	-	588
AT1G08050	1	2498835	2501427	2592	-	55
AT1G08060	1	2501741	2511084	9343	-	694
AT1G08065	1	2511646	2513454	1808	-	0
AT1G08070	1	2514191	2516605	2414	-	16
AT1G08080	1	2516990	2518546	1556	-	4
AT1G08090	1	2524075	2526164	2089	+	5
AT1G08100	1	2527169	2529120	1951	-	0
AT1G08105	1	2531694	2534786	3092	-	6
AT1G08110	1	2535327	2537931	2604	+	1803
AT1G08115	1	2538075	2538237	162	-	11
AT1G08120	1	2538614	2539661	1047	+	0
AT1G08125	1	2539613	2542334	2721	-	329
AT1G08130	1	2542701	2547946	5245	-	698
AT1G08135	1	2548818	2551473	2655	-	0
AT1G08140	1	2552035	2555161	3126	-	1
AT1G08150	1	2556342	2559074	2732	-	0
AT1G08160	1	2559486	2560403	917	-	245
AT1G08165	1	2561626	2562148	522	-	17
AT1G08170	1	2562940	2563672	732	-	4
AT1G08180	1	2564571	2565121	550	-	105
AT1G08190	1	2567474	2573393	5919	+	2332
AT1G08200	1	2573847	2576714	2867	-	4805
AT1G08210	1	2577019	2580669	3650	-	294
AT1G08220	1	2581021	2583323	2302	-	99
AT1G08230	1	2583653	2586744	3091	-	211
AT1G08240	1	2588524	2588596	72	+	0
AT1G08250	1	2588856	2590301	1445	-	355
AT1G08260	1	2590943	2606892	15949	+	480
AT1G08270	1	2606268	2607507	1239	-	34
AT1G08280	1	2608407	2609853	1446	+	128
AT1G08290	1	2609995	2613242	3247	-	31
AT1G08300	1	2614773	2618823	4050	+	100
AT1G08310	1	2618646	2620452	1806	+	5
AT1G08315	1	2620334	2621545	1211	-	133
AT1G08320	1	2621903	2627848	5945	-	3
AT1G08340	1	2631067	2632871	1804	+	46
AT1G08350	1	2632809	2635852	3043	-	220
AT1G08360	1	2636010	2637915	1905	+	4406
AT1G08370	1	2638180	2640554	2374	+	599
AT1G08380	1	2640812	2641828	1016	-	92769
AT1G08390	1	2642213	2643285	1072	+	215
AT1G08400	1	2643329	2646035	2706	-	107
AT1G08410	1	2646188	2649379	3191	+	287
AT1G08420	1	2649536	2657120	7584	+	1293
AT1G08430	1	2658715	2661029	2314	+	4
AT1G08440	1	2663026	2665343	2317	+	5
AT1G08450	1	2667797	2671892	4095	-	1477
AT1G08460	1	2672450	2674628	2178	+	524
AT1G08465	1	2675812	2679781	3969	+	341
AT1G08470	1	2682126	2684100	1974	-	430
AT1G08480	1	2684233	2685621	1388	+	1081
AT1G08490	1	2685658	2688595	2937	-	1258
AT1G08500	1	2689015	2690045	1030	+	6
AT1G08510	1	2691079	2694377	3298	-	2001
AT1G08520	1	2696411	2700959	4548	+	7532
AT1G08530	1	2701225	2703091	1866	+	299
AT1G08540	1	2703335	2706845	3510	+	4002
AT1G08550	1	2706923	2709531	2608	+	2211
AT1G08560	1	2709631	2710912	1281	-	477
AT1G08570	1	2712882	2714734	1852	+	2059
AT1G08580	1	2715078	2716404	1326	-	432
AT1G08590	1	2718777	2722221	3444	+	44
AT1G08592	1	2718874	2721676	2802	-	0
AT1G08600	1	2723823	2733613	9790	+	732
AT1G08610	1	2733656	2735819	2163	-	102
AT1G08620	1	2736773	2743758	6985	+	659
AT1G08630	1	2743760	2747967	4207	-	14
AT1G08640	1	2748397	2751278	2881	-	2339
AT1G08650	1	2752153	2753703	1550	+	397
AT1G08660	1	2757040	2759794	2754	-	594
AT1G08670	1	2760345	2761573	1228	-	0
AT1G08680	1	2762583	2768967	6384	+	798
AT1G08695	1	2769055	2769483	428	-	0
AT1G08700	1	2769814	2771477	1663	-	459
AT1G08710	1	2771632	2773460	1828	+	201
AT1G08720	1	2774029	2779297	5268	+	552
AT1G08730	1	2779962	2788447	8485	+	30
AT1G08735	1	2790289	2793641	3352	+	0
AT1G08740	1	2795642	2800081	4439	-	0
AT1G08750	1	2801066	2804537	3471	+	311
AT1G08760	1	2805370	2808621	3251	+	420
AT1G08770	1	2808882	2809747	865	+	204
AT1G08780	1	2809777	2811191	1414	-	256
AT1G08790	1	2811988	2812646	658	+	1
AT1G08800	1	2813060	2818008	4948	-	377
AT1G08810	1	2819064	2820395	1331	-	288
AT1G08820	1	2821551	2825275	3724	-	549
AT1G08830	1	2827060	2829315	2255	+	698
AT1G08840	1	2829104	2838469	9365	-	163
AT1G08845	1	2838788	2840994	2206	+	69
AT1G08860	1	2842152	2846138	3986	+	1
AT1G08870	1	2846535	2846608	73	-	0
AT1G08880	1	2846948	2847800	852	-	1272
AT1G08890	1	2848347	2852270	3923	+	104
AT1G08900	1	2852453	2855779	3326	+	488
AT1G08910	1	2856226	2861170	4944	+	572
AT1G08920	1	2867258	2870656	3398	+	206
AT1G08930	1	2873464	2877270	3806	+	336
AT1G08940	1	2877691	2879169	1478	+	45
AT1G08950	1	2879302	2879374	72	+	0
AT1G08960	1	2879641	2882231	2590	+	216
AT1G08970	1	2882523	2884337	1814	+	676
AT1G08980	1	2884410	2886620	2210	+	728
AT1G08985	1	2887284	2887706	422	+	0
AT1G08990	1	2888752	2890959	2207	+	1
AT1G09000	1	2891036	2895182	4146	+	74
AT1G09010	1	2895165	2899384	4219	-	1897
AT1G09020	1	2899913	2904815	4902	-	1091
AT1G09026	1	2907123	2907279	156	+	0
AT1G09030	1	2908610	2909030	420	-	0
AT1G09040	1	2911316	2915369	4053	+	74
AT1G09050	1	2918030	2920889	2859	+	85
AT1G09060	1	2921063	2925762	4699	-	1128
AT1G09070	1	2927702	2928968	1266	+	2026
AT1G09080	1	2929216	2931841	2625	-	40
AT1G09090	1	2932738	2936586	3848	+	0
AT1G09100	1	2936527	2939326	2799	-	472
AT1G09110	1	2939416	2939488	72	+	0
AT1G09130	1	2939569	2942288	2719	-	4854
AT1G09140	1	2942563	2945961	3398	-	1680
AT1G09150	1	2946228	2949159	2931	+	743
AT1G09155	1	2949675	2950989	1314	-	9
AT1G09157	1	2951664	2952396	732	-	0
AT1G09160	1	2952770	2955689	2919	-	735
AT1G09170	1	2956588	2962207	5619	-	24
AT1G09176	1	2964151	2964604	453	+	0
AT1G09180	1	2965022	2965972	950	+	59
AT1G09190	1	2966119	2967718	1599	-	26
AT1G09195	1	2967939	2971498	3559	-	182
AT1G09200	1	2971592	2972199	607	-	1444
AT1G09210	1	2972841	2976750	3909	-	2601
AT1G09220	1	2977791	2979466	1675	-	18
AT1G09230	1	2979519	2982624	3105	-	433
AT1G09240	1	2984880	2986130	1250	+	450
AT1G09245	1	2986938	2987393	455	-	0
AT1G09250	1	2989377	2990357	980	+	377
AT1G09260	1	2993403	2993820	417	+	0
AT1G09270	1	2994368	2998222	3854	+	1187
AT1G09280	1	2998099	3001315	3216	-	289
AT1G09290	1	3001516	3003762	2246	-	185
AT1G09300	1	3003494	3008213	4719	+	116
AT1G09310	1	3009054	3009880	826	+	20712
AT1G09320	1	3009940	3012363	2423	-	105
AT1G09330	1	3012761	3015091	2330	-	588
AT1G09340	1	3015327	3018234	2907	+	43182
AT1G09350	1	3019818	3021441	1623	+	208
AT1G09360	1	3021801	3022368	567	+	0
AT1G09370	1	3024895	3025435	540	+	2
AT1G09380	1	3026134	3029549	3415	-	0
AT1G09390	1	3031202	3033582	2380	+	536
AT1G09400	1	3033511	3035036	1525	-	6
AT1G09410	1	3035442	3037560	2118	+	8
AT1G09415	1	3037753	3038408	655	-	148
AT1G09420	1	3038461	3041873	3412	-	128
AT1G09421	1	3038630	3039326	696	+	1
AT1G09430	1	3041995	3045402	3407	+	1097
AT1G09440	1	3045512	3047893	2381	-	244
AT1G09450	1	3049023	3053112	4089	+	91
AT1G09460	1	3053900	3055360	1460	+	29
AT1G09470	1	3055230	3057443	2213	-	121
AT1G09480	1	3057974	3060661	2687	+	32
AT1G09483	1	3060991	3061729	738	-	2
AT1G09486	1	3062429	3063731	1302	-	22
AT1G09490	1	3064123	3065937	1814	+	964
AT1G09500	1	3066698	3068598	1900	+	95
AT1G09510	1	3069384	3070910	1526	+	0
AT1G09520	1	3070945	3072050	1105	-	211
AT1G09530	1	3076581	3079539	2958	+	198
AT1G09540	1	3086158	3087912	1754	+	6
AT1G09550	1	3089732	3092327	2595	-	0
AT1G09560	1	3093838	3094864	1026	+	507
AT1G09570	1	3095255	3100357	5102	-	1858
AT1G09575	1	3101670	3102925	1255	-	38
AT1G09580	1	3104587	3106290	1703	+	199
AT1G09590	1	3106501	3107772	1271	+	1854
AT1G09600	1	3108616	3111318	2702	+	55
AT1G09610	1	3111693	3112873	1180	+	18
AT1G09620	1	3112777	3116699	3922	-	2710
AT1G09625	1	3117136	3117567	431	-	0
AT1G09630	1	3118202	3119708	1506	-	372
AT1G09640	1	3119877	3122526	2649	+	3130
AT1G09645	1	3122955	3124578	1623	+	270
AT1G09650	1	3125806	3127284	1478	+	8
AT1G09660	1	3127770	3131094	3324	-	721
AT1G09665	1	3133094	3133674	580	+	0
AT1G09680	1	3134106	3135930	1824	-	21
AT1G09690	1	3136187	3137475	1288	-	3480
AT1G09700	1	3137766	3140353	2587	-	144
AT1G09710	1	3140867	3144370	3503	+	192
AT1G09720	1	3144437	3147303	2866	-	0
AT1G09730	1	3147666	3154380	6714	-	744
AT1G09740	1	3154531	3156275	1744	+	117
AT1G09750	1	3157500	3159148	1648	+	3949
AT1G09760	1	3159124	3161692	2568	-	875
AT1G09770	1	3161840	3165360	3520	+	1952
AT1G09780	1	3165369	3167869	2500	-	2157
AT1G09790	1	3168481	3170819	2338	-	0
AT1G09794	1	3172107	3173463	1356	+	47
AT1G09795	1	3173533	3176910	3377	+	1881
AT1G09800	1	3176882	3180421	3539	-	92
AT1G09810	1	3180935	3184224	3289	-	241
AT1G09812	1	3187816	3188580	764	+	32
AT1G09815	1	3189368	3190242	874	+	319
AT1G09820	1	3190287	3192414	2127	-	121
AT1G09830	1	3192680	3195025	2345	-	849
AT1G09840	1	3195823	3200291	4468	-	896
AT1G09850	1	3201798	3204150	2352	+	349
AT1G09860	1	3204015	3205309	1294	-	0
AT1G09870	1	3205740	3208598	2858	+	507
AT1G09880	1	3208827	3211653	2826	-	21
AT1G09890	1	3214236	3217538	3302	-	88
AT1G09900	1	3218132	3219929	1797	+	369
AT1G09910	1	3220034	3224541	4507	-	362
AT1G09920	1	3224683	3227070	2387	-	453
AT1G09930	1	3227489	3230043	2554	-	0
AT1G09932	1	3230449	3233109	2660	-	63
AT1G09935	1	3234059	3235530	1471	-	0
AT1G09940	1	3236994	3239554	2560	-	347
AT1G09950	1	3240605	3241632	1027	-	4
AT1G09960	1	3244212	3247200	2988	+	111
AT1G09970	1	3252239	3255693	3454	+	881
AT1G09980	1	3256244	3261614	5370	-	824
AT1G09995	1	3262264	3263612	1348	-	65
AT1G10000	1	3263876	3264788	912	-	15
AT1G10010	1	3265975	3268726	2751	+	0
AT1G10020	1	3269603	3271987	2384	-	594
AT1G10030	1	3273824	3275837	2013	+	250
AT1G10040	1	3275890	3278697	2807	-	30
AT1G10050	1	3279269	3283482	4213	+	269
AT1G10060	1	3284238	3287107	2869	+	233
AT1G10070	1	3288086	3290471	2385	+	17
AT1G10090	1	3290310	3296198	5888	-	594
AT1G10095	1	3297323	3300443	3120	-	92
AT1G10100	1	3300696	3301489	793	-	1
AT1G10110	1	3302741	3304092	1351	+	13
AT1G10120	1	3304038	3306824	2786	-	470
AT1G10130	1	3310929	3322213	11284	+	1065
AT1G10140	1	3322801	3323548	747	-	35
AT1G10150	1	3325823	3327614	1791	+	470
AT1G10155	1	3327636	3328448	812	-	18
AT1G10160	1	3328970	3333470	4500	+	233
AT1G10170	1	3333594	3337491	3897	-	920
AT1G10180	1	3338302	3341608	3306	-	586
AT1G10190	1	3343685	3345632	1947	-	0
AT1G10200	1	3346389	3347885	1496	-	1002
AT1G10210	1	3349218	3351180	1962	+	150
AT1G10220	1	3352158	3354856	2698	+	0
AT1G10230	1	3355570	3356359	789	+	145
AT1G10240	1	3356679	3359838	3159	-	275
AT1G10250	1	3360086	3360508	422	-	0
AT1G10260	1	3360525	3361247	722	-	1
AT1G10270	1	3363503	3366488	2985	+	170
AT1G10280	1	3366492	3369095	2603	-	124
AT1G10290	1	3370557	3377463	6906	+	1661
AT1G10300	1	3378141	3380226	2085	+	1
AT1G10310	1	3381600	3383914	2314	-	589
AT1G10320	1	3384163	3388373	4210	-	372
AT1G10330	1	3388746	3390150	1404	+	35
AT1G10340	1	3390321	3392571	2250	-	58
AT1G10350	1	3393406	3395055	1649	-	357
AT1G10360	1	3395557	3396849	1292	-	1439
AT1G10370	1	3397080	3398358	1278	-	3170
AT1G10380	1	3400605	3402324	1719	+	324
AT1G10385	1	3403223	3405856	2633	+	0
AT1G10390	1	3407023	3412843	5820	-	1659
AT1G10400	1	3414851	3416358	1507	-	0
AT1G10410	1	3416679	3419639	2960	-	451
AT1G10417	1	3424185	3427457	3272	-	26
AT1G10419	1	3428030	3428425	395	+	0
AT1G10430	1	3428477	3430633	2156	-	459
AT1G10440	1	3431184	3431256	72	-	0
AT1G10450	1	3431779	3438370	6591	+	498
AT1G10455	1	3438554	3439013	459	+	0
AT1G10460	1	3439321	3440320	999	-	28
AT1G10470	1	3442326	3443957	1631	-	2598
AT1G10480	1	3449690	3451226	1536	+	5
AT1G10490	1	3453227	3460620	7393	+	424
AT1G10500	1	3459999	3461485	1486	-	1580
AT1G10510	1	3461634	3465786	4152	+	1449
AT1G10520	1	3465963	3469248	3285	+	48
AT1G10522	1	3469579	3471488	1909	+	436
AT1G10530	1	3471455	3472672	1217	-	11
AT1G10538	1	3474514	3474765	251	+	0
AT1G10540	1	3474863	3477927	3064	-	22
AT1G10550	1	3479152	3480988	1836	-	3
AT1G10560	1	3484579	3486965	2386	+	14
AT1G10570	1	3487583	3491277	3694	+	409
AT1G10580	1	3491280	3493737	2457	-	583
AT1G10585	1	3493939	3495144	1205	-	5
AT1G10586	1	3496927	3499439	2512	-	0
AT1G10588	1	3501144	3501904	760	+	0
AT1G10590	1	3502003	3503457	1454	-	1145
AT1G10600	1	3503703	3505502	1799	+	445
AT1G10610	1	3506185	3509006	2821	+	346
AT1G10620	1	3509000	3511975	2975	-	1
AT1G10630	1	3512794	3514729	1935	-	1167
AT1G10640	1	3515364	3517888	2524	-	827
AT1G10650	1	3524017	3526346	2329	-	555
AT1G10652	1	3527708	3527831	123	+	0
AT1G10657	1	3530466	3531842	1376	+	549
AT1G10660	1	3532423	3535131	2708	+	662
AT1G10670	1	3535382	3538439	3057	+	4180
AT1G10680	1	3538469	3543782	5313	-	0
AT1G10682	1	3544990	3545471	481	-	511
AT1G10690	1	3549991	3550632	641	-	56
AT1G10700	1	3554103	3556503	2400	+	438
AT1G10705	1	3557113	3557457	344	+	0
AT1G10710	1	3558357	3561634	3277	+	7
AT1G10717	1	3562179	3562554	375	+	0
AT1G10720	1	3562951	3564759	1808	+	354
AT1G10730	1	3565462	3567779	2317	+	145
AT1G10740	1	3567904	3570838	2934	-	979
AT1G10745	1	3572709	3573066	357	+	0
AT1G10747	1	3574311	3574830	519	+	0
AT1G10750	1	3574806	3578474	3668	-	86
AT1G10760	1	3581033	3590928	9895	-	5305
AT1G10770	1	3591632	3592411	779	-	2
AT1G10780	1	3592745	3595077	2332	-	114
AT1G10790	1	3596359	3597847	1488	+	13
AT1G10800	1	3598157	3598591	434	-	6
AT1G10810	1	3599270	3600877	1607	+	10
AT1G10820	1	3600909	3605076	4167	-	465
AT1G10830	1	3605575	3607493	1918	-	851
AT1G10840	1	3607630	3610520	2890	-	1918
AT1G10850	1	3611746	3614613	2867	+	588
AT1G10865	1	3614512	3616159	1647	-	166
AT1G10870	1	3616609	3623758	7149	-	644
AT1G10880	1	3624034	3627082	3048	-	0
AT1G10890	1	3627725	3630765	3040	+	826
AT1G10900	1	3632233	3637141	4908	-	2299
AT1G10910	1	3639877	3644162	4285	+	1135
AT1G10920	1	3644419	3647768	3349	-	346
AT1G10930	1	3647893	3655590	7697	-	484
AT1G10940	1	3655776	3658608	2832	-	2033
AT1G10950	1	3659208	3663984	4776	+	2171
AT1G10960	1	3664385	3665039	654	+	8956
AT1G10970	1	3665086	3667139	2053	-	243
AT1G10980	1	3667247	3669902	2655	-	13
AT1G10990	1	3670277	3671187	910	-	31
AT1G11000	1	3671755	3675979	4224	-	110
AT1G11010	1	3676606	3676644	38	+	0
AT1G11020	1	3676690	3678524	1834	+	287
AT1G11030	1	3678774	3678848	74	-	0
AT1G11040	1	3679224	3680924	1700	-	1
AT1G11050	1	3681887	3684169	2282	+	197
AT1G11055	1	3683918	3684095	177	-	0
AT1G11060	1	3684567	3689847	5280	+	356
AT1G11070	1	3690211	3693648	3437	-	57
AT1G11080	1	3694671	3698013	3342	-	128
AT1G11090	1	3702607	3703779	1172	+	325
AT1G11100	1	3703671	3709302	5631	-	15
AT1G11110	1	3710207	3712503	2296	+	0
AT1G11112	1	3712998	3713735	737	-	16
AT1G11120	1	3715183	3717320	2137	+	36
AT1G11125	1	3718782	3719711	929	+	10
AT1G11130	1	3722856	3727450	4594	+	453
AT1G11145	1	3727531	3728166	635	-	1
AT1G11150	1	3728970	3731624	2654	+	198
AT1G11160	1	3733138	3739842	6704	+	84
AT1G11170	1	3740764	3744675	3911	+	24
AT1G11175	1	3744857	3745655	798	+	113
AT1G11180	1	3745773	3748521	2748	+	238
AT1G11185	1	3749509	3750035	526	+	0
AT1G11190	1	3750065	3752780	2715	-	98
AT1G11200	1	3753364	3755641	2277	+	256
AT1G11210	1	3755676	3756998	1322	-	12
AT1G11220	1	3759861	3761165	1304	-	32
AT1G11230	1	3763267	3764483	1216	-	0
AT1G11240	1	3766753	3768294	1541	-	333
AT1G11250	1	3768723	3769706	983	+	2
AT1G11260	1	3777327	3780337	3010	+	847
AT1G11265	1	3781234	3785293	4059	+	0
AT1G11270	1	3780428	3786990	6562	-	65
AT1G11280	1	3787333	3790876	3543	-	745
AT1G11290	1	3791453	3793883	2430	-	121
AT1G11300	1	3794237	3800719	6482	+	400
AT1G11310	1	3800737	3804185	3448	-	1592
AT1G11320	1	3807127	3808875	1748	+	91
AT1G11330	1	3810092	3813607	3515	+	597
AT1G11340	1	3814115	3817420	3305	-	76
AT1G11350	1	3817590	3820805	3215	-	712
AT1G11360	1	3821442	3823088	1646	-	390
AT1G11362	1	3824509	3825196	687	-	0
AT1G11370	1	3828097	3830945	2848	-	0
AT1G11380	1	3832622	3834191	1569	+	148
AT1G11390	1	3834458	3837629	3171	-	320
AT1G11400	1	3837820	3840207	2387	+	316
AT1G11410	1	3841285	3844432	3147	+	871
AT1G11420	1	3844580	3846872	2292	-	73
AT1G11430	1	3847242	3849162	1920	+	2568
AT1G11440	1	3849359	3850662	1303	+	338
AT1G11450	1	3853242	3855385	2143	+	28
AT1G11460	1	3857004	3859268	2264	+	1
AT1G11470	1	3859661	3860604	943	-	0
AT1G11475	1	3862398	3864030	1632	+	369
AT1G11480	1	3864152	3866969	2817	-	899
AT1G11482	1	3867404	3868870	1466	-	5
AT1G11490	1	3868883	3870065	1182	-	5
AT1G11500	1	3870832	3871570	738	+	8
AT1G11510	1	3871777	3872836	1059	-	0
AT1G11520	1	3873028	3873619	591	+	0
AT1G11530	1	3874436	3875484	1048	+	215
AT1G11540	1	3875441	3877155	1714	-	0
AT1G11545	1	3878549	3880361	1812	-	356
AT1G11550	1	3881528	3881608	80	+	0
AT1G11560	1	3881787	3882819	1032	+	2
AT1G11570	1	3883279	3883956	677	+	17
AT1G11572	1	3884355	3884952	597	+	1
AT1G11580	1	3888689	3890811	2122	+	699
AT1G11590	1	3892579	3894677	2098	+	4
AT1G11592	1	3895178	3896934	1756	-	147
AT1G11593	1	3898001	3898609	608	+	0
AT1G11595	1	3898630	3899699	1069	+	0
AT1G11600	1	3902011	3903782	1771	+	401
AT1G11608	1	3905578	3906818	1240	+	0
AT1G11610	1	3906861	3909338	2477	-	0
AT1G11620	1	3910832	3911924	1092	+	0
AT1G11630	1	3912901	3914407	1506	-	165
AT1G11640	1	3914628	3914700	72	-	0
AT1G11650	1	3914773	3918176	3403	+	4135
AT1G11655	1	3919271	3919774	503	+	0
AT1G11660	1	3920542	3924555	4013	+	790
AT1G11670	1	3928161	3931576	3415	-	212
AT1G11680	1	3938500	3940754	2254	+	1847
AT1G11684	1	3941102	3941300	198	-	0
AT1G11690	1	3941468	3942212	744	+	0
AT1G11700	1	3945736	3946613	877	+	858
AT1G11710	1	3948713	3951359	2646	+	77
AT1G11720	1	3951552	3957044	5492	+	3229
AT1G11730	1	3957472	3960113	2641	+	72
AT1G11735	1	3961347	3961464	117	-	3
AT1G11740	1	3963053	3966824	3771	-	11
AT1G11750	1	3967475	3969877	2402	+	3313
AT1G11755	1	3969680	3971840	2160	-	122
AT1G11760	1	3972031	3973286	1255	-	102
AT1G11765	1	3973874	3974509	635	+	0
AT1G11770	1	3975678	3977379	1701	+	0
AT1G11780	1	3976838	3979195	2357	-	270
AT1G11785	1	3979861	3980956	1095	-	17
AT1G11790	1	3981247	3985215	3968	+	860
AT1G11800	1	3985224	3987290	2066	-	179
AT1G11803	1	3987754	3988030	276	-	0
AT1G11806	1	3988345	3989398	1053	+	0
AT1G11810	1	3989762	3991066	1304	+	0
AT1G11820	1	3991026	3993598	2572	-	1189
AT1G11840	1	3995168	3997907	2739	+	7673
AT1G11850	1	3999198	3999876	678	+	783
AT1G11860	1	4001112	4003442	2330	+	49095
AT1G11870	1	4003845	4006739	2894	+	918
AT1G11880	1	4007704	4010433	2729	-	125
AT1G11890	1	4010778	4013125	2347	+	608
AT1G11900	1	4013120	4014681	1561	-	79
AT1G11905	1	4014846	4016540	1694	+	163
AT1G11910	1	4016783	4020983	4200	-	9520
AT1G11915	1	4021824	4023292	1468	+	26
AT1G11920	1	4023666	4025097	1431	-	1
AT1G11925	1	4025929	4026732	803	-	0
AT1G11930	1	4028691	4030584	1893	+	1523
AT1G11940	1	4031573	4034078	2505	-	93
AT1G11950	1	4034586	4038758	4172	-	104
AT1G11960	1	4039710	4043880	4170	-	211
AT1G11970	1	4044369	4044669	300	+	0
AT1G11980	1	4045618	4045855	237	+	0
AT1G11990	1	4046245	4049060	2815	-	16
AT1G12000	1	4049895	4053835	3940	-	1429
AT1G12010	1	4056206	4057933	1727	+	107
AT1G12013	1	4058286	4058416	130	+	2
AT1G12015	1	4058486	4058576	90	+	0
AT1G12020	1	4062461	4063337	876	-	203
AT1G12030	1	4064666	4066341	1675	-	6
AT1G12040	1	4070123	4072567	2444	+	0
AT1G12050	1	4072751	4076207	3456	+	983
AT1G12060	1	4076333	4076981	648	+	103
AT1G12064	1	4077497	4078095	598	-	0
AT1G12070	1	4078912	4080106	1194	-	3
AT1G12080	1	4084161	4085045	884	+	295
AT1G12090	1	4089846	4090725	879	-	15393
AT1G12100	1	4095245	4095845	600	+	16
AT1G12110	1	4105232	4109545	4313	+	2253
AT1G12120	1	4114770	4117594	2824	-	731
AT1G12130	1	4118593	4120871	2278	+	0
AT1G12140	1	4121368	4124595	3227	+	1070
AT1G12150	1	4123529	4125648	2119	-	17
AT1G12160	1	4126065	4128310	2245	+	20
AT1G12170	1	4128606	4129701	1095	-	0
AT1G12180	1	4130420	4131137	717	+	0
AT1G12190	1	4132966	4134094	1128	-	0
AT1G12200	1	4137532	4140028	2496	+	240
AT1G12210	1	4140947	4143605	2658	+	46
AT1G12211	1	4143865	4144114	249	-	0
AT1G12220	1	4144571	4147911	3340	+	216
AT1G12230	1	4147961	4151056	3095	+	1635
AT1G12240	1	4153651	4157644	3993	+	3060
AT1G12244	1	4157653	4159046	1393	+	317
AT1G12250	1	4159264	4161455	2191	+	1761
AT1G12260	1	4162831	4165852	3021	-	47
AT1G12270	1	4172074	4174775	2701	+	897
AT1G12280	1	4174874	4177559	2685	-	482
AT1G12290	1	4178358	4182593	4235	-	78
AT1G12294	1	4182131	4182299	168	-	0
AT1G12300	1	4183065	4186124	3059	-	84
AT1G12310	1	4187164	4188056	892	-	1121
AT1G12320	1	4189354	4190342	988	+	114
AT1G12330	1	4194657	4196749	2092	+	598
AT1G12340	1	4197395	4198310	915	+	1
AT1G12350	1	4198412	4200802	2390	+	461
AT1G12360	1	4200875	4206404	5529	+	1075
AT1G12370	1	4206373	4208951	2578	-	157
AT1G12380	1	4214261	4217132	2871	-	293
AT1G12390	1	4220099	4221774	1675	+	124
AT1G12400	1	4221862	4222837	975	+	99
AT1G12410	1	4223029	4225124	2095	+	3470
AT1G12411	1	4225320	4225482	162	-	0
AT1G12420	1	4226361	4229138	2777	-	177
AT1G12423	1	4231026	4231146	120	-	0
AT1G12430	1	4233872	4238764	4892	-	672
AT1G12440	1	4241591	4243008	1417	-	1160
AT1G12450	1	4244307	4245993	1686	+	136
AT1G12451	1	4246108	4246291	183	-	0
AT1G12460	1	4247248	4250630	3382	+	427
AT1G12470	1	4251031	4257392	6361	+	867
AT1G12480	1	4257267	4259300	2033	-	174
AT1G12490	1	4260782	4261869	1087	+	1
AT1G12500	1	4263149	4265044	1895	-	796
AT1G12510	1	4266987	4267061	74	-	0
AT1G12520	1	4267105	4268926	1821	-	405
AT1G12530	1	4268985	4270787	1802	-	244
AT1G12540	1	4272959	4274206	1247	+	0
AT1G12550	1	4274593	4275981	1388	+	224
AT1G12560	1	4276518	4277899	1381	+	0
AT1G12570	1	4277992	4280862	2870	-	157
AT1G12580	1	4282898	4285829	2931	+	736
AT1G12590	1	4285886	4285958	72	-	0
AT1G12600	1	4286203	4288878	2675	-	7
AT1G12610	1	4289943	4291017	1074	-	0
AT1G12620	1	4294593	4297084	2491	-	141
AT1G12630	1	4298888	4299475	587	+	10
AT1G12640	1	4303311	4305798	2487	-	731
AT1G12650	1	4305932	4308005	2073	+	314
AT1G12660	1	4308942	4309583	641	+	0
AT1G12663	1	4310968	4311457	489	+	0
AT1G12665	1	4312330	4312935	605	+	0
AT1G12667	1	4313857	4314204	347	+	0
AT1G12669	1	4315465	4315987	522	+	0
AT1G12670	1	4316700	4317005	305	+	1
AT1G12672	1	4318308	4319090	782	+	5
AT1G12680	1	4319885	4322945	3060	-	426
AT1G12700	1	4323555	4326333	2778	-	130
AT1G12710	1	4326738	4328481	1743	-	147
AT1G12720	1	4331061	4333220	2159	+	0
AT1G12725	1	4333382	4334033	651	-	0
AT1G12730	1	4334614	4337844	3230	+	124
AT1G12740	1	4342281	4344857	2576	+	1
AT1G12750	1	4344984	4348328	3344	-	599
AT1G12760	1	4348497	4350867	2370	+	875
AT1G12770	1	4351063	4353685	2622	+	1281
AT1G12775	1	4353905	4355929	2024	+	76
AT1G12780	1	4355925	4358328	2403	-	673
AT1G12790	1	4359150	4361272	2122	-	76
AT1G12800	1	4361550	4365331	3781	-	8488
AT1G12805	1	4366596	4367119	523	+	1
AT1G12810	1	4367255	4368822	1567	+	386
AT1G12820	1	4368759	4371293	2534	-	1450
AT1G12830	1	4374249	4375170	921	-	277
AT1G12840	1	4375514	4378514	3000	+	3668
AT1G12845	1	4378938	4379516	578	-	170
AT1G12850	1	4379706	4381612	1906	-	597
AT1G12855	1	4382159	4383611	1452	+	5
AT1G12860	1	4384352	4386610	2258	+	1180
AT1G12870	1	4387128	4389110	1982	-	0
AT1G12880	1	4389750	4391151	1401	+	320
AT1G12890	1	4391733	4392393	660	+	2
AT1G12900	1	4392449	4394400	1951	-	80694
AT1G12910	1	4394896	4396291	1395	-	361
AT1G12920	1	4396347	4398193	1846	-	1271
AT1G12930	1	4398374	4405605	7231	-	723
AT1G12935	1	4406317	4406746	429	-	0
AT1G12938	1	4412886	4413057	171	+	0
AT1G12940	1	4416404	4418590	2186	+	0
AT1G12950	1	4419769	4422638	2869	+	18
AT1G12960	1	4422706	4423155	449	-	0
AT1G12970	1	4423639	4425789	2150	+	147
AT1G12980	1	4429717	4430965	1248	+	1
AT1G12990	1	4433639	4436075	2436	+	500
AT1G13000	1	4436104	4439476	3372	-	310
AT1G13010	1	4440213	4440286	73	+	0
AT1G13020	1	4440543	4443684	3141	-	893
AT1G13030	1	4444042	4447406	3364	-	203
AT1G13040	1	4447646	4449200	1554	+	62
AT1G13050	1	4450237	4451742	1505	+	57
AT1G13060	1	4452211	4454876	2665	+	1826
AT1G13070	1	4455476	4457099	1623	+	1
AT1G13080	1	4459165	4460940	1775	+	1854
AT1G13090	1	4461805	4463543	1738	+	1514
AT1G13100	1	4463923	4465538	1615	+	188
AT1G13110	1	4467219	4469033	1814	+	1576
AT1G13120	1	4469180	4473213	4033	-	442
AT1G13130	1	4474719	4477941	3222	+	36
AT1G13140	1	4478490	4480327	1837	-	32
AT1G13145	1	4480859	4481334	475	+	62
AT1G13150	1	4481874	4483696	1822	-	56
AT1G13160	1	4484583	4488577	3994	+	509
AT1G13170	1	4488532	4492587	4055	-	718
AT1G13180	1	4495027	4498469	3442	+	146
AT1G13190	1	4498880	4501613	2733	+	814
AT1G13195	1	4501580	4503591	2011	-	158
AT1G13200	1	4507220	4508528	1308	-	0
AT1G13210	1	4508962	4513938	4976	-	548
AT1G13220	1	4515605	4520284	4679	+	658
AT1G13230	1	4520630	4522544	1914	+	8
AT1G13240	1	4522708	4522782	74	-	0
AT1G13245	1	4525485	4526064	579	-	779
AT1G13250	1	4528622	4530063	1441	-	420
AT1G13260	1	4542167	4543742	1575	+	262
AT1G13270	1	4544952	4547312	2360	+	559
AT1G13280	1	4547453	4548875	1422	+	623
AT1G13290	1	4550152	4551620	1468	-	0
AT1G13300	1	4556891	4558708	1817	+	1
AT1G13310	1	4561067	4563061	1994	-	8
AT1G13320	1	4563470	4567807	4337	-	1282
AT1G13330	1	4567934	4570598	2664	+	25
AT1G13340	1	4569447	4571118	1671	-	50
AT1G13350	1	4572418	4576632	4214	-	731
AT1G13360	1	4576872	4577967	1095	-	1713
AT1G13370	1	4587779	4588613	834	-	13
AT1G13380	1	4589070	4590423	1353	-	340
AT1G13390	1	4592480	4594391	1911	-	415
AT1G13400	1	4597626	4598911	1285	+	3
AT1G13410	1	4601260	4603298	2038	+	6
AT1G13420	1	4604840	4606053	1213	+	5
AT1G13430	1	4606499	4607747	1248	+	8
AT1G13440	1	4608195	4610647	2452	-	27757
AT1G13448	1	4612242	4612929	687	+	52
AT1G13450	1	4612730	4615353	2623	-	527
AT1G13460	1	4615812	4618329	2517	+	479
AT1G13470	1	4620227	4621580	1353	-	99
AT1G13480	1	4622633	4624070	1437	-	1
AT1G13485	1	4624170	4624344	174	-	0
AT1G13490	1	4624714	4626064	1350	-	0
AT1G13500	1	4627788	4629169	1381	-	0
AT1G13510	1	4629202	4630821	1619	-	3
AT1G13520	1	4631777	4633248	1471	-	2
AT1G13530	1	4633739	4635129	1390	-	1
AT1G13540	1	4635462	4636805	1343	-	10
AT1G13550	1	4636983	4638330	1347	-	0
AT1G13560	1	4638513	4642104	3591	-	1496
AT1G13570	1	4642345	4644422	2077	-	257
AT1G13580	1	4644520	4647007	2487	-	181
AT1G13590	1	4647948	4648740	792	+	0
AT1G13600	1	4650786	4651469	683	-	32
AT1G13605	1	4658537	4659106	569	+	0
AT1G13607	1	4660777	4661218	441	+	0
AT1G13608	1	4661681	4662029	348	+	1
AT1G13609	1	4662720	4663219	499	+	12
AT1G13610	1	4663830	4666031	2201	-	7
AT1G13620	1	4668442	4669471	1029	+	0
AT1G13630	1	4669783	4672957	3174	-	42
AT1G13635	1	4674151	4676170	2019	+	4
AT1G13640	1	4677026	4679812	2786	-	617
AT1G13650	1	4680431	4682196	1765	-	4962
AT1G13660	1	4683170	4685640	2470	+	0
AT1G13670	1	4688155	4688966	811	+	12
AT1G13680	1	4690408	4692841	2433	+	1
AT1G13690	1	4693288	4694410	1122	+	350
AT1G13700	1	4694371	4696023	1652	-	73
AT1G13710	1	4702724	4704657	1933	-	119
AT1G13720	1	4709634	4709706	72	+	0
AT1G13730	1	4709823	4712550	2727	+	745
AT1G13740	1	4713673	4715407	1734	+	98
AT1G13750	1	4715393	4718235	2842	-	253
AT1G13755	1	4718672	4719354	682	-	0
AT1G13760	1	4720242	4721342	1100	-	0
AT1G13770	1	4721694	4724510	2816	+	344
AT1G13780	1	4724607	4726499	1892	+	139
AT1G13790	1	4727437	4730425	2988	+	119
AT1G13800	1	4731055	4733707	2652	-	26
AT1G13810	1	4734035	4735389	1354	+	69
AT1G13820	1	4735546	4737808	2262	+	1984
AT1G13830	1	4739872	4741038	1166	-	4
AT1G13840	1	4741998	4742071	73	+	0
AT1G13850	1	4743094	4743167	73	+	0
AT1G13860	1	4743204	4746956	3752	-	500
AT1G13870	1	4747264	4748642	1378	-	258
AT1G13880	1	4748872	4751212	2340	+	404
AT1G13890	1	4751580	4752844	1264	+	0
AT1G13900	1	4753144	4755580	2436	-	608
AT1G13910	1	4755783	4757991	2208	+	197
AT1G13920	1	4758187	4759754	1567	+	124
AT1G13930	1	4761011	4762666	1655	+	13046
AT1G13940	1	4762702	4766749	4047	-	456
AT1G13950	1	4773575	4774867	1292	+	116
AT1G13960	1	4776462	4779400	2938	+	265
AT1G13970	1	4779522	4782542	3020	-	75
AT1G13980	1	4788462	4794654	6192	+	826
AT1G13990	1	4794755	4796597	1842	+	391
AT1G14000	1	4797357	4800283	2926	+	1398
AT1G14010	1	4800168	4801850	1682	-	314
AT1G14020	1	4802719	4805375	2656	+	345
AT1G14030	1	4805305	4807517	2212	-	1404
AT1G14040	1	4810487	4814543	4056	+	42
AT1G14048	1	4815682	4815988	306	-	0
AT1G14060	1	4817143	4818020	877	-	126
AT1G14070	1	4818547	4820150	1603	+	121
AT1G14071	1	4820404	4820499	95	-	2
AT1G14080	1	4822527	4824414	1887	+	1
AT1G14090	1	4824432	4827436	3004	-	69
AT1G14100	1	4827960	4829587	1627	+	3
AT1G14110	1	4830296	4831915	1619	+	0
AT1G14120	1	4833517	4835089	1572	-	4
AT1G14130	1	4835723	4837616	1893	-	124
AT1G14140	1	4837926	4839633	1707	-	262
AT1G14150	1	4839852	4840751	899	+	2612
AT1G14160	1	4840696	4841848	1152	-	0
AT1G14170	1	4843233	4845847	2614	-	48
AT1G14180	1	4847161	4849207	2046	+	169
AT1G14182	1	4849447	4849826	379	-	2
AT1G14185	1	4850273	4852096	1823	+	12
AT1G14190	1	4852801	4854307	1506	+	65
AT1G14200	1	4854383	4855200	817	-	149
AT1G14205	1	4855532	4856930	1398	+	53
AT1G14210	1	4856777	4857964	1187	-	233
AT1G14220	1	4858641	4859601	960	-	1
AT1G14225	1	4860514	4860649	135	-	0
AT1G14230	1	4861265	4864094	2829	+	229
AT1G14240	1	4864901	4868000	3099	+	8
AT1G14250	1	4868451	4871488	3037	+	40
AT1G14260	1	4872855	4874907	2052	+	20
AT1G14270	1	4874874	4877248	2374	-	1897
AT1G14280	1	4877626	4879149	1523	+	1309
AT1G14290	1	4880050	4881964	1914	-	374
AT1G14300	1	4882375	4884791	2416	-	159
AT1G14310	1	4885043	4886793	1750	+	373
AT1G14315	1	4886767	4887933	1166	-	0
AT1G14320	1	4888213	4889661	1448	+	7510
AT1G14330	1	4890117	4892251	2134	-	236
AT1G14340	1	4897345	4898961	1616	+	298
AT1G14345	1	4899144	4899979	835	+	2996
AT1G14350	1	4907952	4911168	3216	+	298
AT1G14360	1	4911092	4913152	2060	-	392
AT1G14370	1	4915575	4918138	2563	+	121
AT1G14380	1	4918009	4921596	3587	-	629
AT1G14390	1	4924276	4926794	2518	+	10
AT1G14400	1	4927010	4928690	1680	-	2215
AT1G14410	1	4929122	4930904	1782	-	707
AT1G14420	1	4931565	4933515	1950	-	4
AT1G14430	1	4934119	4936100	1981	+	187
AT1G14440	1	4938823	4940903	2080	-	294
AT1G14450	1	4946217	4947576	1359	-	730
AT1G14455	1	4947818	4948400	582	-	2
AT1G14460	1	4948747	4952927	4180	-	572
AT1G14470	1	4954079	4955702	1623	+	11
AT1G14480	1	4956256	4958076	1820	+	24
AT1G14490	1	4958513	4959325	812	-	22
AT1G14500	1	4960374	4961780	1406	+	0
AT1G14510	1	4961885	4964428	2543	-	780
AT1G14518	1	4966809	4967493	684	-	0
AT1G14520	1	4968141	4970311	2170	-	40
AT1G14530	1	4970857	4973726	2869	-	156
AT1G14540	1	4974066	4975705	1639	-	1
AT1G14549	1	4978793	4978907	114	-	0
AT1G14550	1	4979027	4980324	1297	+	0
AT1G14560	1	4980671	4983284	2613	+	337
AT1G14570	1	4983534	4987375	3841	+	1043
AT1G14580	1	4989561	4992732	3171	+	726
AT1G14590	1	4998815	5000643	1828	-	195
AT1G14600	1	5001010	5003370	2360	-	57
AT1G14610	1	5008243	5014533	6290	-	2407
AT1G14620	1	5014752	5016604	1852	-	263
AT1G14630	1	5019954	5021537	1583	+	88
AT1G14640	1	5023655	5025955	2300	+	97
AT1G14642	1	5026363	5026585	222	+	9
AT1G14650	1	5027661	5031779	4118	+	1238
AT1G14660	1	5031949	5036477	4528	-	197
AT1G14670	1	5037611	5040528	2917	+	1783
AT1G14680	1	5040860	5041733	873	+	17
AT1G14685	1	5042322	5044294	1972	+	521
AT1G14686	1	5045780	5046800	1020	-	3
AT1G14687	1	5047802	5048612	810	+	19
AT1G14688	1	5049525	5050983	1458	-	1
AT1G14690	1	5051759	5055252	3493	-	884
AT1G14700	1	5058679	5061136	2457	+	907
AT1G14710	1	5061865	5065178	3313	-	1213
AT1G14720	1	5066635	5068645	2010	-	657
AT1G14730	1	5073104	5074779	1675	+	49
AT1G14740	1	5075212	5077791	2579	-	909
AT1G14750	1	5079406	5082520	3114	-	21
AT1G14755	1	5083741	5084342	601	+	0
AT1G14760	1	5084351	5085213	862	-	9
AT1G14770	1	5086625	5088846	2221	-	134
AT1G14780	1	5090989	5094152	3163	+	14
AT1G14790	1	5093960	5098032	4072	-	382
AT1G14800	1	5099571	5102558	2987	+	0
AT1G14810	1	5102423	5104695	2272	-	1776
AT1G14820	1	5105017	5106954	1937	-	221
AT1G14830	1	5107420	5111670	4250	-	1500
AT1G14840	1	5111954	5115497	3543	-	1155
AT1G14850	1	5116695	5123259	6564	-	535
AT1G14860	1	5124741	5126151	1410	+	3
AT1G14870	1	5128374	5129523	1149	-	10
AT1G14880	1	5132534	5133716	1182	-	209
AT1G14890	1	5137013	5137957	944	+	181
AT1G14900	1	5138333	5139432	1099	-	381
AT1G14910	1	5139711	5143689	3978	-	802
AT1G14920	1	5149225	5151354	2129	+	1028
AT1G14930	1	5152262	5153084	822	-	0
AT1G14940	1	5154536	5155564	1028	-	0
AT1G14950	1	5157335	5158269	934	-	0
AT1G14960	1	5159198	5160083	885	-	0
AT1G14970	1	5161948	5164917	2969	-	174
AT1G14980	1	5165627	5166745	1118	-	1243
AT1G14990	1	5167030	5168264	1234	-	150
AT1G15000	1	5168595	5170066	1471	+	273
AT1G15002	1	5169939	5170435	496	-	1
AT1G15010	1	5171206	5171742	536	+	9
AT1G15015	1	5172080	5172923	843	+	10
AT1G15020	1	5173096	5176223	3127	-	417
AT1G15030	1	5177528	5180049	2521	+	881
AT1G15040	1	5179886	5181389	1503	-	5
AT1G15045	1	5181856	5181964	108	+	0
AT1G15050	1	5182255	5183243	988	-	7
AT1G15060	1	5183606	5186974	3368	-	991
AT1G15080	1	5187625	5189673	2048	+	97
AT1G15090	1	5189686	5189760	74	-	4
AT1G15100	1	5193425	5194203	778	-	209
AT1G15110	1	5199017	5202175	3158	+	124
AT1G15120	1	5202647	5204193	1546	+	1886
AT1G15125	1	5204624	5205912	1288	+	90
AT1G15130	1	5206001	5209915	3914	-	1283
AT1G15140	1	5210205	5212349	2144	-	2188
AT1G15150	1	5212614	5214858	2244	+	17
AT1G15160	1	5215474	5217545	2071	+	58
AT1G15165	1	5217718	5220113	2395	-	112
AT1G15170	1	5220640	5222973	2333	+	222
AT1G15175	1	5222912	5224121	1209	-	93
AT1G15180	1	5224384	5226702	2318	+	909
AT1G15190	1	5227052	5228202	1150	+	5
AT1G15200	1	5228299	5231184	2885	-	1057
AT1G15210	1	5231347	5236573	5226	-	12
AT1G15215	1	5238064	5240051	1987	+	180
AT1G15220	1	5240028	5241538	1510	-	91
AT1G15230	1	5242197	5243227	1030	-	344
AT1G15240	1	5243449	5248604	5155	+	973
AT1G15250	1	5248663	5249474	811	-	236
AT1G15260	1	5249759	5250573	814	+	825
AT1G15270	1	5250649	5252121	1472	-	2617
AT1G15280	1	5252314	5256753	4439	+	1170
AT1G15290	1	5257045	5264942	7897	-	6071
AT1G15300	1	5265725	5268602	2877	-	68
AT1G15310	1	5269018	5272058	3040	-	67
AT1G15320	1	5272255	5274074	1819	-	0
AT1G15330	1	5274345	5275602	1257	+	1
AT1G15340	1	5275676	5277689	2013	-	2652
AT1G15350	1	5278259	5279877	1618	-	244
AT1G15360	1	5283537	5284673	1136	+	1
AT1G15370	1	5287046	5288577	1531	+	684
AT1G15380	1	5290744	5292535	1791	+	2
AT1G15385	1	5292755	5293265	510	-	0
AT1G15390	1	5294628	5295797	1169	+	656
AT1G15400	1	5295772	5296902	1130	-	515
AT1G15405	1	5297874	5298166	292	-	38
AT1G15410	1	5298323	5300927	2604	+	790
AT1G15415	1	5300741	5301412	671	-	3
AT1G15420	1	5301612	5303390	1778	-	250
AT1G15430	1	5304316	5306012	1696	+	136
AT1G15440	1	5306060	5309514	3454	-	291
AT1G15450	1	5309646	5309718	72	-	0
AT1G15460	1	5310000	5314094	4094	-	0
AT1G15470	1	5315506	5317863	2357	+	292
AT1G15480	1	5318010	5320594	2584	+	113
AT1G15490	1	5320614	5323895	3281	-	283
AT1G15500	1	5326289	5328874	2585	+	3838
AT1G15510	1	5329110	5331711	2601	+	168
AT1G15520	1	5331857	5338326	6469	-	107
AT1G15530	1	5339960	5341931	1971	-	192
AT1G15540	1	5342586	5343705	1119	+	0
AT1G15550	1	5344477	5346166	1689	-	495
AT1G15560	1	5352654	5354314	1660	-	1
AT1G15570	1	5362008	5365549	3541	+	351
AT1G15580	1	5365664	5366497	833	-	45
AT1G15590	1	5367296	5368670	1374	+	0
AT1G15600	1	5368922	5370344	1422	+	0
AT1G15610	1	5370676	5371859	1183	+	0
AT1G15620	1	5373503	5374575	1072	+	2
AT1G15630	1	5376792	5378027	1235	+	0
AT1G15640	1	5378885	5380139	1254	+	0
AT1G15650	1	5380906	5380988	82	+	0
AT1G15660	1	5381169	5385254	4085	+	394
AT1G15670	1	5389951	5391490	1539	+	34
AT1G15680	1	5393406	5394639	1233	+	0
AT1G15690	1	5398989	5402733	3744	+	17711
AT1G15700	1	5402568	5403818	1250	-	106
AT1G15710	1	5404357	5405686	1329	+	589
AT1G15720	1	5406024	5407486	1462	+	48
AT1G15730	1	5407400	5409987	2587	-	1387
AT1G15740	1	5410907	5414919	4012	+	1715
AT1G15750	1	5414816	5421033	6217	-	2965
AT1G15757	1	5424241	5424576	335	-	0
AT1G15760	1	5425713	5426322	609	+	30
AT1G15770	1	5426891	5428280	1389	-	1
AT1G15772	1	5428519	5429561	1042	-	0
AT1G15780	1	5430182	5436412	6230	-	1184
AT1G15790	1	5438252	5440087	1835	-	68
AT1G15800	1	5441081	5443684	2603	-	23
AT1G15810	1	5444417	5446564	2147	+	373
AT1G15820	1	5446461	5447859	1398	-	181795
AT1G15825	1	5448148	5448529	381	-	127
AT1G15830	1	5448725	5450177	1452	+	414
AT1G15840	1	5451431	5452374	943	+	0
AT1G15850	1	5453244	5454088	844	-	0
AT1G15860	1	5454784	5457022	2238	+	616
AT1G15870	1	5457083	5458429	1346	+	20
AT1G15880	1	5458534	5460333	1799	-	510
AT1G15885	1	5460476	5461281	805	+	88
AT1G15890	1	5461316	5464223	2907	+	40
AT1G15900	1	5464355	5464697	342	+	3
AT1G15910	1	5465335	5469125	3790	+	422
AT1G15920	1	5469388	5471149	1761	+	279
AT1G15930	1	5471399	5473014	1615	+	2749
AT1G15940	1	5473564	5478259	4695	+	787
AT1G15950	1	5478753	5482180	3427	+	2002
AT1G15960	1	5481664	5485082	3418	-	421
AT1G15970	1	5486318	5488868	2550	-	386
AT1G15980	1	5489297	5491363	2066	+	10177
AT1G15990	1	5491303	5493772	2469	-	5
AT1G16000	1	5494532	5495359	827	+	137
AT1G16010	1	5495372	5497723	2351	-	880
AT1G16020	1	5498164	5501358	3194	+	594
AT1G16022	1	5501395	5501959	564	-	4
AT1G16025	1	5501504	5501959	455	+	0
AT1G16030	1	5502205	5504535	2330	-	129
AT1G16040	1	5504734	5506611	1877	+	178
AT1G16060	1	5508506	5511735	3229	+	142
AT1G16070	1	5511872	5513896	2024	-	70
AT1G16080	1	5514316	5516027	1711	+	5935
AT1G16090	1	5516258	5517822	1564	+	179
AT1G16100	1	5518061	5518134	73	-	0
AT1G16110	1	5518372	5520891	2519	+	113
AT1G16120	1	5522638	5524983	2345	+	1
AT1G16130	1	5525490	5528212	2722	+	8
AT1G16140	1	5528964	5531255	2291	+	0
AT1G16150	1	5532414	5534877	2463	+	1
AT1G16160	1	5535972	5538269	2297	+	0
AT1G16170	1	5538731	5539821	1090	-	224
AT1G16180	1	5540426	5542902	2476	+	2503
AT1G16190	1	5543151	5546103	2952	+	427
AT1G16210	1	5546127	5547552	1425	-	896
AT1G16220	1	5548652	5550553	1901	+	83
AT1G16225	1	5551040	5552097	1057	-	1
AT1G16230	1	5553466	5554324	858	-	0
AT1G16240	1	5555006	5556841	1835	-	828
AT1G16250	1	5556988	5559520	2532	+	178
AT1G16260	1	5559578	5562113	2535	-	643
AT1G16270	1	5563086	5568368	5282	+	774
AT1G16280	1	5568481	5570487	2006	-	202
AT1G16290	1	5570752	5573538	2786	-	3
AT1G16300	1	5574309	5577622	3313	+	194
AT1G16310	1	5578430	5580693	2263	+	110
AT1G16320	1	5580854	5582143	1289	+	1301
AT1G16330	1	5582386	5587391	5005	-	68
AT1G16340	1	5587789	5590651	2862	-	340
AT1G16350	1	5590950	5593007	2057	+	962
AT1G16360	1	5593300	5595179	1879	-	7
AT1G16370	1	5596693	5598447	1754	+	1
AT1G16380	1	5598452	5601367	2915	-	0
AT1G16390	1	5602872	5604663	1791	+	213
AT1G16400	1	5605158	5607473	2315	+	290
AT1G16410	1	5608806	5611426	2620	+	6117
AT1G16420	1	5612149	5613867	1718	-	12
AT1G16430	1	5614618	5615510	892	+	104
AT1G16440	1	5615814	5617672	1858	+	4
AT1G16445	1	5617810	5619334	1524	+	76
AT1G16450	1	5619470	5619543	73	-	0
AT1G16460	1	5619581	5622663	3082	-	1273
AT1G16470	1	5622785	5625643	2858	+	1196
AT1G16480	1	5625698	5628656	2958	-	45
AT1G16489	1	5629215	5630488	1273	+	5
AT1G16490	1	5629654	5630995	1341	-	43
AT1G16500	1	5639031	5640173	1142	+	113
AT1G16510	1	5644571	5645443	872	-	18
AT1G16515	1	5647548	5647813	265	-	43
AT1G16520	1	5648759	5651167	2408	+	282
AT1G16530	1	5651369	5652883	1514	-	32
AT1G16540	1	5659414	5665449	6035	+	204
AT1G16550	1	5665906	5668209	2303	+	75
AT1G16560	1	5668383	5670708	2325	+	671
AT1G16570	1	5670576	5673600	3024	-	286
AT1G16590	1	5673794	5675131	1337	+	112
AT1G16600	1	5675168	5675433	265	+	0
AT1G16610	1	5675703	5678852	3149	-	721
AT1G16620	1	5679818	5681188	1370	+	0
AT1G16630	1	5682117	5684867	2750	-	169
AT1G16635	1	5685502	5686368	866	-	6
AT1G16640	1	5686602	5687715	1113	+	17
AT1G16650	1	5687942	5691198	3256	+	127
AT1G16660	1	5692023	5696458	4435	+	0
AT1G16670	1	5697323	5699769	2446	+	210
AT1G16680	1	5702752	5705838	3086	+	505
AT1G16690	1	5705968	5709533	3565	+	150
AT1G16700	1	5709724	5711902	2178	+	1197
AT1G16705	1	5712087	5713752	1665	+	8
AT1G16710	1	5714218	5722614	8396	+	1103
AT1G16720	1	5723087	5726478	3391	+	10502
AT1G16730	1	5726367	5727312	945	-	571
AT1G16740	1	5727689	5729080	1391	+	422
AT1G16750	1	5729096	5731870	2774	-	315
AT1G16760	1	5734233	5737307	3074	+	1
AT1G16770	1	5737877	5739377	1500	+	2
AT1G16780	1	5739298	5744214	4916	-	518
AT1G16790	1	5744552	5745209	657	+	210
AT1G16800	1	5745522	5755263	9741	-	245
AT1G16810	1	5755587	5756895	1308	+	812
AT1G16820	1	5756834	5758464	1630	-	30
AT1G16825	1	5758854	5760501	1647	+	109
AT1G16830	1	5760771	5762619	1848	+	23
AT1G16840	1	5762693	5764073	1380	-	461
AT1G16850	1	5764806	5765651	845	-	26
AT1G16858	1	5767299	5770602	3303	+	0
AT1G16860	1	5767299	5770602	3303	+	0
AT1G16870	1	5770731	5773251	2520	-	405
AT1G16880	1	5773591	5776308	2717	+	13916
AT1G16890	1	5776176	5778484	2308	-	1739
AT1G16900	1	5779020	5782433	3413	-	398
AT1G16905	1	5782454	5783840	1386	-	0
AT1G16910	1	5785002	5785927	925	+	2
AT1G16916	1	5786559	5787112	553	-	128
AT1G16920	1	5787329	5789249	1920	-	561
AT1G16930	1	5789986	5791534	1548	+	103
AT1G16940	1	5791982	5793491	1509	+	0
AT1G16950	1	5796008	5796559	551	+	0
AT1G16960	1	5799887	5800845	958	+	207
AT1G16970	1	5800766	5805799	5033	-	331
AT1G16980	1	5807310	5811488	4178	+	0
AT1G17000	1	5812727	5816662	3935	+	0
AT1G17010	1	5817566	5819352	1786	+	0
AT1G17020	1	5820205	5822013	1808	+	12
AT1G17030	1	5822367	5824455	2088	+	53
AT1G17040	1	5824847	5828233	3386	+	214
AT1G17050	1	5829079	5831343	2264	+	3212
AT1G17060	1	5832096	5835456	3360	-	35
AT1G17070	1	5837589	5840332	2743	+	221
AT1G17080	1	5840268	5841606	1338	-	664
AT1G17090	1	5842215	5844283	2068	-	56
AT1G17100	1	5844675	5845661	986	+	2279
AT1G17110	1	5845659	5850934	5275	-	1291
AT1G17120	1	5851952	5853955	2003	+	520
AT1G17130	1	5854147	5856697	2550	+	690
AT1G17140	1	5856572	5858550	1978	-	1123
AT1G17145	1	5860118	5862682	2564	-	388
AT1G17147	1	5863430	5864009	579	-	23
AT1G17150	1	5865706	5867495	1789	+	0
AT1G17160	1	5867634	5869356	1722	+	384
AT1G17170	1	5869845	5870840	995	+	13
AT1G17180	1	5872144	5873086	942	+	2
AT1G17190	1	5875349	5876545	1196	+	80
AT1G17200	1	5878399	5880041	1642	+	870
AT1G17210	1	5880129	5884756	4627	-	1461
AT1G17220	1	5885082	5890470	5388	+	13268
AT1G17230	1	5891323	5895075	3752	+	216
AT1G17232	1	5892299	5893652	1353	-	0
AT1G17235	1	5895350	5895710	360	+	5
AT1G17240	1	5896415	5898717	2302	-	22
AT1G17250	1	5901168	5903439	2271	-	0
AT1G17255	1	5899993	5903619	3626	+	20
AT1G17260	1	5904057	5908898	4841	+	56
AT1G17270	1	5909248	5911693	2445	-	143
AT1G17275	1	5912052	5915313	3261	+	0
AT1G17277	1	5915643	5916212	569	-	0
AT1G17280	1	5916870	5920089	3219	-	898
AT1G17285	1	5920773	5921415	642	+	4
AT1G17290	1	5922629	5926400	3771	+	3257
AT1G17300	1	5926993	5927784	791	+	0
AT1G17310	1	5928013	5928667	654	-	0
AT1G17330	1	5929908	5931831	1923	+	284
AT1G17340	1	5933869	5938761	4892	+	535
AT1G17345	1	5940422	5941210	788	+	6
AT1G17350	1	5941783	5944463	2680	+	235
AT1G17360	1	5946763	5951473	4710	+	2052
AT1G17370	1	5951541	5955037	3496	-	1833
AT1G17380	1	5955487	5957212	1725	-	12
AT1G17390	1	5958627	5959651	1024	-	0
AT1G17400	1	5960480	5962481	2001	-	6
AT1G17410	1	5968533	5969995	1462	-	108
AT1G17420	1	5977410	5981480	4070	+	416
AT1G17430	1	5982266	5984013	1747	+	117
AT1G17440	1	5983983	5987784	3801	-	943
AT1G17450	1	5988279	5996785	8506	-	417
AT1G17455	1	5997179	5998475	1296	+	72
AT1G17460	1	5998813	6002716	3903	+	54
AT1G17470	1	6002911	6006405	3494	+	1364
AT1G17480	1	6006460	6008266	1806	-	79
AT1G17490	1	6008588	6009420	832	+	237
AT1G17495	1	6009569	6013742	4173	-	0
AT1G17500	1	6018756	6023503	4747	+	402
AT1G17510	1	6023503	6024309	806	-	110
AT1G17520	1	6024635	6027385	2750	-	207
AT1G17530	1	6027630	6028506	876	+	315
AT1G17540	1	6029276	6032754	3478	-	1
AT1G17545	1	6033108	6033908	800	+	1
AT1G17550	1	6034361	6037289	2928	+	1261
AT1G17560	1	6037463	6038692	1229	-	110
AT1G17570	1	6038756	6038838	82	+	0
AT1G17580	1	6039302	6049556	10254	+	991
AT1G17590	1	6050192	6052568	2376	-	125
AT1G17600	1	6052935	6056664	3729	-	165
AT1G17610	1	6056894	6058357	1463	+	112
AT1G17615	1	6059440	6060667	1227	+	1
AT1G17620	1	6062215	6063291	1076	+	447
AT1G17630	1	6064524	6066720	2196	+	37
AT1G17640	1	6067393	6069098	1705	-	98
AT1G17650	1	6069476	6072012	2536	-	1718
AT1G17660	1	6075819	6075891	72	+	0
AT1G17665	1	6072252	6074484	2232	-	1
AT1G17670	1	6075944	6076018	74	-	0
AT1G17680	1	6076076	6082337	6261	+	463
AT1G17690	1	6082754	6088340	5586	-	445
AT1G17700	1	6089516	6090323	807	+	62
AT1G17710	1	6090559	6092027	1468	-	9
AT1G17720	1	6093207	6098383	5176	-	1338
AT1G17730	1	6099088	6100315	1227	+	629
AT1G17744	1	6100960	6101983	1023	-	0
AT1G17745	1	6100963	6105265	4302	+	641
AT1G17750	1	6106655	6110120	3465	+	73
AT1G17760	1	6110106	6116617	6511	-	510
AT1G17770	1	6120740	6122822	2082	+	0
AT1G17780	1	6123700	6125269	1569	+	286
AT1G17790	1	6125355	6127404	2049	-	203
AT1G17800	1	6128822	6129508	686	+	0
AT1G17810	1	6130024	6131627	1603	+	0
AT1G17820	1	6131536	6135345	3809	-	422
AT1G17830	1	6135802	6138432	2630	-	61
AT1G17840	1	6142563	6146521	3958	+	1931
AT1G17850	1	6145925	6148940	3015	-	470
AT1G17860	1	6149300	6150038	738	+	128
AT1G17870	1	6149938	6152222	2284	-	489
AT1G17880	1	6152408	6153982	1574	-	2753
AT1G17890	1	6154267	6155752	1485	-	656
AT1G17900	1	6157367	6158130	763	-	0
AT1G17910	1	6159125	6161615	2490	+	0
AT1G17920	1	6161871	6165382	3511	-	183
AT1G17930	1	6166219	6168839	2620	-	218
AT1G17940	1	6169340	6173222	3882	-	265
AT1G17950	1	6177616	6179289	1673	+	5
AT1G17960	1	6180895	6183806	2911	-	11
AT1G17970	1	6184903	6187472	2569	+	417
AT1G17980	1	6187506	6191708	4202	-	592
AT1G17990	1	6192070	6194093	2023	-	39
AT1G18000	1	6194542	6196229	1687	-	10
AT1G18010	1	6199897	6201484	1587	+	1
AT1G18020	1	6202248	6203918	1670	+	0
AT1G18030	1	6204342	6206988	2646	+	235
AT1G18040	1	6206870	6209500	2630	-	202
AT1G18050	1	6209770	6211588	1818	-	1
AT1G18060	1	6211872	6213444	1572	-	5267
AT1G18070	1	6213724	6218340	4616	-	2936
AT1G18075	1	6220647	6220833	186	+	46
AT1G18080	1	6222200	6224151	1951	+	6728
AT1G18090	1	6224500	6227822	3322	+	185
AT1G18100	1	6227216	6230188	2972	-	0
AT1G18120	1	6232091	6233926	1835	+	0
AT1G18130	1	6235894	6238799	2905	+	0
AT1G18140	1	6238843	6241436	2593	-	5
AT1G18150	1	6244297	6247812	3515	-	1426
AT1G18160	1	6248792	6254039	5247	+	996
AT1G18170	1	6254228	6255690	1462	+	1197
AT1G18180	1	6255829	6257900	2071	+	108
AT1G18190	1	6257850	6261457	3607	-	444
AT1G18191	1	6262053	6262330	277	-	0
AT1G18200	1	6265415	6266937	1522	-	15
AT1G18210	1	6266608	6268828	2220	-	652
AT1G18220	1	6269669	6269807	138	-	0
AT1G18230	1	6272665	6273307	642	-	0
AT1G18240	1	6274285	6275594	1309	-	0
AT1G18250	1	6276787	6278150	1363	-	548
AT1G18260	1	6278847	6282103	3256	-	799
AT1G18265	1	6282251	6283293	1042	-	109
AT1G18270	1	6283411	6293871	10460	-	1163
AT1G18280	1	6294332	6295364	1032	+	0
AT1G18290	1	6297363	6298328	965	+	1
AT1G18300	1	6299686	6301086	1400	+	71
AT1G18310	1	6301199	6303956	2757	-	0
AT1G18320	1	6304359	6305689	1330	+	11
AT1G18330	1	6305965	6308013	2048	-	316
AT1G18335	1	6309040	6311326	2286	-	228
AT1G18340	1	6311482	6313931	2449	-	221
AT1G18350	1	6315650	6316738	1088	+	1
AT1G18360	1	6316694	6319427	2733	-	1362
AT1G18370	1	6319649	6324222	4573	-	393
AT1G18382	1	6326365	6326699	334	-	0
AT1G18390	1	6325641	6330098	4457	+	41
AT1G18400	1	6331397	6333743	2346	+	31
AT1G18410	1	6336527	6342460	5933	-	7
AT1G18415	1	6343095	6345662	2567	-	44
AT1G18420	1	6343329	6345689	2360	+	4
AT1G18430	1	6345763	6345835	72	+	0
AT1G18440	1	6345973	6347910	1937	+	489
AT1G18450	1	6348106	6351975	3869	+	719
AT1G18460	1	6352469	6356113	3644	+	2072
AT1G18470	1	6356130	6360192	4062	-	638
AT1G18480	1	6361628	6363007	1379	+	202
AT1G18485	1	6363171	6366235	3064	+	363
AT1G18486	1	6366396	6366753	357	+	0
AT1G18490	1	6366519	6368849	2330	+	410
AT1G18500	1	6369346	6373025	3679	+	1300
AT1G18510	1	6373294	6374090	796	+	0
AT1G18520	1	6374931	6376316	1385	+	0
AT1G18530	1	6376782	6377256	474	+	2
AT1G18540	1	6377320	6378580	1260	-	4257
AT1G18550	1	6381502	6384340	2838	-	141
AT1G18560	1	6385448	6388080	2632	+	127
AT1G18570	1	6389410	6391267	1857	+	163
AT1G18580	1	6395863	6398239	2376	+	322
AT1G18590	1	6398579	6399942	1363	+	1393
AT1G18600	1	6400403	6402791	2388	+	427
AT1G18610	1	6405644	6409297	3653	+	216
AT1G18620	1	6409977	6414451	4474	+	2293
AT1G18630	1	6414724	6416459	1735	+	157
AT1G18640	1	6416356	6418690	2334	-	697
AT1G18650	1	6418857	6420557	1700	-	1021
AT1G18660	1	6421116	6425880	4764	+	1732
AT1G18670	1	6426897	6430696	3799	-	366
AT1G18680	1	6431937	6433464	1527	-	118
AT1G18690	1	6433573	6436922	3349	+	145
AT1G18700	1	6437476	6444076	6600	+	686
AT1G18710	1	6450593	6453114	2521	+	104
AT1G18720	1	6457820	6459751	1931	-	1050
AT1G18730	1	6460597	6462224	1627	+	3306
AT1G18735	1	6461231	6461752	521	-	0
AT1G18740	1	6463921	6465476	1555	+	469
AT1G18745	1	6465486	6466454	968	-	102
AT1G18750	1	6466760	6469984	3224	+	177
AT1G18760	1	6471149	6471824	675	-	1
AT1G18770	1	6473369	6474048	679	-	0
AT1G18773	1	6474801	6475904	1103	+	141
AT1G18780	1	6476257	6477235	978	-	0
AT1G18790	1	6478850	6480043	1193	-	0
AT1G18800	1	6481112	6483596	2484	-	419
AT1G18810	1	6485595	6487030	1435	-	629
AT1G18820	1	6488654	6488735	81	+	0
AT1G18830	1	6489308	6494218	4910	+	28
AT1G18835	1	6496097	6496396	299	-	16
AT1G18840	1	6500847	6504413	3566	-	708
AT1G18850	1	6504805	6506424	1619	-	129
AT1G18860	1	6509491	6511227	1736	+	0
AT1G18870	1	6515428	6519282	3854	+	172
AT1G18871	1	6519308	6519485	177	-	1
AT1G18879	1	6520940	6521124	184	+	0
AT1G18880	1	6520747	6523368	2621	+	133
AT1G18890	1	6522763	6525962	3199	-	514
AT1G18900	1	6528983	6532614	3631	+	403
AT1G18910	1	6532558	6538145	5587	-	179
AT1G18930	1	6542871	6543247	376	+	0
AT1G18940	1	6543851	6545592	1741	+	13
AT1G18950	1	6546398	6551887	5489	+	752
AT1G18960	1	6552751	6553940	1189	+	2
AT1G18970	1	6554567	6555377	810	-	2
AT1G18980	1	6557253	6558045	792	-	1
AT1G18990	1	6558677	6560489	1812	-	3
AT1G19000	1	6560791	6562786	1995	-	5055
AT1G19010	1	6565493	6567525	2032	+	165
AT1G19020	1	6568072	6568597	525	+	34
AT1G19025	1	6568852	6570939	2087	+	47
AT1G19030	1	6571183	6572937	1754	+	0
AT1G19040	1	6576894	6577413	519	+	0
AT1G19050	1	6577832	6579178	1346	-	603
AT1G19060	1	6582065	6583601	1536	-	0
AT1G19070	1	6584453	6584705	252	+	10
AT1G19080	1	6584240	6586517	2277	+	69
AT1G19086	1	6588541	6589338	797	+	0
AT1G19090	1	6590244	6592816	2572	+	0
AT1G19100	1	6594929	6601355	6426	+	265
AT1G19110	1	6602125	6605908	3783	+	1249
AT1G19115	1	6606236	6607943	1707	+	0
AT1G19120	1	6608114	6609369	1255	+	412
AT1G19130	1	6609324	6610613	1289	-	523
AT1G19140	1	6610720	6612516	1796	-	697
AT1G19150	1	6612748	6613972	1224	+	6392
AT1G19160	1	6614161	6615214	1053	-	0
AT1G19170	1	6616642	6618986	2344	+	279
AT1G19180	1	6622093	6623620	1527	+	19
AT1G19190	1	6623875	6624977	1102	+	3
AT1G19200	1	6625019	6625856	837	-	24
AT1G19210	1	6626821	6627530	709	-	9
AT1G19220	1	6628067	6633087	5020	-	439
AT1G19230	1	6644188	6649375	5187	+	24
AT1G19240	1	6649242	6650420	1178	-	106
AT1G19250	1	6650528	6653078	2550	-	8
AT1G19260	1	6657259	6659569	2310	-	1
AT1G19270	1	6662500	6666028	3528	+	266
AT1G19290	1	6666248	6668963	2715	+	122
AT1G19300	1	6671136	6672653	1517	-	127
AT1G19310	1	6676233	6677673	1440	-	223
AT1G19320	1	6679280	6680252	972	+	0
AT1G19330	1	6680562	6683533	2971	-	442
AT1G19340	1	6684750	6687116	2366	+	104
AT1G19350	1	6688521	6690414	1893	+	1156
AT1G19360	1	6690455	6692477	2022	-	461
AT1G19370	1	6692763	6694934	2171	-	127
AT1G19371	1	6695419	6695609	190	-	0
AT1G19373	1	6697177	6697253	76	+	0
AT1G19376	1	6697437	6697524	87	+	0
AT1G19380	1	6698057	6698824	767	+	29
AT1G19390	1	6700771	6703368	2597	-	1
AT1G19392	1	6708556	6709175	619	+	0
AT1G19394	1	6709772	6710670	898	+	18
AT1G19396	1	6709777	6711788	2011	+	34
AT1G19397	1	6710960	6711787	827	+	48
AT1G19400	1	6712037	6714252	2215	-	1425
AT1G19410	1	6714491	6716439	1948	-	0
AT1G19415	1	6719447	6720654	1207	+	3
AT1G19420	1	6721434	6723930	2496	+	33
AT1G19430	1	6724572	6728040	3468	-	604
AT1G19440	1	6728983	6730931	1948	+	475
AT1G19450	1	6731433	6734882	3449	-	2890
AT1G19460	1	6738483	6739734	1251	+	0
AT1G19464	1	6740499	6740591	92	+	0
AT1G19470	1	6741295	6742534	1239	+	0
AT1G19480	1	6744352	6746408	2056	+	175
AT1G19485	1	6746777	6751507	4730	+	595
AT1G19490	1	6751672	6753999	2327	-	143
AT1G19500	1	6754785	6755684	899	-	3
AT1G19510	1	6756283	6757377	1094	-	40
AT1G19520	1	6759964	6762778	2814	+	534
AT1G19530	1	6763914	6764971	1057	+	7
AT1G19540	1	6765666	6767341	1675	+	54
AT1G19550	1	6767450	6767983	533	-	3
AT1G19560	1	6768813	6770752	1939	-	15
AT1G19570	1	6773301	6774528	1227	-	3648
AT1G19580	1	6774759	6777456	2697	+	743
AT1G19600	1	6778987	6781173	2186	+	719
AT1G19610	1	6781482	6782039	557	-	3
AT1G19620	1	6784019	6785075	1056	+	12
AT1G19630	1	6785426	6787967	2541	-	77
AT1G19640	1	6788884	6791846	2962	-	170
AT1G19650	1	6796201	6799764	3563	-	922
AT1G19660	1	6799980	6802685	2705	-	4757
AT1G19670	1	6803610	6805044	1434	-	851
AT1G19680	1	6805456	6807862	2406	+	395
AT1G19690	1	6807714	6809569	1855	-	246
AT1G19700	1	6809723	6812663	2940	-	1358
AT1G19710	1	6814792	6816876	2084	+	284
AT1G19715	1	6816701	6819542	2841	-	2969
AT1G19720	1	6819563	6822711	3148	-	2543
AT1G19730	1	6822863	6824071	1208	-	232
AT1G19740	1	6824321	6825459	1138	+	2760
AT1G19750	1	6826996	6830063	3067	+	5
AT1G19770	1	6832346	6833837	1491	+	887
AT1G19780	1	6833884	6836578	2694	-	0
AT1G19790	1	6838119	6840293	2174	-	6
AT1G19800	1	6846368	6848103	1735	+	1004
AT1G19810	1	6848381	6849988	1607	-	0
AT1G19830	1	6852154	6852872	718	+	25
AT1G19835	1	6855951	6860443	4492	-	2246
AT1G19840	1	6872793	6873255	462	-	64
AT1G19850	1	6886878	6891374	4496	+	546
AT1G19860	1	6891428	6894736	3308	-	532
AT1G19870	1	6895014	6898725	3711	-	1256
AT1G19880	1	6900414	6904069	3655	-	1006
AT1G19890	1	6905033	6906018	985	+	0
AT1G19900	1	6906898	6908741	1843	-	0
AT1G19910	1	6913228	6914594	1366	+	2755
AT1G19920	1	6914612	6916805	2193	-	3578
AT1G19930	1	6917019	6918138	1119	+	0
AT1G19940	1	6918190	6920377	2187	-	96
AT1G19950	1	6924183	6926724	2541	+	238
AT1G19960	1	6928038	6928463	425	+	1940
AT1G19968	1	6930260	6930985	725	+	5
AT1G19970	1	6931011	6932689	1678	-	222
AT1G19980	1	6933015	6935002	1987	+	163
AT1G19990	1	6935217	6936693	1476	+	219
AT1G20000	1	6936897	6937666	769	-	0
AT1G20010	1	6937794	6940582	2788	-	3314
AT1G20015	1	6941284	6941373	89	+	1
AT1G20020	1	6942716	6945018	2302	+	18670
AT1G20030	1	6945424	6947344	1920	+	148
AT1G20040	1	6948859	6948943	84	-	0
AT1G20050	1	6949042	6950319	1277	+	950
AT1G20060	1	6950654	6956293	5639	-	151
AT1G20065	1	6956520	6958075	1555	+	6
AT1G20070	1	6958009	6959123	1114	-	1886
AT1G20080	1	6962131	6965045	2914	+	6
AT1G20090	1	6966921	6968933	2012	+	1161
AT1G20100	1	6969106	6970956	1850	-	836
AT1G20110	1	6971484	6974835	3351	+	1281
AT1G20120	1	6975387	6977264	1877	+	13
AT1G20130	1	6977752	6980241	2489	+	1
AT1G20132	1	6981263	6983627	2364	+	0
AT1G20135	1	6984123	6985498	1375	+	0
AT1G20140	1	6986357	6987270	913	+	120
AT1G20150	1	6987331	6990361	3030	-	0
AT1G20160	1	6990783	6993972	3189	-	492
AT1G20170	1	6995281	6995353	72	-	0
AT1G20180	1	6996209	6997943	1734	+	1
AT1G20190	1	6998488	6999817	1329	-	1001
AT1G20200	1	7001200	7004418	3218	-	1418
AT1G20210	1	7004513	7004585	72	+	0
AT1G20220	1	7004878	7007651	2773	-	1079
AT1G20225	1	7007755	7009333	1578	-	649
AT1G20230	1	7009569	7011852	2283	+	56
AT1G20240	1	7012112	7015216	3104	-	0
AT1G20250	1	7016515	7016588	73	+	0
AT1G20260	1	7016692	7020590	3898	+	4195
AT1G20270	1	7020748	7023067	2319	-	316
AT1G20280	1	7023828	7024212	384	+	0
AT1G20290	1	7025547	7029698	4151	-	0
AT1G20300	1	7029628	7031535	1907	+	156
AT1G20310	1	7032289	7033208	919	+	1
AT1G20320	1	7033656	7034874	1218	-	0
AT1G20330	1	7038687	7040159	1472	-	2484
AT1G20340	1	7042428	7043363	935	-	105541
AT1G20350	1	7043712	7044592	880	+	15
AT1G20360	1	7046503	7047744	1241	-	0
AT1G20370	1	7051576	7053641	2065	-	271
AT1G20375	1	7058193	7058310	117	+	0
AT1G20380	1	7061664	7065178	3514	+	222
AT1G20390	1	7065493	7071561	6068	+	135
AT1G20400	1	7072191	7075838	3647	-	5
AT1G20405	1	7077166	7077606	440	+	0
AT1G20410	1	7078897	7082547	3650	-	264
AT1G20420	1	7082667	7082739	72	+	0
AT1G20430	1	7083195	7083835	640	-	377
AT1G20440	1	7084408	7085772	1364	-	2291
AT1G20450	1	7088002	7089606	1604	-	3412
AT1G20460	1	7091360	7092993	1633	+	106
AT1G20470	1	7094259	7094869	610	+	263
AT1G20480	1	7094832	7097114	2282	-	74
AT1G20490	1	7097292	7099695	2403	-	100
AT1G20500	1	7100501	7102915	2414	-	0
AT1G20510	1	7103453	7105881	2428	-	715
AT1G20515	1	7106164	7107977	1813	+	12
AT1G20520	1	7106921	7107617	696	-	0
AT1G20530	1	7108369	7110377	2008	-	13
AT1G20540	1	7112610	7115362	2752	+	542
AT1G20550	1	7115240	7118161	2921	-	98
AT1G20560	1	7119675	7121817	2142	-	787
AT1G20570	1	7122017	7126559	4542	-	41
AT1G20575	1	7126771	7128745	1974	-	289
AT1G20580	1	7128883	7130642	1759	+	782
AT1G20590	1	7131165	7132183	1018	-	1
AT1G20600	1	7133110	7134416	1306	+	0
AT1G20610	1	7134789	7137781	2992	-	120
AT1G20620	1	7143066	7146540	3474	+	34139
AT1G20630	1	7146635	7149977	3342	+	1046
AT1G20640	1	7154409	7158218	3809	+	982
AT1G20650	1	7158243	7160526	2283	-	1490
AT1G20657	1	7161889	7163076	1187	-	0
AT1G20670	1	7164189	7168021	3832	-	406
AT1G20680	1	7169381	7170796	1415	+	1
AT1G20690	1	7174437	7176377	1940	+	0
AT1G20691	1	7174583	7176453	1870	-	0
AT1G20693	1	7176774	7178820	2046	+	2654
AT1G20696	1	7179451	7181499	2048	+	1967
AT1G20700	1	7182557	7184009	1452	+	3
AT1G20710	1	7184484	7185267	783	+	0
AT1G20720	1	7185657	7192794	7137	-	148
AT1G20730	1	7194255	7195575	1320	+	0
AT1G20735	1	7197490	7198681	1191	+	0
AT1G20740	1	7200393	7201538	1145	+	0
AT1G20750	1	7203301	7208998	5697	-	0
AT1G20760	1	7209368	7214993	5625	+	1072
AT1G20770	1	7215014	7216741	1727	-	417
AT1G20780	1	7217127	7220784	3657	+	319
AT1G20790	1	7220960	7222268	1308	-	0
AT1G20795	1	7226309	7227566	1257	-	0
AT1G20800	1	7228717	7231600	2883	-	0
AT1G20810	1	7232005	7233566	1561	+	1866
AT1G20816	1	7233767	7235128	1361	+	269
AT1G20820	1	7242760	7242832	72	-	0
AT1G20823	1	7238799	7239669	870	+	331
AT1G20830	1	7242919	7244904	1985	+	611
AT1G20840	1	7244938	7248143	3205	-	587
AT1G20850	1	7252173	7253731	1558	+	1141
AT1G20860	1	7254006	7258677	4671	-	0
AT1G20870	1	7259101	7260775	1674	-	102
AT1G20875	1	7261480	7261681	201	+	1
AT1G20880	1	7262042	7265438	3396	-	269
AT1G20890	1	7265822	7267323	1501	-	113
AT1G20900	1	7272555	7274072	1517	+	8
AT1G20910	1	7276942	7281138	4196	-	298
AT1G20920	1	7285058	7289778	4720	+	1487
AT1G20925	1	7289972	7292507	2535	+	0
AT1G20930	1	7292567	7294746	2179	-	202
AT1G20940	1	7295273	7296518	1245	-	0
AT1G20950	1	7297238	7301415	4177	-	1381
AT1G20960	1	7301747	7310250	8503	-	3117
AT1G20967	1	7313080	7313227	147	+	0
AT1G20970	1	7313945	7319574	5629	+	1287
AT1G20980	1	7324587	7329385	4798	+	1614
AT1G20990	1	7330523	7331946	1423	-	7
AT1G21000	1	7337727	7339452	1725	+	696
AT1G21010	1	7346155	7346973	818	+	116
AT1G21020	1	7353539	7357981	4442	+	0
AT1G21040	1	7359982	7363334	3352	-	0
AT1G21050	1	7366774	7367678	904	+	327
AT1G21060	1	7371665	7374110	2445	+	583
AT1G21065	1	7374209	7375789	1580	+	4168
AT1G21070	1	7375868	7378147	2279	-	166
AT1G21080	1	7378537	7382661	4124	-	1041
AT1G21090	1	7384628	7386558	1930	+	126
AT1G21100	1	7386838	7388428	1590	-	18
AT1G21110	1	7389980	7391553	1573	-	7
AT1G21120	1	7395227	7396773	1546	-	14
AT1G21130	1	7399061	7400605	1544	-	1327
AT1G21140	1	7404382	7405281	899	+	92
AT1G21150	1	7406295	7407764	1469	-	125
AT1G21160	1	7407954	7412857	4903	-	770
AT1G21170	1	7413049	7419643	6594	+	592
AT1G21190	1	7419677	7420903	1226	-	319
AT1G21200	1	7421216	7423143	1927	+	194
AT1G21202	1	7423517	7423611	94	+	2
AT1G21210	1	7424105	7427041	2936	+	1
AT1G21220	1	7428111	7428930	819	-	10
AT1G21230	1	7429979	7432346	2367	+	0
AT1G21240	1	7434302	7436830	2528	+	27
AT1G21245	1	7436841	7437342	501	+	0
AT1G21250	1	7439265	7442113	2848	+	1344
AT1G21260	1	7442217	7442979	762	-	77
AT1G21270	1	7444930	7447549	2619	+	1197
AT1G21280	1	7447489	7448463	974	-	129
AT1G21281	1	7448551	7448683	132	+	0
AT1G21286	1	7449471	7449664	193	+	0
AT1G21290	1	7449963	7450695	732	-	0
AT1G21300	1	7451149	7451707	558	-	0
AT1G21310	1	7453235	7455009	1774	-	226
AT1G21320	1	7462833	7466164	3331	-	3
AT1G21323	1	7466693	7467359	666	+	0
AT1G21326	1	7469001	7469721	720	-	0
AT1G21327	1	7471946	7472210	264	-	0
AT1G21330	1	7474702	7475683	981	+	0
AT1G21340	1	7476086	7476869	783	+	0
AT1G21350	1	7476941	7479042	2101	-	1245
AT1G21360	1	7481251	7483507	2256	+	3
AT1G21370	1	7483780	7485666	1886	+	198
AT1G21380	1	7485635	7488713	3078	-	1020
AT1G21390	1	7489150	7490737	1587	-	66
AT1G21395	1	7491964	7492339	375	+	0
AT1G21400	1	7493425	7496710	3285	+	821
AT1G21410	1	7497140	7499579	2439	+	432
AT1G21420	1	7499732	7499804	72	-	0
AT1G21430	1	7500844	7502186	1342	+	0
AT1G21440	1	7502158	7504175	2017	-	2061
AT1G21450	1	7508968	7511801	2833	+	729
AT1G21460	1	7511849	7513361	1512	-	676
AT1G21470	1	7516708	7517179	471	-	0
AT1G21475	1	7524085	7524631	546	-	0
AT1G21480	1	7518945	7521504	2559	-	264
AT1G21490	1	7527078	7528202	1124	-	0
AT1G21500	1	7529881	7531025	1144	-	7119
AT1G21510	1	7531311	7532629	1318	-	17
AT1G21520	1	7534153	7534789	636	-	53
AT1G21525	1	7537086	7537649	563	-	29
AT1G21528	1	7542829	7543077	248	-	0
AT1G21529	1	7543923	7544678	755	-	0
AT1G21530	1	7545150	7546936	1786	-	0
AT1G21540	1	7548613	7550565	1952	-	62
AT1G21550	1	7553100	7553876	776	-	37
AT1G21560	1	7554783	7557056	2273	+	523
AT1G21580	1	7557261	7565803	8542	-	3107
AT1G21590	1	7566231	7569902	3671	-	2842
AT1G21600	1	7570885	7573846	2961	-	1400
AT1G21610	1	7573921	7578956	5035	+	558
AT1G21620	1	7579128	7580171	1043	+	0
AT1G21630	1	7581083	7588151	7068	+	1823
AT1G21640	1	7588413	7592890	4477	+	3050
AT1G21650	1	7592663	7604229	11566	-	396
AT1G21651	1	7600804	7604215	3411	-	5
AT1G21660	1	7605698	7609065	3367	+	1131
AT1G21670	1	7610397	7612682	2285	+	363
AT1G21680	1	7613004	7615339	2335	+	1175
AT1G21690	1	7615613	7618605	2992	+	331
AT1G21695	1	7618939	7619919	980	+	18
AT1G21700	1	7620000	7624136	4136	-	758
AT1G21710	1	7624395	7626116	1721	+	246
AT1G21720	1	7626282	7628262	1980	+	1346
AT1G21722	1	7628455	7629252	797	+	0
AT1G21730	1	7630106	7636594	6488	+	362
AT1G21738	1	7641001	7641094	93	-	0
AT1G21740	1	7641579	7645078	3499	+	154
AT1G21750	1	7645699	7648841	3142	+	1488
AT1G21760	1	7649193	7651816	2623	+	544
AT1G21770	1	7651645	7652288	643	-	32
AT1G21780	1	7651881	7654014	2133	+	912
AT1G21790	1	7654183	7655883	1700	+	288
AT1G21800	1	7656119	7656191	72	-	0
AT1G21810	1	7656398	7658634	2236	-	139
AT1G21830	1	7661117	7662608	1491	-	134
AT1G21835	1	7665663	7665936	273	+	0
AT1G21840	1	7666459	7667758	1299	+	120
AT1G21850	1	7667802	7670530	2728	-	0
AT1G21860	1	7671027	7674215	3188	-	0
AT1G21864	1	7675501	7675971	470	+	0
AT1G21866	1	7677498	7677959	461	+	0
AT1G21870	1	7678207	7679697	1490	+	0
AT1G21880	1	7680480	7682641	2161	+	513
AT1G21890	1	7682583	7685662	3079	-	27
AT1G21900	1	7690801	7692438	1637	-	461
AT1G21910	1	7696535	7697699	1164	+	20
AT1G21920	1	7704254	7706140	1886	-	947
AT1G21925	1	7710422	7710725	303	-	0
AT1G21928	1	7712210	7712513	303	-	0
AT1G21930	1	7712897	7714443	1546	+	225
AT1G21940	1	7715169	7716975	1806	-	0
AT1G21945	1	7717825	7722120	4295	+	2
AT1G21950	1	7723258	7723954	696	-	0
AT1G21960	1	7725971	7726586	615	+	0
AT1G21970	1	7727576	7729617	2041	-	0
AT1G21973	1	7730910	7731144	234	-	0
AT1G21975	1	7732279	7732468	189	+	0
AT1G21980	1	7734738	7738661	3923	+	779
AT1G21990	1	7740529	7742106	1577	-	0
AT1G22000	1	7744188	7747785	3597	+	4
AT1G22010	1	7749570	7750062	492	+	0
AT1G22015	1	7751001	7753519	2518	-	0
AT1G22020	1	7754320	7757383	3063	+	543
AT1G22030	1	7759163	7760556	1393	-	99
AT1G22040	1	7767923	7770055	2132	+	352
AT1G22050	1	7771669	7773154	1485	+	184
AT1G22060	1	7773062	7781499	8437	-	1486
AT1G22065	1	7785775	7786391	616	+	5
AT1G22067	1	7787390	7787525	135	+	0
AT1G22070	1	7789347	7792114	2767	+	556
AT1G22080	1	7792191	7795440	3249	-	0
AT1G22090	1	7795707	7797425	1718	+	1
AT1G22100	1	7798022	7800228	2206	-	0
AT1G22110	1	7800506	7802562	2056	-	1
AT1G22120	1	7806308	7809632	3324	-	0
AT1G22130	1	7812386	7814264	1878	-	0
AT1G22140	1	7814762	7815631	869	-	690
AT1G22150	1	7818360	7821344	2984	+	3
AT1G22160	1	7823148	7823971	823	+	686
AT1G22170	1	7826288	7828326	2038	+	185
AT1G22180	1	7828325	7830392	2067	-	128
AT1G22190	1	7835781	7837288	1507	+	313
AT1G22200	1	7837590	7840788	3198	-	654
AT1G22210	1	7841517	7844056	2539	+	0
AT1G22220	1	7846601	7847802	1201	+	24
AT1G22230	1	7849860	7851122	1262	+	24
AT1G22240	1	7853083	7854963	1880	+	2
AT1G22250	1	7858863	7859766	903	+	76
AT1G22260	1	7859629	7865249	5620	-	28
AT1G22270	1	7865480	7866139	659	+	341
AT1G22275	1	7867132	7872618	5486	+	21
AT1G22280	1	7873866	7875878	2012	+	464
AT1G22290	1	7876639	7877962	1323	-	0
AT1G22300	1	7878768	7881219	2451	-	3469
AT1G22310	1	7881536	7883742	2206	-	261
AT1G22320	1	7884416	7884454	38	-	0
AT1G22330	1	7886541	7889534	2993	+	250
AT1G22340	1	7890463	7892090	1627	-	7
AT1G22350	1	7892877	7894498	1621	-	167
AT1G22360	1	7894857	7897591	2734	-	556
AT1G22370	1	7898012	7899879	1867	-	359
AT1G22380	1	7900386	7902332	1946	-	16
AT1G22400	1	7903659	7906673	3014	-	195
AT1G22403	1	7908567	7909708	1141	-	97
AT1G22410	1	7912045	7915003	2958	+	2552
AT1G22420	1	7916075	7917518	1443	-	0
AT1G22430	1	7919143	7921832	2689	+	1355
AT1G22440	1	7922427	7924944	2517	+	0
AT1G22450	1	7925120	7927278	2158	+	1751
AT1G22460	1	7927427	7930657	3230	-	0
AT1G22470	1	7932853	7933390	537	-	2
AT1G22480	1	7934161	7935382	1221	-	0
AT1G22490	1	7938250	7940592	2342	-	52
AT1G22500	1	7949475	7950900	1425	+	82
AT1G22510	1	7950817	7952832	2015	-	122
AT1G22520	1	7952995	7954418	1423	-	410
AT1G22530	1	7955492	7958442	2950	-	331
AT1G22540	1	7964041	7966436	2395	+	350
AT1G22550	1	7966532	7968641	2109	-	52
AT1G22560	1	7970247	7974396	4149	+	3
AT1G22570	1	7976619	7978573	1954	-	82
AT1G22580	1	7980708	7981263	555	+	0
AT1G22590	1	7981739	7984334	2595	+	559
AT1G22600	1	7987140	7989217	2077	-	17
AT1G22610	1	7994290	7997588	3298	+	1531
AT1G22620	1	7997675	8002944	5269	-	604
AT1G22630	1	8003314	8004304	990	+	1884
AT1G22640	1	8006194	8007428	1234	+	343
AT1G22650	1	8013381	8015991	2610	-	331
AT1G22651	1	8016125	8016287	162	+	0
AT1G22660	1	8017396	8021712	4316	+	258
AT1G22670	1	8021853	8023516	1663	-	4
AT1G22680	1	8024966	8026356	1390	-	3
AT1G22690	1	8027293	8028168	875	+	616
AT1G22700	1	8028157	8029971	1814	-	2414
AT1G22710	1	8030640	8033117	2477	-	5387
AT1G22720	1	8044231	8045665	1434	-	0
AT1G22730	1	8046148	8049039	2891	+	560
AT1G22740	1	8049099	8050708	1609	+	194
AT1G22750	1	8050859	8052930	2071	+	1263
AT1G22760	1	8055324	8059015	3691	+	1
AT1G22767	1	8061041	8061176	135	-	0
AT1G22770	1	8061843	8067716	5873	+	727
AT1G22780	1	8067863	8069342	1479	+	2176
AT1G22790	1	8069486	8071562	2076	+	348
AT1G22800	1	8071934	8074357	2423	+	293
AT1G22810	1	8074230	8075037	807	-	0
AT1G22830	1	8076572	8079116	2544	+	54
AT1G22840	1	8079286	8080574	1288	+	1622
AT1G22850	1	8080481	8082875	2394	-	5690
AT1G22860	1	8083399	8089236	5837	+	396
AT1G22870	1	8089500	8094173	4673	+	376
AT1G22880	1	8095501	8097709	2208	+	146
AT1G22882	1	8098766	8101351	2585	+	411
AT1G22885	1	8101564	8102375	811	+	127
AT1G22890	1	8102817	8103532	715	+	136
AT1G22900	1	8103658	8104505	847	-	87
AT1G22910	1	8105588	8108164	2576	+	534
AT1G22920	1	8109713	8112051	2338	-	533
AT1G22930	1	8117338	8122127	4789	+	3180
AT1G22940	1	8122338	8125068	2730	+	575
AT1G22950	1	8125022	8127196	2174	-	340
AT1G22960	1	8128085	8130242	2157	-	98
AT1G22970	1	8130715	8132208	1493	-	292
AT1G22980	1	8132443	8134350	1907	-	3
AT1G22985	1	8135212	8135920	708	-	39
AT1G22990	1	8139164	8140202	1038	+	1
AT1G23000	1	8143403	8145070	1667	+	132
AT1G23010	1	8147263	8149813	2550	+	36
AT1G23020	1	8150069	8153530	3461	-	349
AT1G23030	1	8156645	8159077	2432	+	502
AT1G23037	1	8162413	8163149	736	+	0
AT1G23040	1	8164958	8165862	904	+	107
AT1G23050	1	8168442	8169267	825	+	0
AT1G23052	1	8168442	8169267	825	-	0
AT1G23060	1	8170754	8172992	2238	-	23
AT1G23070	1	8173822	8175819	1997	-	0
AT1G23074	1	8177831	8177996	165	+	0
AT1G23080	1	8180576	8183570	2994	-	1957
AT1G23090	1	8184951	8189064	4113	-	517
AT1G23100	1	8195775	8196475	700	+	73
AT1G23110	1	8196446	8198331	1885	-	7
AT1G23120	1	8198719	8199557	838	+	8
AT1G23130	1	8200382	8201235	853	+	14303
AT1G23140	1	8202260	8203215	955	-	80
AT1G23145	1	8203961	8204255	294	+	0
AT1G23147	1	8205871	8206206	335	+	0
AT1G23149	1	8206548	8207618	1070	+	0
AT1G23150	1	8206548	8207618	1070	+	0
AT1G23160	1	8209231	8211325	2094	+	0
AT1G23170	1	8212555	8215807	3252	+	143
AT1G23180	1	8215720	8219584	3864	+	1193
AT1G23190	1	8219868	8224469	4601	+	3052
AT1G23200	1	8227177	8229582	2405	+	56
AT1G23201	1	8230208	8230775	567	+	0
AT1G23205	1	8233996	8234893	897	-	460
AT1G23210	1	8240173	8242129	1956	+	0
AT1G23220	1	8242422	8244403	1981	+	386
AT1G23230	1	8244439	8251795	7356	+	755
AT1G23240	1	8252714	8254625	1911	-	0
AT1G23250	1	8255232	8256770	1538	-	0
AT1G23260	1	8256985	8258688	1703	-	568
AT1G23270	1	8259601	8260144	543	-	0
AT1G23280	1	8260864	8262772	1908	-	368
AT1G23290	1	8262983	8263587	604	+	2853
AT1G23300	1	8263826	8266048	2222	-	0
AT1G23310	1	8268403	8271933	3530	-	69166
AT1G23320	1	8273422	8275350	1928	-	0
AT1G23330	1	8279587	8281891	2304	-	292
AT1G23340	1	8283643	8286832	3189	-	110
AT1G23350	1	8293594	8294264	670	-	2
AT1G23360	1	8295184	8296923	1739	-	657
AT1G23380	1	8297290	8302651	5361	-	54
AT1G23390	1	8309111	8310649	1538	-	1791
AT1G23400	1	8312075	8314744	2669	-	1869
AT1G23410	1	8314923	8315531	608	+	78
AT1G23420	1	8317395	8319483	2088	+	0
AT1G23440	1	8321679	8324240	2561	+	719
AT1G23450	1	8324697	8326697	2000	+	13
AT1G23460	1	8327311	8329622	2311	+	255
AT1G23465	1	8330054	8330938	884	+	22
AT1G23470	1	8331296	8332136	840	+	18
AT1G23480	1	8333019	8336385	3366	+	551
AT1G23490	1	8336682	8338672	1990	+	4270
AT1G23500	1	8339667	8341072	1405	+	0
AT1G23510	1	8341448	8342796	1348	-	1
AT1G23520	1	8343423	8344839	1416	-	0
AT1G23530	1	8345594	8346651	1057	+	87
AT1G23540	1	8346826	8349786	2960	-	8
AT1G23550	1	8350792	8352791	1999	+	97
AT1G23560	1	8352614	8354262	1648	-	7
AT1G23570	1	8354805	8356461	1656	-	0
AT1G23580	1	8357445	8358805	1360	-	0
AT1G23590	1	8359124	8360645	1521	-	0
AT1G23600	1	8361003	8362485	1482	-	2
AT1G23610	1	8362863	8363675	812	-	0
AT1G23620	1	8364661	8366449	1788	-	0
AT1G23640	1	8367169	8370280	3111	-	0
AT1G23650	1	8371019	8371106	87	-	4
AT1G23660	1	8371608	8372845	1237	-	1
AT1G23670	1	8373281	8375897	2616	-	0
AT1G23680	1	8376686	8377156	470	-	0
AT1G23690	1	8377261	8378769	1508	-	0
AT1G23700	1	8379453	8381965	2512	-	0
AT1G23710	1	8385250	8386426	1176	+	157
AT1G23720	1	8388654	8391540	2886	+	0
AT1G23724	1	8393186	8393330	144	+	0
AT1G23730	1	8395556	8398144	2588	+	42
AT1G23740	1	8398114	8399749	1635	-	14724
AT1G23750	1	8400150	8401487	1337	+	204
AT1G23760	1	8402045	8404301	2256	+	1
AT1G23770	1	8405213	8406266	1053	-	0
AT1G23780	1	8406685	8408525	1840	-	516
AT1G23790	1	8409962	8412041	2079	+	83
AT1G23800	1	8412050	8414879	2829	-	271
AT1G23810	1	8417494	8418566	1072	+	0
AT1G23820	1	8420264	8422985	2721	+	1424
AT1G23830	1	8422959	8424088	1129	-	41
AT1G23840	1	8424296	8425376	1080	-	28
AT1G23850	1	8425738	8427235	1497	-	12
AT1G23860	1	8427355	8429498	2143	-	416
AT1G23870	1	8432178	8435656	3478	+	322
AT1G23880	1	8435656	8438745	3089	+	119
AT1G23890	1	8438765	8440866	2101	-	149
AT1G23900	1	8441145	8447519	6374	+	957
AT1G23910	1	8451067	8451289	222	-	1
AT1G23920	1	8454199	8456566	2367	+	0
AT1G23930	1	8459081	8461460	2379	-	0
AT1G23935	1	8461908	8465943	4035	+	95
AT1G23940	1	8466093	8469346	3253	+	54
AT1G23950	1	8469533	8471417	1884	-	414
AT1G23960	1	8478406	8480316	1910	-	748
AT1G23965	1	8480421	8481486	1065	-	1
AT1G23970	1	8482012	8483875	1863	-	219
AT1G23980	1	8484702	8486002	1300	-	107
AT1G23990	1	8490633	8492730	2097	+	0
AT1G24000	1	8496056	8496566	510	-	0
AT1G24010	1	8498802	8499499	697	-	0
AT1G24020	1	8500399	8502065	1666	-	2144
AT1G24030	1	8503233	8505460	2227	+	52
AT1G24040	1	8503776	8506803	3027	-	437
AT1G24050	1	8507009	8508864	1855	+	919
AT1G24060	1	8509375	8510062	687	-	0
AT1G24062	1	8510400	8510967	567	-	0
AT1G24068	1	8515505	8515971	466	+	0
AT1G24070	1	8516237	8519734	3497	-	154
AT1G24080	1	8520289	8520363	74	-	0
AT1G24090	1	8520833	8523121	2288	+	23
AT1G24095	1	8523246	8524929	1683	+	31
AT1G24100	1	8525434	8527087	1653	-	1885
AT1G24110	1	8527837	8528818	981	+	0
AT1G24120	1	8529142	8532212	3070	-	871
AT1G24130	1	8534182	8535430	1248	-	5
AT1G24140	1	8536044	8537387	1343	-	45
AT1G24145	1	8541026	8541739	713	+	74
AT1G24147	1	8542445	8543474	1029	+	592
AT1G24148	1	8544249	8545551	1302	+	475
AT1G24150	1	8549517	8551993	2476	+	94
AT1G24159	1	8552774	8553385	611	+	0
AT1G24160	1	8553410	8556555	3145	-	1365
AT1G24170	1	8557215	8558832	1617	-	782
AT1G24180	1	8560524	8563495	2971	-	1285
AT1G24190	1	8563557	8570505	6948	-	1219
AT1G24200	1	8571172	8572377	1205	-	0
AT1G24210	1	8573548	8575156	1608	-	21
AT1G24212	1	8575875	8576245	370	-	0
AT1G24220	1	8578657	8582413	3756	-	0
AT1G24230	1	8584038	8585135	1097	-	0
AT1G24240	1	8586352	8588116	1764	+	155
AT1G24250	1	8588441	8589546	1105	-	0
AT1G24256	1	8592077	8592989	912	+	0
AT1G24260	1	8593636	8596105	2469	-	4
AT1G24265	1	8600464	8603801	3337	+	59
AT1G24267	1	8604068	8607484	3416	-	660
AT1G24270	1	8608057	8608763	706	-	2
AT1G24280	1	8609444	8612580	3136	+	168
AT1G24290	1	8612504	8614277	1773	-	99
AT1G24300	1	8614364	8620420	6056	-	1065
AT1G24310	1	8624060	8626405	2345	+	305
AT1G24320	1	8626314	8630971	4657	-	0
AT1G24330	1	8631439	8635055	3616	+	145
AT1G24340	1	8635208	8638986	3778	+	477
AT1G24350	1	8638519	8640825	2306	-	280
AT1G24360	1	8640581	8643478	2897	+	2626
AT1G24370	1	8643760	8645626	1866	-	0
AT1G24380	1	8646055	8647609	1554	+	0
AT1G24388	1	8648098	8648694	596	-	0
AT1G24390	1	8648200	8648995	795	+	0
AT1G24400	1	8651406	8653828	2422	-	113
AT1G24405	1	8655245	8655650	405	+	3
AT1G24420	1	8656686	8657997	1311	+	0
AT1G24430	1	8658002	8659506	1504	-	4
AT1G24440	1	8662018	8663964	1946	+	240
AT1G24450	1	8664152	8665289	1137	+	218
AT1G24460	1	8665873	8672651	6778	+	1516
AT1G24470	1	8674055	8676408	2353	+	36
AT1G24480	1	8676359	8677159	800	-	0
AT1G24485	1	8678857	8681894	3037	+	0
AT1G24490	1	8682233	8685271	3038	+	717
AT1G24510	1	8685270	8688247	2977	-	2572
AT1G24520	1	8688628	8689268	640	+	0
AT1G24530	1	8693226	8694705	1479	+	39
AT1G24540	1	8699750	8701421	1671	+	3
AT1G24560	1	8702384	8705848	3464	+	615
AT1G24570	1	8707196	8709589	2393	+	4
AT1G24575	1	8711035	8711528	493	-	274
AT1G24577	1	8712477	8713032	555	-	43
AT1G24580	1	8710179	8710824	645	+	159
AT1G24590	1	8714388	8715309	921	-	2
AT1G24600	1	8720308	8720721	413	+	29
AT1G24610	1	8720650	8722746	2096	-	810
AT1G24620	1	8723711	8724459	748	-	1
AT1G24625	1	8725882	8727212	1330	-	220
AT1G24640	1	8729279	8732681	3402	+	0
AT1G24650	1	8734569	8737315	2746	+	0
AT1G24657	1	8737951	8738365	414	-	0
AT1G24686	1	8740505	8740919	414	-	0
AT1G24706	1	8741939	8755558	13619	+	1539
AT1G24733	1	8757068	8757362	294	+	0
AT1G24735	1	8757863	8759645	1782	+	30
AT1G24764	1	8759532	8763355	3823	-	564
AT1G24792	1	8766059	8767096	1037	+	2
AT1G24793	1	8767561	8769438	1877	+	2
AT1G24800	1	8769659	8771251	1592	+	0
AT1G24807	1	8771765	8773535	1770	-	0
AT1G24822	1	8774996	8777882	2886	-	0
AT1G24851	1	8778279	8779056	777	+	0
AT1G24879	1	8780843	8781536	693	+	0
AT1G24880	1	8775900	8783775	7875	+	66
AT1G24881	1	8784035	8785634	1599	+	0
AT1G24909	1	8785784	8787914	2130	-	0
AT1G24938	1	8789375	8792080	2705	-	0
AT1G24967	1	8793820	8797942	4122	-	2
AT1G24996	1	8799519	8800410	891	-	0
AT1G25025	1	8800807	8801584	777	+	0
AT1G25053	1	8803299	8804091	792	+	2
AT1G25054	1	8798482	8806360	7878	+	0
AT1G25055	1	8806606	8808156	1550	+	0
AT1G25083	1	8808548	8810443	1895	-	0
AT1G25097	1	8811904	8814788	2884	-	0
AT1G25098	1	8812810	8814450	1640	+	2170
AT1G25112	1	8815185	8815962	777	+	0
AT1G25141	1	8817677	8818382	705	+	0
AT1G25145	1	8818866	8820736	1870	+	0
AT1G25150	1	8821007	8822533	1526	+	0
AT1G25155	1	8822691	8824821	2130	-	0
AT1G25175	1	8827285	8829320	2035	+	0
AT1G25180	1	8829563	8830340	777	+	0
AT1G25209	1	8831723	8832760	1037	+	3
AT1G25210	1	8833017	8835112	2095	+	9
AT1G25211	1	8835385	8837007	1622	+	37
AT1G25220	1	8836834	8839549	2715	-	341
AT1G25230	1	8840401	8842317	1916	-	486
AT1G25240	1	8845230	8846493	1263	+	0
AT1G25250	1	8849548	8851612	2064	+	43
AT1G25260	1	8853958	8855872	1914	-	749
AT1G25270	1	8857725	8859909	2184	+	0
AT1G25275	1	8860670	8861364	694	+	758
AT1G25280	1	8863776	8866805	3029	+	804
AT1G25290	1	8867107	8869092	1985	+	375
AT1G25300	1	8871567	8872386	819	+	0
AT1G25310	1	8874123	8874834	711	-	0
AT1G25320	1	8877856	8880310	2454	+	104
AT1G25330	1	8880266	8882100	1834	-	0
AT1G25340	1	8885080	8886398	1318	+	0
AT1G25350	1	8889109	8894261	5152	-	1351
AT1G25360	1	8894427	8896800	2373	+	17
AT1G25370	1	8897754	8899102	1348	-	77
AT1G25375	1	8900152	8903257	3105	-	262
AT1G25380	1	8903469	8906002	2533	+	500
AT1G25390	1	8906451	8908854	2403	-	386
AT1G25400	1	8911129	8912642	1513	-	14
AT1G25410	1	8914190	8915219	1029	-	0
AT1G25420	1	8916058	8918232	2174	+	713
AT1G25422	1	8918851	8919892	1041	+	10
AT1G25425	1	8922699	8923331	632	+	129
AT1G25430	1	8927731	8933058	5327	-	530
AT1G25440	1	8933715	8935460	1745	-	8031
AT1G25450	1	8938478	8940387	1909	-	572
AT1G25460	1	8942810	8944244	1434	+	7
AT1G25470	1	8944608	8946628	2020	-	0
AT1G25472	1	8944608	8946628	2020	-	0
AT1G25480	1	8948464	8950876	2412	+	255
AT1G25490	1	8951201	8955107	3906	+	1995
AT1G25500	1	8955248	8957978	2730	-	70
AT1G25510	1	8959185	8960848	1663	-	119
AT1G25520	1	8962124	8964564	2440	+	667
AT1G25530	1	8964543	8967428	2885	-	76
AT1G25540	1	8969064	8974660	5596	-	614
AT1G25550	1	8976433	8978093	1660	+	710
AT1G25560	1	8981676	8983041	1365	-	190
AT1G25570	1	8991825	8995496	3671	-	845
AT1G25580	1	8996767	8999860	3093	-	190
AT1G25682	1	9002284	9004646	2362	-	446
AT1G25784	1	9005556	9010027	4471	+	0
AT1G25886	1	9010257	9015226	4969	-	0
AT1G25988	1	9016251	9017450	1199	-	0
AT1G26090	1	9020379	9022769	2390	+	367
AT1G26100	1	9022541	9024081	1540	-	182
AT1G26110	1	9024344	9027786	3442	-	3545
AT1G26120	1	9028394	9031485	3091	-	330
AT1G26130	1	9033217	9038577	5360	+	528
AT1G26140	1	9038707	9039540	833	-	0
AT1G26150	1	9039627	9043288	3661	-	4960
AT1G26160	1	9044440	9046979	2539	-	632
AT1G26170	1	9047432	9054589	7157	-	803
AT1G26180	1	9054743	9056852	2109	+	579
AT1G26190	1	9057095	9061086	3991	-	401
AT1G26200	1	9063470	9064914	1444	-	13
AT1G26208	1	9066635	9069238	2603	-	54
AT1G26210	1	9067038	9068207	1169	+	89
AT1G26218	1	9071057	9072273	1216	-	7
AT1G26220	1	9071139	9071861	722	+	0
AT1G26230	1	9072255	9076743	4488	-	869
AT1G26233	1	9076047	9076182	135	-	1
AT1G26235	1	9076446	9076572	126	-	0
AT1G26240	1	9078139	9079576	1437	-	0
AT1G26250	1	9083837	9085464	1627	+	0
AT1G26260	1	9086852	9089378	2526	+	157
AT1G26270	1	9089523	9092457	2934	-	625
AT1G26290	1	9097983	9098667	684	+	48
AT1G26300	1	9095899	9099754	3855	-	300
AT1G26310	1	9100152	9103603	3451	-	2
AT1G26320	1	9105037	9107189	2152	+	0
AT1G26330	1	9107518	9113725	6207	+	99
AT1G26340	1	9113899	9114977	1078	+	183
AT1G26350	1	9116009	9116781	772	-	0
AT1G26355	1	9117949	9118611	662	-	0
AT1G26360	1	9118947	9121217	2270	-	0
AT1G26370	1	9121491	9125557	4066	-	505
AT1G26380	1	9126736	9128528	1792	-	9
AT1G26390	1	9130016	9131779	1763	-	5
AT1G26400	1	9133290	9134874	1584	-	0
AT1G26410	1	9138674	9140439	1765	-	2
AT1G26420	1	9141566	9143304	1738	-	3
AT1G26430	1	9143809	9143883	74	+	0
AT1G26440	1	9143966	9146050	2084	-	341
AT1G26450	1	9148709	9150250	1541	-	49
AT1G26460	1	9151731	9154740	3009	+	668
AT1G26470	1	9155090	9156246	1156	+	246
AT1G26480	1	9156328	9157950	1622	-	0
AT1G26490	1	9158182	9158255	73	+	0
AT1G26500	1	9158379	9159897	1518	+	50
AT1G26510	1	9159850	9161044	1194	-	0
AT1G26515	1	9161809	9162910	1101	-	0
AT1G26520	1	9163245	9165900	2655	-	154
AT1G26530	1	9165359	9167490	2131	+	12
AT1G26540	1	9167588	9170934	3346	-	81
AT1G26550	1	9171129	9172940	1811	+	1956
AT1G26558	1	9175610	9177598	1988	+	35
AT1G26560	1	9178377	9181835	3458	+	1474
AT1G26570	1	9182203	9184393	2190	+	242
AT1G26580	1	9184605	9187505	2900	+	1731
AT1G26590	1	9189623	9190709	1086	+	7
AT1G26600	1	9191606	9192401	795	+	17
AT1G26610	1	9193349	9195280	1931	+	3
AT1G26620	1	9195837	9199669	3832	-	313
AT1G26630	1	9205835	9207383	1548	+	8457
AT1G26640	1	9207387	9209902	2515	-	498
AT1G26650	1	9210088	9211560	1472	+	532
AT1G26660	1	9211739	9213974	2235	+	72
AT1G26665	1	9214173	9215552	1379	+	88
AT1G26670	1	9215900	9218010	2110	+	985
AT1G26680	1	9219462	9223649	4187	+	6
AT1G26690	1	9224144	9225775	1631	-	270
AT1G26700	1	9228234	9232240	4006	+	0
AT1G26710	1	9232327	9233144	817	-	0
AT1G26720	1	9234302	9234812	510	-	0
AT1G26730	1	9241434	9244650	3216	+	81
AT1G26740	1	9244980	9246603	1623	-	205
AT1G26750	1	9246786	9248274	1488	+	410
AT1G26760	1	9248151	9249943	1792	-	58
AT1G26761	1	9250223	9251644	1421	-	1340
AT1G26762	1	9253630	9254167	537	+	2
AT1G26770	1	9259604	9261313	1709	+	744
AT1G26771	1	9263168	9263273	105	-	0
AT1G26773	1	9264403	9264580	177	+	0
AT1G26780	1	9271028	9272463	1435	+	5
AT1G26790	1	9273856	9275312	1456	-	15
AT1G26795	1	9276380	9276954	574	+	0
AT1G26796	1	9278952	9279482	530	+	0
AT1G26797	1	9280954	9281560	606	+	0
AT1G26798	1	9281790	9282341	551	+	0
AT1G26799	1	9283872	9284438	566	+	0
AT1G26800	1	9285098	9286324	1226	-	131
AT1G26810	1	9286642	9289969	3327	-	171
AT1G26815	1	9290869	9291282	413	-	0
AT1G26820	1	9292445	9293784	1339	-	201
AT1G26830	1	9295735	9298541	2806	+	1312
AT1G26840	1	9298750	9300699	1949	+	71
AT1G26850	1	9300872	9304328	3456	-	3877
AT1G26860	1	9304981	9305800	819	-	0
AT1G26870	1	9312855	9314983	2128	+	0
AT1G26880	1	9315382	9316729	1347	-	1832
AT1G26890	1	9317588	9319246	1658	+	8
AT1G26900	1	9319755	9321474	1719	-	79
AT1G26910	1	9321649	9322965	1316	+	223
AT1G26911	1	9323739	9324200	461	+	7
AT1G26916	1	9327155	9327251	96	+	0
AT1G26920	1	9329511	9330398	887	+	953
AT1G26921	1	9330955	9331105	150	-	0
AT1G26930	1	9336056	9337786	1730	-	114
AT1G26940	1	9343125	9345145	2020	+	183
AT1G26945	1	9351453	9352761	1308	+	457
AT1G26950	1	9353847	9354324	477	-	0
AT1G26960	1	9355919	9357460	1541	+	70
AT1G26970	1	9359681	9361833	2152	+	3
AT1G26973	1	9363195	9363288	93	-	0
AT1G26975	1	9364470	9364570	100	+	0
AT1G26976	1	9364995	9365610	615	+	0
AT1G26985	1	9367079	9367179	100	+	0
AT1G26990	1	9368530	9373180	4650	-	0
AT1G27000	1	9373925	9376720	2795	+	1204
AT1G27008	1	9376787	9377244	457	-	0
AT1G27020	1	9378558	9380692	2134	+	38
AT1G27030	1	9381802	9383984	2182	+	764
AT1G27040	1	9386783	9390042	3259	-	2
AT1G27045	1	9391608	9393019	1411	+	99
AT1G27050	1	9393689	9394592	903	+	172
AT1G27060	1	9395022	9396673	1651	+	91
AT1G27070	1	9396657	9399453	2796	-	332
AT1G27080	1	9400663	9403789	3126	+	1
AT1G27090	1	9403899	9406256	2357	-	2341
AT1G27100	1	9407124	9411172	4048	-	850
AT1G27110	1	9412819	9417504	4685	-	30
AT1G27120	1	9421176	9424069	2893	+	639
AT1G27130	1	9425459	9426886	1427	+	765
AT1G27135	1	9427163	9427529	366	+	0
AT1G27140	1	9427857	9428716	859	+	0
AT1G27150	1	9429046	9432274	3228	+	668
AT1G27160	1	9432417	9433190	773	+	1
AT1G27170	1	9433487	9439417	5930	+	69
AT1G27180	1	9439858	9446106	6248	+	157
AT1G27190	1	9446656	9448825	2169	-	1077
AT1G27200	1	9449548	9451750	2202	-	285
AT1G27210	1	9455367	9458026	2659	-	911
AT1G27213	1	9460034	9460187	153	-	0
AT1G27220	1	9463805	9465444	1639	+	0
AT1G27240	1	9466236	9467076	840	+	0
AT1G27250	1	9468567	9469634	1067	+	0
AT1G27260	1	9469947	9470967	1020	+	0
AT1G27270	1	9472076	9473149	1073	+	0
AT1G27280	1	9474026	9474990	964	+	0
AT1G27285	1	9476196	9480516	4320	+	82
AT1G27290	1	9481531	9482912	1381	+	547
AT1G27300	1	9483156	9484368	1212	+	198
AT1G27310	1	9484315	9485896	1581	-	1221
AT1G27320	1	9487779	9492572	4793	+	2415
AT1G27330	1	9492963	9494069	1106	+	574
AT1G27340	1	9495519	9498085	2566	+	781
AT1G27350	1	9498150	9499425	1275	-	534
AT1G27360	1	9501076	9503869	2793	+	399
AT1G27370	1	9505200	9508481	3281	-	342
AT1G27380	1	9508744	9510066	1322	-	13
AT1G27385	1	9510474	9512860	2386	-	1034
AT1G27390	1	9513088	9515001	1913	-	539
AT1G27400	1	9515134	9516940	1806	+	2152
AT1G27410	1	9517200	9519025	1825	+	153
AT1G27420	1	9519107	9520520	1413	+	61
AT1G27430	1	9520910	9526928	6018	-	1181
AT1G27435	1	9527573	9528878	1305	-	373
AT1G27440	1	9529140	9531375	2235	-	182
AT1G27450	1	9531838	9534114	2276	+	1745
AT1G27460	1	9534531	9537561	3030	+	667
AT1G27461	1	9537745	9539013	1268	-	0
AT1G27470	1	9540112	9544292	4180	-	256
AT1G27480	1	9544513	9546285	1772	+	988
AT1G27490	1	9546372	9547073	701	-	0
AT1G27500	1	9551450	9554139	2689	-	182
AT1G27510	1	9554744	9558367	3623	-	1313
AT1G27520	1	9558634	9562381	3747	+	821
AT1G27530	1	9562590	9563963	1373	-	1263
AT1G27540	1	9566331	9567906	1575	-	192
AT1G27550	1	9568812	9569330	518	-	0
AT1G27560	1	9570854	9571987	1133	-	0
AT1G27565	1	9574549	9575189	640	+	0
AT1G27570	1	9575537	9582376	6839	+	3
AT1G27580	1	9589932	9591075	1143	-	2
AT1G27590	1	9592127	9594586	2459	+	233
AT1G27595	1	9596359	9603255	6896	+	702
AT1G27600	1	9603177	9606101	2924	-	488
AT1G27610	1	9607110	9607577	467	-	1
AT1G27620	1	9608417	9610542	2125	+	7
AT1G27630	1	9611102	9614336	3234	+	210
AT1G27640	1	9614462	9614906	444	-	1
AT1G27650	1	9614550	9616357	1807	+	770
AT1G27660	1	9621569	9626004	4435	+	215
AT1G27670	1	9627571	9628496	925	-	4
AT1G27671	1	9629025	9630729	1704	+	0
AT1G27680	1	9631284	9634597	3313	+	445
AT1G27690	1	9636593	9638577	1984	+	323
AT1G27695	1	9639023	9640151	1128	+	230
AT1G27700	1	9640197	9641901	1704	-	275
AT1G27710	1	9642473	9643352	879	+	0
AT1G27720	1	9643350	9647376	4026	-	19
AT1G27730	1	9648140	9649073	933	-	28
AT1G27740	1	9654687	9656089	1402	+	0
AT1G27750	1	9657384	9661958	4574	+	391
AT1G27752	1	9662084	9667539	5455	+	694
AT1G27760	1	9668583	9671616	3033	+	1529
AT1G27770	1	9671637	9676157	4520	-	874
AT1G27780	1	9677042	9682982	5940	+	0
AT1G27790	1	9683680	9684043	363	+	0
AT1G27800	1	9684837	9685473	636	+	0
AT1G27810	1	9686067	9687016	949	-	0
AT1G27815	1	9687756	9690536	2780	-	0
AT1G27820	1	9691627	9692560	933	+	2
AT1G27840	1	9693007	9696412	3405	-	253
AT1G27850	1	9698416	9703941	5525	+	877
AT1G27860	1	9704557	9706238	1681	-	1
AT1G27870	1	9706656	9707298	642	-	0
AT1G27880	1	9708923	9714089	5166	+	134
AT1G27890	1	9714135	9715044	909	-	0
AT1G27900	1	9715452	9720568	5116	-	375
AT1G27910	1	9720735	9724714	3979	-	493
AT1G27920	1	9726947	9729848	2901	+	353
AT1G27921	1	9728123	9730331	2208	-	51
AT1G27930	1	9731259	9732719	1460	-	793
AT1G27940	1	9733596	9738129	4533	-	122
AT1G27950	1	9740703	9742159	1456	+	2971
AT1G27960	1	9742187	9745787	3600	-	168
AT1G27970	1	9746810	9748467	1657	+	1260
AT1G27980	1	9748736	9752769	4033	+	138
AT1G27990	1	9752798	9753952	1154	-	0
AT1G28000	1	9756673	9757963	1290	-	1
AT1G28002	1	9759211	9760165	954	+	0
AT1G28007	1	9762023	9762209	186	+	0
AT1G28010	1	9763435	9768068	4633	+	178
AT1G28020	1	9768394	9771157	2763	-	0
AT1G28030	1	9771792	9773345	1553	+	0
AT1G28040	1	9773579	9775481	1902	-	0
AT1G28050	1	9775527	9777810	2283	-	92
AT1G28060	1	9779137	9782700	3563	+	691
AT1G28070	1	9782995	9783998	1003	+	73
AT1G28080	1	9789825	9791546	1721	+	1
AT1G28090	1	9795761	9799063	3302	+	474
AT1G28100	1	9801081	9804394	3313	+	265
AT1G28110	1	9803640	9806896	3256	-	328
AT1G28120	1	9812958	9815544	2586	-	632
AT1G28130	1	9825285	9828067	2782	+	202
AT1G28135	1	9829260	9829584	324	+	0
AT1G28140	1	9832815	9834427	1612	-	2098
AT1G28150	1	9834942	9835904	962	-	661
AT1G28160	1	9839386	9840124	738	+	0
AT1G28170	1	9841331	9842312	981	+	0
AT1G28180	1	9843074	9845002	1928	-	0
AT1G28190	1	9846883	9847923	1040	-	48
AT1G28200	1	9850146	9852366	2220	-	488
AT1G28210	1	9854545	9860158	5613	+	70
AT1G28220	1	9860302	9861434	1132	-	6
AT1G28230	1	9862072	9864606	2534	-	245
AT1G28240	1	9868315	9872211	3896	-	648
AT1G28250	1	9874246	9875579	1333	+	209
AT1G28260	1	9875599	9879267	3668	-	234
AT1G28270	1	9883037	9883870	833	+	0
AT1G28280	1	9886076	9887478	1402	-	606
AT1G28281	1	9887518	9887656	138	+	0
AT1G28290	1	9889124	9890993	1869	-	1129
AT1G28300	1	9896866	9899876	3010	-	2
AT1G28304	1	9903566	9904010	444	+	0
AT1G28305	1	9904733	9905516	783	-	0
AT1G28306	1	9907201	9907615	414	-	0
AT1G28307	1	9909019	9909127	108	+	0
AT1G28310	1	9911897	9913837	1940	-	259
AT1G28320	1	9920506	9924488	3982	-	757
AT1G28323	1	9928400	9931731	3331	+	0
AT1G28327	1	9931933	9933451	1518	+	0
AT1G28330	1	9933883	9935271	1388	-	190
AT1G28335	1	9937000	9937733	733	+	0
AT1G28340	1	9940174	9943549	3375	+	1111
AT1G28350	1	9944035	9949800	5765	+	541
AT1G28360	1	9951847	9952740	893	+	14
AT1G28370	1	9955968	9956940	972	-	12
AT1G28375	1	9961054	9961703	649	+	0
AT1G28380	1	9963592	9966320	2728	+	723
AT1G28390	1	9966185	9968301	2116	-	100
AT1G28395	1	9969320	9971681	2361	-	137
AT1G28400	1	9972383	9973793	1410	-	1432
AT1G28410	1	9976181	9979267	3086	-	280
AT1G28420	1	9979801	9987638	7837	+	1252
AT1G28430	1	9992985	9994642	1657	-	1
AT1G28440	1	9996823	10000447	3624	+	1702
AT1G28447	1	10003149	10003540	391	+	0
AT1G28450	1	10003965	10004523	558	+	2
AT1G28455	1	10005229	10005700	471	+	1
AT1G28460	1	10006229	10006778	549	+	1
AT1G28465	1	10007520	10008087	567	+	0
AT1G28470	1	10010180	10012198	2018	+	15
AT1G28480	1	10013473	10014073	600	-	1
AT1G28490	1	10015918	10018047	2129	+	439
AT1G28500	1	10018690	10020350	1660	+	0
AT1G28510	1	10023875	10026295	2420	+	380
AT1G28520	1	10029149	10031990	2841	+	786
AT1G28530	1	10031996	10035500	3504	-	196
AT1G28540	1	10035663	10036956	1293	+	159
AT1G28550	1	10036965	10037698	733	-	0
AT1G28560	1	10038037	10041544	3507	-	223
AT1G28570	1	10041640	10044150	2510	-	253
AT1G28580	1	10044336	10046442	2106	-	502
AT1G28590	1	10047275	10049300	2025	-	0
AT1G28591	1	10049484	10049857	373	-	0
AT1G28600	1	10051000	10053117	2117	-	1205
AT1G28610	1	10053616	10055731	2115	-	1041
AT1G28620	1	10056192	10057819	1627	-	153
AT1G28630	1	10058455	10063460	5005	-	0
AT1G28640	1	10067562	10069177	1615	-	0
AT1G28650	1	10069364	10071082	1718	-	0
AT1G28660	1	10071711	10073411	1700	-	173
AT1G28670	1	10074506	10076344	1838	-	722
AT1G28680	1	10078188	10080029	1841	+	85
AT1G28685	1	10077922	10079643	1721	-	7
AT1G28690	1	10080041	10081604	1563	-	24
AT1G28695	1	10081893	10083122	1229	-	0
AT1G28700	1	10083499	10085030	1531	-	0
AT1G28710	1	10086599	10089772	3173	-	263
AT1G28720	1	10089436	10089508	72	+	0
AT1G28730	1	10089897	10089969	72	+	4
AT1G28740	1	10090367	10090439	72	+	0
AT1G28750	1	10090768	10090840	72	+	0
AT1G28760	1	10103157	10104588	1431	+	103
AT1G28770	1	10092324	10092396	72	+	0
AT1G28780	1	10092800	10092872	72	+	0
AT1G28790	1	10093308	10093380	72	+	0
AT1G28800	1	10093745	10093817	72	+	0
AT1G28810	1	10094172	10094244	72	+	0
AT1G28815	1	10095796	10096374	578	+	15
AT1G28820	1	10096950	10097022	72	+	4
AT1G28830	1	10097113	10097185	72	+	1
AT1G28840	1	10097717	10097789	72	+	3
AT1G28850	1	10098652	10098724	72	+	0
AT1G28860	1	10099078	10099150	72	+	0
AT1G28870	1	10099424	10099496	72	+	0
AT1G28880	1	10099826	10099898	72	+	0
AT1G28890	1	10100272	10100344	72	+	1
AT1G28900	1	10101027	10101099	72	+	0
AT1G28910	1	10101599	10101671	72	+	0
AT1G28920	1	10101992	10102064	72	+	1
AT1G28930	1	10106089	10106161	72	+	0
AT1G28940	1	10106527	10106599	72	+	1
AT1G28950	1	10106897	10106969	72	+	1
AT1G28960	1	10109499	10111660	2161	-	466
AT1G28970	1	10107648	10107720	72	+	5
AT1G28980	1	10108388	10108460	72	+	2
AT1G28990	1	10108709	10108781	72	+	1
AT1G29000	1	10113017	10114340	1323	+	0
AT1G29010	1	10117714	10119085	1371	+	0
AT1G29020	1	10120496	10122902	2406	-	0
AT1G29025	1	10124347	10127068	2721	-	0
AT1G29030	1	10129034	10133961	4927	-	146
AT1G29040	1	10134068	10136241	2173	+	417
AT1G29041	1	10135450	10136241	791	+	0
AT1G29050	1	10136229	10139208	2979	-	463
AT1G29060	1	10147692	10149686	1994	+	131
AT1G29070	1	10149790	10151360	1570	+	6440
AT1G29071	1	10151667	10151774	107	-	2
AT1G29075	1	10153542	10154701	1159	+	0
AT1G29080	1	10157493	10158674	1181	-	0
AT1G29090	1	10162982	10164452	1470	-	1
AT1G29100	1	10169083	10169619	536	+	0
AT1G29110	1	10171682	10173071	1389	+	11
AT1G29120	1	10174186	10178521	4335	+	1099
AT1G29140	1	10178901	10180019	1118	+	0
AT1G29150	1	10180517	10182703	2186	+	2015
AT1G29160	1	10183796	10184324	528	-	21
AT1G29170	1	10190213	10194900	4687	-	670
AT1G29179	1	10198763	10200255	1492	+	0
AT1G29180	1	10199627	10200962	1335	+	0
AT1G29190	1	10201044	10201799	755	-	0
AT1G29195	1	10202535	10203396	861	-	22
AT1G29200	1	10207821	10210622	2801	+	18
AT1G29210	1	10207305	10207378	73	-	0
AT1G29220	1	10210519	10212722	2203	-	418
AT1G29230	1	10214859	10216422	1563	+	7
AT1G29240	1	10216778	10219846	3068	-	153
AT1G29250	1	10223265	10224727	1462	-	593
AT1G29260	1	10224814	10226205	1391	+	475
AT1G29265	1	10227072	10227195	123	+	0
AT1G29270	1	10230086	10231142	1056	+	74
AT1G29280	1	10236366	10237467	1101	+	5
AT1G29290	1	10244965	10245572	607	+	5
AT1G29300	1	10247779	10249594	1815	-	70
AT1G29310	1	10252293	10254690	2397	+	502
AT1G29320	1	10255320	10258343	3023	+	191
AT1G29330	1	10258247	10261112	2865	-	99
AT1G29340	1	10264394	10266818	2424	+	857
AT1G29350	1	10268468	10273788	5320	-	156
AT1G29355	1	10274047	10275539	1492	+	1
AT1G29357	1	10274101	10275718	1617	-	118
AT1G29360	1	10275978	10277747	1769	+	0
AT1G29370	1	10277889	10283198	5309	-	155
AT1G29380	1	10284120	10285970	1850	+	91
AT1G29390	1	10286292	10288103	1811	-	1238
AT1G29395	1	10288196	10289621	1425	-	1080
AT1G29400	1	10290039	10294630	4591	-	2825
AT1G29410	1	10297876	10300005	2129	-	150
AT1G29418	1	10300877	10301302	425	+	212
AT1G29420	1	10301151	10301951	800	-	15
AT1G29430	1	10302649	10303335	686	-	215
AT1G29440	1	10304506	10305108	602	-	159
AT1G29450	1	10305950	10306499	549	-	210
AT1G29460	1	10307506	10308143	637	-	178
AT1G29465	1	10308573	10309798	1225	+	162
AT1G29470	1	10310244	10314048	3804	-	4250
AT1G29475	1	10315833	10317528	1695	+	0
AT1G29480	1	10317935	10318711	776	+	0
AT1G29490	1	10319743	10320402	659	+	2
AT1G29500	1	10321209	10321864	655	+	209
AT1G29510	1	10322573	10323189	616	+	120
AT1G29520	1	10323654	10324743	1089	+	298
AT1G29530	1	10324744	10326735	1991	-	778
AT1G29540	1	10327370	10328105	735	+	3
AT1G29550	1	10330513	10332326	1813	+	148
AT1G29560	1	10332370	10335694	3324	+	166
AT1G29570	1	10335909	10337854	1945	+	0
AT1G29580	1	10338442	10339146	704	+	0
AT1G29590	1	10339936	10342848	2912	+	45
AT1G29600	1	10344045	10346243	2198	+	419
AT1G29620	1	10347362	10349017	1655	+	0
AT1G29630	1	10349426	10353736	4310	+	176
AT1G29640	1	10355702	10356482	780	-	29
AT1G29650	1	10357605	10363195	5590	+	2
AT1G29660	1	10371838	10373766	1928	+	5996
AT1G29670	1	10375762	10377871	2109	+	2642
AT1G29680	1	10377789	10378961	1172	-	0
AT1G29690	1	10379019	10382123	3104	-	317
AT1G29700	1	10384980	10387441	2461	-	2430
AT1G29710	1	10387672	10389100	1428	+	105
AT1G29715	1	10389293	10392668	3375	-	5
AT1G29720	1	10393796	10399873	6077	-	2344
AT1G29730	1	10400563	10405874	5311	-	79
AT1G29740	1	10407378	10412997	5619	-	16
AT1G29750	1	10413880	10420524	6644	-	569
AT1G29760	1	10422330	10424327	1997	+	221
AT1G29770	1	10424575	10425801	1226	+	84
AT1G29780	1	10426949	10427615	666	+	23
AT1G29785	1	10427612	10429133	1521	-	138
AT1G29790	1	10429975	10432034	2059	+	500
AT1G29800	1	10432600	10435441	2841	+	361
AT1G29810	1	10435373	10437506	2133	-	225
AT1G29820	1	10437656	10440786	3130	+	186
AT1G29830	1	10441052	10445657	4605	+	3
AT1G29840	1	10445624	10447553	1929	-	179
AT1G29850	1	10447753	10449946	2193	+	1099
AT1G29860	1	10454481	10455785	1304	+	0
AT1G29870	1	10456901	10458782	1881	-	0
AT1G29880	1	10459477	10462801	3324	-	2708
AT1G29890	1	10463402	10467170	3768	+	775
AT1G29900	1	10468053	10472211	4158	+	2313
AT1G29910	1	10472279	10473299	1020	-	149077
AT1G29920	1	10474783	10475959	1176	-	128943
AT1G29930	1	10478004	10479048	1044	+	263498
AT1G29940	1	10479120	10486819	7699	-	529
AT1G29950	1	10491697	10494598	2901	+	147
AT1G29951	1	10491974	10494598	2624	+	0
AT1G29952	1	10491974	10494598	2624	+	0
AT1G29960	1	10494706	10496170	1464	+	88
AT1G29962	1	10496729	10497287	558	+	0
AT1G29965	1	10498309	10499462	1153	-	14
AT1G29970	1	10498350	10501452	3102	-	322
AT1G29980	1	10503277	10506117	2840	-	247
AT1G29990	1	10507592	10509098	1506	+	549
AT1G30000	1	10509210	10512468	3258	-	509
AT1G30010	1	10513193	10516385	3192	+	89
AT1G30016	1	10521119	10521215	96	-	0
AT1G30020	1	10515873	10516347	474	-	0
AT1G30030	1	10531830	10534842	3012	+	0
AT1G30040	1	10537647	10539831	2184	+	56
AT1G30050	1	10543021	10544591	1570	+	0
AT1G30060	1	10545086	10545906	820	-	0
AT1G30070	1	10546590	10548151	1561	-	303
AT1G30080	1	10550946	10553215	2269	-	1
AT1G30090	1	10559560	10561423	1863	-	472
AT1G30100	1	10571339	10573365	2026	+	13
AT1G30110	1	10581734	10584080	2346	+	94
AT1G30120	1	10584159	10586635	2476	-	3712
AT1G30130	1	10587601	10589760	2159	+	334
AT1G30135	1	10596491	10597239	748	+	0
AT1G30140	1	10598626	10599696	1070	+	1
AT1G30150	1	10602177	10605159	2982	+	0
AT1G30160	1	10606209	10607810	1601	+	59
AT1G30170	1	10607887	10609618	1731	-	0
AT1G30180	1	10610684	10614013	3329	+	1
AT1G30190	1	10618965	10619802	837	+	31
AT1G30200	1	10625028	10627105	2077	+	846
AT1G30210	1	10627184	10630610	3426	-	723
AT1G30220	1	10632820	10635471	2651	-	13
AT1G30230	1	10638910	10640782	1872	+	4216
AT1G30240	1	10641098	10645935	4837	-	218
AT1G30250	1	10646986	10647511	525	-	581
AT1G30260	1	10651050	10651728	678	+	344
AT1G30270	1	10654856	10658897	4041	+	501
AT1G30280	1	10662662	10664668	2006	-	43
AT1G30282	1	10663331	10664763	1432	+	0
AT1G30290	1	10670319	10672740	2421	-	186
AT1G30300	1	10672997	10675368	2371	+	195
AT1G30310	1	10675488	10675935	447	-	0
AT1G30320	1	10680245	10682954	2709	+	241
AT1G30330	1	10685821	10690838	5017	-	1194
AT1G30340	1	10696998	10701393	4395	+	0
AT1G30350	1	10710078	10711664	1586	-	0
AT1G30360	1	10715664	10718997	3333	+	3993
AT1G30370	1	10719168	10720758	1590	-	1
AT1G30380	1	10722196	10723247	1051	+	68256
AT1G30390	1	10723453	10725016	1563	+	3
AT1G30400	1	10727637	10738055	10418	+	4313
AT1G30410	1	10738804	10747323	8519	+	933
AT1G30420	1	10748815	10756316	7501	+	380
AT1G30430	1	10756721	10756794	73	+	0
AT1G30440	1	10759474	10762394	2920	+	928
AT1G30450	1	10762738	10769532	6794	+	743
AT1G30455	1	10769721	10770775	1054	+	0
AT1G30460	1	10770812	10775402	4590	-	272
AT1G30470	1	10779170	10786697	7527	+	1486
AT1G30473	1	10786978	10788683	1705	+	0
AT1G30475	1	10788225	10790125	1900	-	42
AT1G30480	1	10790021	10792575	2554	+	250
AT1G30490	1	10796134	10800961	4827	-	706
AT1G30500	1	10804449	10806319	1870	-	246
AT1G30510	1	10806984	10809188	2204	-	407
AT1G30515	1	10809288	10809915	627	-	26
AT1G30520	1	10810983	10813700	2717	+	1518
AT1G30530	1	10814658	10816583	1925	+	1813
AT1G30540	1	10816773	10819362	2589	-	239
AT1G30550	1	10819553	10823659	4106	-	93
AT1G30560	1	10824760	10826293	1533	+	0
AT1G30570	1	10828932	10831482	2550	+	327
AT1G30580	1	10831672	10835538	3866	-	2894
AT1G30590	1	10835793	10840005	4212	-	1227
AT1G30600	1	10841141	10845050	3909	-	407
AT1G30610	1	10846512	10850628	4116	+	920
AT1G30620	1	10854548	10858244	3696	+	173
AT1G30630	1	10858297	10860261	1964	-	1579
AT1G30640	1	10860654	10864700	4046	+	158
AT1G30650	1	10868302	10871297	2995	+	44
AT1G30660	1	10876852	10879017	2165	+	9
AT1G30670	1	10879172	10880188	1016	-	0
AT1G30680	1	10881596	10886425	4829	+	636
AT1G30690	1	10887606	10890332	2726	+	1437
AT1G30700	1	10892569	10894572	2003	+	2
AT1G30710	1	10895279	10897109	1830	+	0
AT1G30720	1	10898171	10899912	1741	+	3
AT1G30730	1	10900853	10902534	1681	+	1
AT1G30740	1	10903028	10904630	1602	+	1
AT1G30750	1	10904906	10905709	803	-	1
AT1G30755	1	10905816	10908892	3076	-	119
AT1G30757	1	10909149	10909784	635	+	18
AT1G30760	1	10918277	10920677	2400	+	17
AT1G30780	1	10923918	10926561	2643	-	0
AT1G30784	1	10929535	10930090	555	-	0
AT1G30790	1	10932712	10934066	1354	+	0
AT1G30795	1	10935752	10936348	596	+	0
AT1G30800	1	10936922	10938099	1177	+	0
AT1G30810	1	10936764	10942292	5528	-	562
AT1G30814	1	10942647	10944727	2080	-	0
AT1G30820	1	10944912	10949458	4546	-	719
AT1G30825	1	10960940	10963182	2242	+	225
AT1G30830	1	10963572	10963646	74	-	0
AT1G30835	1	10966906	10968878	1972	+	351
AT1G30840	1	10974444	10976298	1854	+	77
AT1G30845	1	10979645	10980688	1043	+	49
AT1G30850	1	10985077	10986295	1218	+	1
AT1G30860	1	10986522	10989504	2982	-	89
AT1G30870	1	10991484	10993023	1539	+	1
AT1G30880	1	10993194	10994125	931	-	689
AT1G30890	1	10994320	10996134	1814	+	352
AT1G30900	1	10997274	11000543	3269	+	112
AT1G30910	1	11000882	11002936	2054	+	852
AT1G30920	1	11004241	11005444	1203	-	0
AT1G30921	1	11007111	11008238	1127	-	0
AT1G30925	1	11009887	11011792	1905	-	0
AT1G30930	1	11014782	11015913	1131	-	0
AT1G30935	1	11017435	11018990	1555	-	8
AT1G30940	1	11021983	11023320	1337	-	2
AT1G30945	1	11026337	11026784	447	-	0
AT1G30950	1	11036179	11037508	1329	+	5
AT1G30960	1	11037611	11040033	2422	-	44
AT1G30970	1	11040280	11043751	3471	-	754
AT1G30972	1	11044630	11045466	836	+	0
AT1G30974	1	11046968	11047816	848	+	0
AT1G30975	1	11048255	11048552	297	-	0
AT1G30980	1	11049582	11050729	1147	-	0
AT1G30990	1	11052129	11053063	934	+	0
AT1G31000	1	11053376	11054561	1185	-	0
AT1G31010	1	11054730	11056921	2191	-	88
AT1G31020	1	11057104	11058867	1763	+	174
AT1G31030	1	11064582	11067201	2619	-	0
AT1G31040	1	11069792	11072291	2499	-	51
AT1G31050	1	11075626	11079240	3614	-	7
AT1G31070	1	11084858	11088563	3705	+	566
AT1G31072	1	11089490	11089925	435	+	0
AT1G31080	1	11091831	11092899	1068	+	0
AT1G31090	1	11094406	11095649	1243	+	0
AT1G31093	1	11096083	11096599	516	-	0
AT1G31100	1	11097033	11100418	3385	-	0
AT1G31110	1	11104112	11104186	74	+	0
AT1G31120	1	11104300	11107763	3463	-	217
AT1G31130	1	11114700	11116195	1495	-	1211
AT1G31140	1	11117992	11119785	1793	+	1
AT1G31150	1	11120096	11122587	2491	+	289
AT1G31160	1	11122657	11124155	1498	-	673
AT1G31163	1	11128731	11130239	1508	-	0
AT1G31166	1	11130615	11130981	366	+	0
AT1G31170	1	11133409	11134844	1435	+	958
AT1G31173	1	11137364	11138969	1605	+	259
AT1G31175	1	11140548	11142630	2082	+	248
AT1G31180	1	11142713	11144633	1920	-	1333
AT1G31190	1	11144771	11146930	2159	+	1739
AT1G31200	1	11146922	11147678	756	-	105
AT1G31210	1	11148253	11152501	4248	-	0
AT1G31220	1	11156801	11158683	1882	+	205
AT1G31230	1	11158617	11163274	4657	-	3401
AT1G31240	1	11163857	11164928	1071	-	24
AT1G31245	1	11165704	11165830	126	-	0
AT1G31250	1	11166556	11167547	991	-	0
AT1G31258	1	11171224	11171835	611	+	15
AT1G31260	1	11175558	11177362	1804	-	0
AT1G31270	1	11178348	11178658	310	+	0
AT1G31274	1	11179997	11180462	465	-	0
AT1G31280	1	11181710	11185344	3634	+	353
AT1G31290	1	11188292	11192317	4025	+	12
AT1G31300	1	11193634	11196312	2678	+	783
AT1G31310	1	11198352	11200141	1789	-	48
AT1G31319	1	11211806	11211914	108	-	0
AT1G31320	1	11213016	11214382	1366	+	91
AT1G31330	1	11214823	11216037	1214	-	116022
AT1G31335	1	11216913	11217393	480	-	182
AT1G31340	1	11217844	11219458	1614	-	1748
AT1G31350	1	11221334	11222786	1452	-	196
AT1G31355	1	11228987	11229990	1003	+	11
AT1G31358	1	11230462	11230612	150	-	0
AT1G31360	1	11232332	11237530	5198	+	297
AT1G31370	1	11238297	11239363	1066	-	0
AT1G31380	1	11240450	11241099	649	-	0
AT1G31390	1	11243190	11244392	1202	-	0
AT1G31400	1	11245224	11246481	1257	-	0
AT1G31410	1	11246913	11249359	2446	-	767
AT1G31420	1	11249599	11253915	4316	+	3727
AT1G31430	1	11253935	11255737	1802	-	16
AT1G31440	1	11255835	11258715	2880	-	1182
AT1G31450	1	11259871	11261209	1338	-	0
AT1G31460	1	11261540	11263364	1824	-	55
AT1G31470	1	11262917	11264963	2046	-	62
AT1G31480	1	11265879	11271701	5822	+	324
AT1G31485	1	11271743	11273075	1332	+	0
AT1G31490	1	11271227	11273294	2067	-	2
AT1G31500	1	11273604	11276577	2973	-	541
AT1G31510	1	11277416	11278462	1046	+	0
AT1G31520	1	11278982	11279639	657	-	0
AT1G31530	1	11281187	11282468	1281	-	0
AT1G31540	1	11288451	11293753	5302	-	730
AT1G31550	1	11295524	11297379	1855	-	259
AT1G31570	1	11302781	11309164	6383	-	7
AT1G31580	1	11311168	11311989	821	+	20820
AT1G31600	1	11312960	11316473	3513	-	613
AT1G31620	1	11316940	11317894	954	+	0
AT1G31630	1	11318527	11319547	1020	-	0
AT1G31640	1	11322691	11324176	1485	-	0
AT1G31650	1	11326300	11330738	4438	-	919
AT1G31660	1	11330955	11333540	2585	-	436
AT1G31670	1	11337557	11341889	4332	+	0
AT1G31690	1	11343979	11347767	3788	+	164
AT1G31710	1	11349839	11355486	5647	+	494
AT1G31720	1	11356101	11357081	980	+	12
AT1G31730	1	11359641	11364288	4647	+	1476
AT1G31740	1	11365284	11369908	4624	-	0
AT1G31750	1	11370658	11372077	1419	-	48
AT1G31760	1	11372424	11373483	1059	-	55
AT1G31770	1	11374892	11377794	2902	-	359
AT1G31772	1	11378939	11379414	475	+	0
AT1G31780	1	11391226	11394748	3522	+	897
AT1G31790	1	11394689	11396018	1329	-	46
AT1G31800	1	11396401	11399714	3313	+	4247
AT1G31810	1	11399606	11406259	6653	-	601
AT1G31812	1	11410874	11412204	1330	-	7874
AT1G31814	1	11412607	11414502	1895	-	136
AT1G31817	1	11414748	11416444	1696	-	458
AT1G31820	1	11416450	11418279	1829	-	145
AT1G31830	1	11418624	11420837	2213	-	235
AT1G31835	1	11423058	11423684	626	-	38
AT1G31840	1	11423905	11426714	2809	+	10
AT1G31850	1	11430221	11433699	3478	+	583
AT1G31860	1	11434107	11436607	2500	-	433
AT1G31870	1	11436718	11440109	3391	+	430
AT1G31875	1	11442912	11443044	132	-	0
AT1G31880	1	11445489	11450189	4700	+	30
AT1G31885	1	11450459	11451985	1526	+	3
AT1G31900	1	11457876	11458134	258	+	5
AT1G31910	1	11457125	11461825	4700	+	3143
AT1G31920	1	11461854	11463848	1994	-	576
AT1G31930	1	11464984	11469185	4201	+	840
AT1G31935	1	11469481	11470010	529	+	26
AT1G31940	1	11470055	11471340	1285	-	280
AT1G31950	1	11475806	11478194	2388	+	30
AT1G31960	1	11479132	11479654	522	-	0
AT1G31970	1	11479865	11482890	3025	+	1086
AT1G31983	1	11501673	11503237	1564	-	4
AT1G31990	1	11488015	11489287	1272	+	0
AT1G31993	1	11503575	11507662	4087	+	0
AT1G32000	1	11508284	11508909	625	-	0
AT1G32010	1	11509340	11512040	2700	-	0
AT1G32020	1	11512551	11513067	516	-	0
AT1G32030	1	11514593	11515595	1002	+	0
AT1G32040	1	11518417	11520070	1653	+	0
AT1G32045	1	11520688	11520876	188	-	0
AT1G32049	1	11527727	11528207	480	+	0
AT1G32050	1	11528444	11531281	2837	+	1987
AT1G32060	1	11532532	11534639	2107	+	55893
AT1G32070	1	11534681	11536338	1657	-	2227
AT1G32080	1	11537341	11539800	2459	-	17593
AT1G32090	1	11540024	11544131	4107	-	321
AT1G32100	1	11546337	11547994	1657	-	306
AT1G32110	1	11552176	11552310	134	-	1
AT1G32120	1	11552925	11558777	5852	+	326
AT1G32130	1	11558860	11561920	3060	-	1406
AT1G32140	1	11562741	11564833	2092	-	0
AT1G32150	1	11565517	11568531	3014	+	308
AT1G32160	1	11568664	11570387	1723	+	2526
AT1G32170	1	11575319	11577927	2608	+	47
AT1G32172	1	11578505	11580547	2042	+	8
AT1G32180	1	11586515	11589651	3136	-	1
AT1G32190	1	11592954	11595982	3028	-	77
AT1G32200	1	11601780	11605060	3280	-	2664
AT1G32210	1	11605856	11607768	1912	-	616
AT1G32220	1	11607853	11609733	1880	+	4336
AT1G32225	1	11610113	11610625	512	+	0
AT1G32230	1	11612117	11616218	4101	+	4203
AT1G32240	1	11625699	11630626	4927	-	194
AT1G32250	1	11639842	11640343	501	+	0
AT1G32260	1	11640580	11641871	1291	-	212
AT1G32270	1	11642592	11644962	2370	+	1
AT1G32280	1	11646219	11646816	597	+	0
AT1G32290	1	11650221	11650567	346	-	0
AT1G32300	1	11651341	11653365	2024	+	0
AT1G32310	1	11653563	11654794	1231	+	126
AT1G32320	1	11655155	11656073	918	+	1
AT1G32330	1	11656985	11660376	3391	-	169
AT1G32337	1	11661814	11662122	308	+	0
AT1G32340	1	11663069	11666058	2989	-	275
AT1G32350	1	11666976	11668690	1714	-	0
AT1G32360	1	11672930	11675339	2409	+	557
AT1G32361	1	11675530	11676748	1218	+	0
AT1G32370	1	11676960	11678449	1489	+	253
AT1G32375	1	11679229	11680679	1450	+	2
AT1G32380	1	11681751	11684478	2727	+	634
AT1G32385	1	11685059	11685144	85	+	1
AT1G32390	1	11688128	11688707	579	+	0
AT1G32400	1	11689105	11691531	2426	-	1879
AT1G32410	1	11693798	11695566	1768	+	421
AT1G32415	1	11695610	11697896	2286	+	37
AT1G32420	1	11701994	11702903	909	+	0
AT1G32430	1	11704931	11706325	1394	-	0
AT1G32440	1	11712161	11715112	2951	+	1381
AT1G32450	1	11715149	11719970	4821	-	209
AT1G32460	1	11738117	11739326	1209	+	315
AT1G32470	1	11739303	11740361	1058	-	14015
AT1G32480	1	11741082	11741990	908	+	0
AT1G32490	1	11742053	11749788	7735	-	1000
AT1G32500	1	11749822	11752106	2284	-	2228
AT1G32505	1	11753253	11754123	870	+	0
AT1G32510	1	11756999	11758118	1119	+	6
AT1G32520	1	11758210	11759280	1070	-	897
AT1G32530	1	11759458	11762607	3149	-	703
AT1G32540	1	11767503	11769898	2395	+	772
AT1G32550	1	11771765	11774187	2422	-	1592
AT1G32560	1	11774483	11775279	796	+	4
AT1G32570	1	11776764	11777557	793	+	5
AT1G32580	1	11784056	11785637	1581	+	642
AT1G32582	1	11785935	11786037	102	+	0
AT1G32583	1	11785805	11788286	2481	+	56
AT1G32585	1	11788514	11789177	663	-	0
AT1G32590	1	11789767	11793772	4005	+	0
AT1G32600	1	11794801	11795683	882	+	0
AT1G32610	1	11795608	11797141	1533	-	49
AT1G32620	1	11797247	11797285	38	-	1
AT1G32630	1	11797334	11798602	1268	+	91
AT1G32640	1	11798809	11800988	2179	-	433
AT1G32650	1	11810556	11810631	75	-	0
AT1G32660	1	11811039	11812380	1341	+	0
AT1G32670	1	11815663	11815976	313	+	0
AT1G32680	1	11818033	11818279	246	+	0
AT1G32690	1	11820907	11821710	803	-	33
AT1G32700	1	11827432	11829759	2327	+	429
AT1G32710	1	11833112	11833706	594	+	0
AT1G32713	1	11834067	11834180	113	-	0
AT1G32720	1	11834901	11836631	1730	+	0
AT1G32730	1	11840909	11843257	2348	+	152
AT1G32740	1	11844876	11846347	1471	+	113
AT1G32750	1	11846246	11856765	10519	-	1253
AT1G32760	1	11858210	11859292	1082	+	47
AT1G32763	1	11860485	11860891	406	-	0
AT1G32770	1	11865342	11866950	1608	-	0
AT1G32780	1	11869824	11872926	3102	-	164
AT1G32790	1	11874703	11877387	2684	-	1824
AT1G32810	1	11881809	11885843	4034	+	555
AT1G32820	1	11888388	11890377	1989	+	0
AT1G32830	1	11891180	11894820	3640	-	0
AT1G32840	1	11896545	11899695	3150	-	0
AT1G32850	1	11902628	11906900	4272	+	1
AT1G32860	1	11907108	11908928	1820	-	188
AT1G32870	1	11911678	11913947	2269	+	248
AT1G32880	1	11913927	11914735	808	-	0
AT1G32890	1	11914966	11919845	4879	-	0
AT1G32900	1	11920389	11923766	3377	-	5290
AT1G32910	1	11925425	11926908	1483	+	0
AT1G32920	1	11928806	11929302	496	+	74
AT1G32928	1	11931202	11931801	599	+	22
AT1G32930	1	11931841	11934759	2918	-	131
AT1G32940	1	11937595	11940978	3383	+	225
AT1G32950	1	11941437	11944760	3323	+	6
AT1G32960	1	11945306	11948650	3344	+	0
AT1G32970	1	11948720	11951982	3262	-	0
AT1G32975	1	11953088	11953899	811	+	0
AT1G32980	1	11954277	11955362	1085	-	0
AT1G32990	1	11955784	11957284	1500	+	7291
AT1G32992	1	11957459	11957730	271	+	0
AT1G33000	1	11957967	11958162	195	+	0
AT1G33010	1	11959286	11960591	1305	+	0
AT1G33020	1	11962745	11964832	2087	+	0
AT1G33030	1	11964775	11966276	1501	-	0
AT1G33040	1	11966469	11967843	1374	+	1566
AT1G33050	1	11967815	11971532	3717	-	897
AT1G33055	1	11971307	11972578	1271	-	10
AT1G33060	1	11975339	11978521	3182	-	301
AT1G33070	1	11982888	11985299	2411	+	0
AT1G33080	1	11985706	11990482	4776	+	272
AT1G33090	1	11993297	11996712	3415	+	0
AT1G33100	1	11997682	12001308	3626	+	0
AT1G33102	1	12002332	12002877	545	-	32
AT1G33110	1	12004926	12008833	3907	+	1617
AT1G33120	1	12010900	12012524	1624	+	859
AT1G33130	1	12016650	12018654	2004	-	0
AT1G33135	1	12018682	12019195	513	+	0
AT1G33140	1	12023274	12024783	1509	+	1131
AT1G33160	1	12024805	12025328	523	+	0
AT1G33170	1	12027083	12030539	3456	+	1172
AT1G33180	1	12030584	12030892	308	+	0
AT1G33190	1	12033886	12034755	869	-	0
AT1G33200	1	12041778	12044690	2912	+	1
AT1G33220	1	12044871	12045879	1008	+	0
AT1G33230	1	12046640	12050066	3426	+	585
AT1G33240	1	12051470	12054546	3076	-	2862
AT1G33250	1	12057249	12059485	2236	-	477
AT1G33260	1	12064508	12066376	1868	+	159
AT1G33265	1	12066594	12068075	1481	+	209
AT1G33270	1	12068062	12070374	2312	-	569
AT1G33280	1	12072740	12073839	1099	+	0
AT1G33290	1	12074098	12076104	2006	+	995
AT1G33300	1	12080512	12080824	312	-	0
AT1G33320	1	12081008	12083462	2454	+	1
AT1G33330	1	12084950	12086528	1578	+	359
AT1G33340	1	12087579	12088958	1379	+	173
AT1G33350	1	12089402	12091687	2285	-	29
AT1G33360	1	12091876	12096025	4149	+	324
AT1G33370	1	12097278	12097347	69	-	0
AT1G33380	1	12099095	12099378	283	-	0
AT1G33390	1	12099481	12104601	5120	-	296
AT1G33400	1	12104783	12109524	4741	-	376
AT1G33410	1	12109589	12118850	9261	-	627
AT1G33415	1	12118991	12126593	7602	+	86
AT1G33420	1	12120885	12123576	2691	-	181
AT1G33430	1	12124236	12126481	2245	-	18
AT1G33440	1	12127388	12130407	3019	-	177
AT1G33450	1	12139227	12139780	553	+	0
AT1G33460	1	12140011	12142760	2749	-	0
AT1G33470	1	12144514	12147208	2694	+	1327
AT1G33475	1	12147275	12148249	974	-	20
AT1G33480	1	12148601	12150263	1662	-	277
AT1G33490	1	12150689	12152394	1705	-	528
AT1G33500	1	12152572	12154715	2143	+	3
AT1G33510	1	12155844	12156871	1027	-	0
AT1G33520	1	12157155	12158953	1798	-	617
AT1G33530	1	12159883	12161314	1431	+	0
AT1G33540	1	12162348	12164700	2352	-	0
AT1G33550	1	12166397	12166621	224	-	0
AT1G33560	1	12168767	12172005	3238	+	257
AT1G33570	1	12173001	12174499	1498	-	0
AT1G33580	1	12174772	12176059	1287	-	0
AT1G33590	1	12177776	12179413	1637	+	1814
AT1G33600	1	12180775	12182363	1588	+	644
AT1G33607	1	12187017	12187423	406	-	2
AT1G33610	1	12188909	12190418	1509	+	57
AT1G33612	1	12191311	12192849	1538	+	19
AT1G33615	1	12193324	12194374	1050	-	32
AT1G33640	1	12195721	12195970	249	-	4
AT1G33660	1	12197700	12198322	622	-	7
AT1G33670	1	12201962	12203408	1446	+	0
AT1G33680	1	12203944	12208698	4754	+	983
AT1G33700	1	12208307	12214182	5875	-	180
AT1G33709	1	12219370	12219502	132	-	0
AT1G33710	1	12219656	12220289	633	+	0
AT1G33720	1	12220896	12224000	3104	-	301
AT1G33730	1	12227278	12228460	1182	+	1
AT1G33740	1	12230179	12230430	251	-	1
AT1G33743	1	12231683	12232532	849	+	0
AT1G33750	1	12233768	12236476	2708	+	0
AT1G33760	1	12237877	12238598	721	+	3
AT1G33770	1	12242125	12244462	2337	+	45
AT1G33780	1	12244584	12246188	1604	-	1049
AT1G33785	1	12255359	12256256	897	-	0
AT1G33790	1	12256663	12260605	3942	+	70
AT1G33800	1	12261418	12262717	1299	+	49
AT1G33810	1	12265032	12266847	1815	+	1304
AT1G33811	1	12267865	12269913	2048	+	1058
AT1G33813	1	12273242	12274646	1404	-	0
AT1G33817	1	12274981	12276763	1782	-	0
AT1G33820	1	12278437	12279451	1014	-	0
AT1G33830	1	12279946	12281406	1460	-	0
AT1G33835	1	12281846	12282297	451	+	0
AT1G33840	1	12283861	12285306	1445	-	1
AT1G33850	1	12287912	12288210	298	-	0
AT1G33855	1	12291257	12292501	1244	+	0
AT1G33860	1	12294393	12295305	912	+	0
AT1G33870	1	12301324	12302467	1143	-	0
AT1G33880	1	12303861	12304911	1050	-	0
AT1G33890	1	12308283	12309686	1403	-	0
AT1G33900	1	12311517	12313518	2001	-	0
AT1G33910	1	12314903	12316258	1355	+	0
AT1G33920	1	12319904	12320870	966	+	0
AT1G33925	1	12322573	12322753	180	+	0
AT1G33930	1	12323887	12327084	3197	+	33
AT1G33940	1	12330575	12332785	2210	-	0
AT1G33950	1	12333045	12339182	6137	-	4
AT1G33960	1	12346231	12348513	2282	+	107
AT1G33970	1	12349459	12351246	1787	-	719
AT1G33980	1	12351592	12355023	3431	+	860
AT1G33990	1	12355567	12358031	2464	+	1315
AT1G34000	1	12357909	12358966	1057	-	5403
AT1G34010	1	12359535	12361189	1654	-	303
AT1G34020	1	12366853	12369178	2325	+	351
AT1G34030	1	12370064	12371553	1489	-	1889
AT1G34040	1	12374432	12376179	1747	+	10
AT1G34041	1	12378032	12378188	156	+	0
AT1G34042	1	12379426	12379687	261	-	0
AT1G34044	1	12386218	12387342	1124	+	8
AT1G34046	1	12388594	12389447	853	+	0
AT1G34047	1	12390237	12390915	678	-	0
AT1G34050	1	12393494	12396006	2512	+	0
AT1G34060	1	12396419	12398369	1950	-	154
AT1G34065	1	12398434	12401036	2602	-	112
AT1G34070	1	12402282	12403209	927	+	0
AT1G34080	1	12403276	12406628	3352	-	0
AT1G34090	1	12407267	12409879	2612	+	0
AT1G34095	1	12411669	12412514	845	-	7
AT1G34097	1	12412781	12415386	2605	+	0
AT1G34100	1	12415543	12417172	1629	+	12
AT1G34110	1	12417175	12421523	4348	-	409
AT1G34120	1	12426777	12429710	2933	+	193
AT1G34130	1	12429889	12433187	3298	+	1085
AT1G34140	1	12433355	12434735	1380	-	0
AT1G34150	1	12435953	12439499	3546	+	205
AT1G34160	1	12441392	12443256	1864	+	32
AT1G34170	1	12443546	12446764	3218	-	0
AT1G34180	1	12448566	12451287	2721	+	5
AT1G34190	1	12451450	12454142	2692	+	1012
AT1G34200	1	12455707	12457412	1705	+	219
AT1G34210	1	12458669	12462905	4236	+	844
AT1G34220	1	12462848	12466089	3241	-	851
AT1G34230	1	12466961	12467841	880	-	0
AT1G34240	1	12470417	12471252	835	+	0
AT1G34245	1	12472867	12473754	887	+	69
AT1G34250	1	12483163	12483634	471	-	0
AT1G34260	1	12485966	12492169	6203	+	533
AT1G34270	1	12492410	12494544	2134	-	186
AT1G34280	1	12495141	12495381	240	-	0
AT1G34281	1	12495725	12496038	313	-	0
AT1G34290	1	12497999	12498800	801	+	0
AT1G34300	1	12503405	12506048	2643	+	337
AT1G34310	1	12508547	12511520	2973	-	0
AT1G34315	1	12514105	12516521	2416	-	51
AT1G34320	1	12520178	12524370	4192	+	1083
AT1G34330	1	12528094	12529132	1038	+	0
AT1G34340	1	12530826	12534162	3336	+	654
AT1G34350	1	12534425	12536095	1670	+	196
AT1G34355	1	12536496	12541891	5395	+	126
AT1G34360	1	12542862	12546172	3310	+	162
AT1G34370	1	12550445	12552699	2254	+	730
AT1G34380	1	12552654	12554358	1704	-	145
AT1G34390	1	12556004	12559082	3078	+	0
AT1G34392	1	12560459	12561315	856	-	0
AT1G34400	1	12565991	12566615	624	-	0
AT1G34405	1	12570840	12572126	1286	-	0
AT1G34410	1	12577721	12580824	3103	+	0
AT1G34418	1	12582121	12582721	600	+	403
AT1G34419	1	12583038	12583206	168	-	0
AT1G34420	1	12584586	12587570	2984	+	66
AT1G34430	1	12587751	12590192	2441	-	2521
AT1G34440	1	12591347	12592737	1390	-	0
AT1G34460	1	12595109	12599628	4519	+	18
AT1G34470	1	12604299	12607033	2734	+	290
AT1G34480	1	12607275	12609084	1809	+	5
AT1G34490	1	12609481	12610495	1014	+	0
AT1G34500	1	12611637	12612663	1026	+	0
AT1G34510	1	12615732	12617032	1300	-	0
AT1G34520	1	12623476	12624487	1011	+	0
AT1G34530	1	12627874	12630008	2134	+	0
AT1G34540	1	12637053	12638550	1497	+	0
AT1G34545	1	12641080	12642418	1338	-	0
AT1G34550	1	12646695	12652646	5951	-	703
AT1G34560	1	12653960	12654677	717	+	0
AT1G34570	1	12654939	12656486	1547	-	542
AT1G34575	1	12657148	12658732	1584	-	0
AT1G34580	1	12660550	12663870	3320	+	78
AT1G34590	1	12665166	12667818	2652	+	0
AT1G34600	1	12668424	12673094	4670	-	0
AT1G34610	1	12675583	12679303	3720	+	0
AT1G34620	1	12680937	12684547	3610	-	0
AT1G34630	1	12685199	12687641	2442	+	220
AT1G34640	1	12687551	12688543	992	-	187
AT1G34650	1	12692994	12697834	4840	+	0
AT1G34660	1	12699871	12701377	1506	+	0
AT1G34670	1	12709127	12710423	1296	+	6
AT1G34680	1	12711180	12711455	275	+	0
AT1G34690	1	12713189	12713570	381	+	0
AT1G34700	1	12714208	12717181	2973	+	0
AT1G34710	1	12717729	12718678	949	+	0
AT1G34720	1	12719356	12719887	531	-	0
AT1G34730	1	12720885	12721377	492	-	0
AT1G34740	1	12722223	12728189	5966	-	0
AT1G34750	1	12736091	12738196	2105	-	270
AT1G34760	1	12743820	12745648	1828	-	286
AT1G34770	1	12746485	12748614	2129	+	102
AT1G34780	1	12748570	12750383	1813	-	624
AT1G34790	1	12763901	12765638	1737	+	0
AT1G34792	1	12766262	12766651	389	-	0
AT1G34795	1	12769643	12770131	488	-	0
AT1G34797	1	12771927	12772219	292	+	0
AT1G34800	1	12773163	12773442	279	-	0
AT1G34803	1	12775341	12775633	292	+	0
AT1G34805	1	12776577	12776856	279	-	0
AT1G34808	1	12778755	12779047	292	+	0
AT1G34810	1	12779991	12780270	279	-	0
AT1G34813	1	12782170	12782462	292	+	0
AT1G34815	1	12783405	12783684	279	-	0
AT1G34818	1	12785580	12785872	292	+	0
AT1G34820	1	12786816	12787095	279	-	0
AT1G34823	1	12788994	12789286	292	+	0
AT1G34825	1	12790121	12790605	484	-	0
AT1G34828	1	12792408	12792700	292	+	0
AT1G34830	1	12793535	12794023	488	-	0
AT1G34836	1	12795823	12796115	292	+	0
AT1G34840	1	12796983	12797247	264	-	0
AT1G34842	1	12751189	12752376	1187	-	0
AT1G34844	1	12751267	12752617	1350	+	20
AT1G34850	1	12800307	12800571	264	-	0
AT1G34860	1	12803707	12803986	279	-	0
AT1G34904	1	12753486	12754922	1436	+	0
AT1G34910	1	12804833	12805334	501	+	0
AT1G34930	1	12807120	12807399	279	-	0
AT1G34967	1	12755619	12759846	4227	+	0
AT1G35030	1	12808245	12809481	1236	+	0
AT1G35035	1	12811029	12811308	279	-	0
AT1G35040	1	12812156	12812569	413	+	0
AT1G35050	1	12814080	12816016	1936	+	0
AT1G35060	1	12820033	12822787	2754	+	0
AT1G35080	1	12826124	12828202	2078	-	0
AT1G35090	1	12828872	12829881	1009	-	0
AT1G35100	1	12830551	12831339	788	+	0
AT1G35110	1	12833397	12840997	7600	-	0
AT1G35112	1	12840227	12841118	891	-	48
AT1G35115	1	12842157	12845455	3298	+	668
AT1G35120	1	12846096	12846425	329	-	0
AT1G35130	1	12848821	12849507	686	+	0
AT1G35140	1	12851996	12853128	1132	+	17
AT1G35143	1	12855007	12855133	126	-	1
AT1G35146	1	12856197	12860244	4047	-	0
AT1G35150	1	12864157	12866238	2081	-	0
AT1G35160	1	12867125	12868890	1765	+	1706
AT1G35170	1	12870737	12872194	1457	-	0
AT1G35180	1	12877106	12878719	1613	-	86
AT1G35181	1	12879305	12879470	165	+	0
AT1G35183	1	12884437	12884590	153	+	3
AT1G35186	1	12885605	12886983	1378	-	0
AT1G35190	1	12890422	12892874	2452	+	245
AT1G35200	1	12893338	12893747	409	-	2
AT1G35210	1	12896651	12897402	751	-	16
AT1G35220	1	12908913	12914802	5889	+	441
AT1G35230	1	12917148	12917763	615	+	46
AT1G35240	1	12927456	12930523	3067	-	0
AT1G35242	1	12931243	12931396	153	+	0
AT1G35250	1	12932940	12934479	1539	-	0
AT1G35255	1	12935646	12936553	907	-	0
AT1G35260	1	12936848	12937787	939	-	16
AT1G35270	1	12939578	12941565	1987	-	0
AT1G35280	1	12944136	12946494	2358	+	0
AT1G35290	1	12947543	12948841	1298	-	22
AT1G35300	1	12950375	12952882	2507	+	0
AT1G35310	1	12956158	12957090	932	-	36
AT1G35320	1	12959056	12962853	3797	-	89
AT1G35330	1	12965045	12966113	1068	+	1
AT1G35333	1	12970270	12970420	150	+	0
AT1G35340	1	12977667	12979910	2243	+	1737
AT1G35350	1	12981250	12984583	3333	-	334
AT1G35360	1	12990112	12990867	755	+	0
AT1G35365	1	12991391	12992145	754	+	0
AT1G35370	1	13000585	13005078	4493	+	2
AT1G35375	1	13005672	13006187	515	-	0
AT1G35380	1	13006355	13007926	1571	-	0
AT1G35390	1	13008910	13014607	5697	+	0
AT1G35400	1	13018288	13019198	910	+	0
AT1G35405	1	13019298	13023624	4326	-	2
AT1G35410	1	13024160	13024941	781	+	0
AT1G35420	1	13026237	13027684	1447	+	1728
AT1G35430	1	13030552	13031152	600	-	115
AT1G35435	1	13032805	13033247	442	-	0
AT1G35440	1	13035293	13036037	744	-	0
AT1G35450	1	13037409	13038752	1343	-	0
AT1G35460	1	13039915	13042102	2187	+	418
AT1G35461	1	13043488	13043629	141	+	0
AT1G35465	1	13046926	13047661	735	+	0
AT1G35467	1	13049163	13049433	270	+	0
AT1G35470	1	13051409	13055014	3605	-	479
AT1G35480	1	13055397	13056364	967	-	0
AT1G35490	1	13061637	13063450	1813	+	0
AT1G35500	1	13066086	13066596	510	+	0
AT1G35501	1	13067250	13067335	85	+	0
AT1G35510	1	13071164	13074949	3785	+	723
AT1G35513	1	13076844	13077489	645	+	17
AT1G35515	1	13077925	13080265	2340	+	18
AT1G35516	1	13078617	13079773	1156	+	936
AT1G35520	1	13082818	13085830	3012	-	0
AT1G35530	1	13089868	13097078	7210	+	80
AT1G35535	1	13098265	13102245	3980	+	0
AT1G35537	1	13105205	13105570	365	-	0
AT1G35540	1	13108633	13111700	3067	+	0
AT1G35545	1	13110516	13112832	2316	-	0
AT1G35550	1	13112505	13113136	631	+	0
AT1G35560	1	13115825	13117235	1410	-	528
AT1G35570	1	13119618	13120439	821	-	0
AT1G35580	1	13122203	13125264	3061	-	1221
AT1G35590	1	13131934	13135837	3903	+	0
AT1G35600	1	13136558	13139252	2694	+	0
AT1G35610	1	13143149	13144988	1839	-	1
AT1G35612	1	13145642	13146693	1051	+	457
AT1G35614	1	13148591	13149559	968	+	0
AT1G35617	1	13153582	13153948	366	+	0
AT1G35620	1	13156367	13158467	2100	+	924
AT1G35625	1	13158465	13160245	1780	-	0
AT1G35630	1	13162965	13164512	1547	-	0
AT1G35640	1	13174551	13175390	839	+	0
AT1G35645	1	13175797	13177747	1950	+	0
AT1G35647	1	13181477	13186236	4759	-	0
AT1G35650	1	13187284	13191749	4465	-	0
AT1G35660	1	13192742	13197976	5234	+	234
AT1G35663	1	13199231	13199771	540	-	0
AT1G35670	1	13205380	13208252	2872	+	459
AT1G35680	1	13208735	13210418	1683	+	8835
AT1G35690	1	13214129	13215116	987	+	0
AT1G35700	1	13216615	13217251	636	+	0
AT1G35710	1	13220939	13224681	3742	+	1851
AT1G35720	1	13225196	13227195	1999	+	3612
AT1G35730	1	13227323	13229796	2473	-	3
AT1G35735	1	13231090	13235530	4440	-	1
AT1G35740	1	13242544	13244065	1521	+	0
AT1G35745	1	13248053	13249824	1771	-	0
AT1G35750	1	13253397	13255570	2173	-	0
AT1G35760	1	13264306	13268116	3810	+	0
AT1G35770	1	13269565	13275678	6113	-	0
AT1G35780	1	13277273	13280289	3016	-	445
AT1G35790	1	13295189	13300109	4920	-	0
AT1G35820	1	13308118	13309257	1139	-	0
AT1G35830	1	13321213	13322122	909	-	26
AT1G35840	1	13324969	13329493	4524	+	0
AT1G35850	1	13330509	13331506	997	+	0
AT1G35860	1	13332046	13334050	2004	-	0
AT1G35870	1	13335256	13339587	4331	+	0
AT1G35880	1	13339850	13341228	1378	-	0
AT1G35890	1	13341299	13341953	654	+	0
AT1G35900	1	13347503	13348433	930	-	0
AT1G35910	1	13363002	13365060	2058	-	29
AT1G35920	1	13372520	13375053	2533	+	0
AT1G35930	1	13375847	13377170	1323	+	0
AT1G35940	1	13377799	13383951	6152	+	0
AT1G35950	1	13384660	13385740	1080	+	0
AT1G35960	1	13390828	13396127	5299	-	0
AT1G35970	1	13397663	13403558	5895	+	0
AT1G35980	1	13406229	13407328	1099	-	0
AT1G35990	1	13409751	13415069	5318	-	0
AT1G35995	1	13418826	13421119	2293	-	0
AT1G36000	1	13422553	13423028	475	+	0
AT1G36010	1	13426454	13430084	3630	+	0
AT1G36020	1	13433918	13434340	422	-	0
AT1G36030	1	13436585	13436828	243	+	0
AT1G36035	1	13440075	13445130	5055	+	0
AT1G36040	1	13446061	13447625	1564	+	0
AT1G36050	1	13450203	13453683	3480	+	573
AT1G36060	1	13454495	13456331	1836	-	9
AT1G36070	1	13466910	13470936	4026	-	267
AT1G36078	1	13481664	13482785	1121	-	0
AT1G36080	1	13483142	13485572	2430	+	0
AT1G36090	1	13487656	13489700	2044	-	0
AT1G36095	1	13491369	13492725	1356	-	0
AT1G36100	1	13494651	13495215	564	+	0
AT1G36105	1	13499041	13500993	1952	+	0
AT1G36110	1	13503911	13506396	2485	-	0
AT1G36120	1	13509836	13514564	4728	-	0
AT1G36130	1	13516324	13520545	4221	-	0
AT1G36140	1	13524939	13527049	2110	-	0
AT1G36150	1	13528256	13529470	1214	+	0
AT1G36160	1	13533410	13544009	10599	+	4388
AT1G36180	1	13545964	13558492	12528	+	402
AT1G36185	1	13560123	13564586	4463	+	0
AT1G36190	1	13574381	13576085	1704	-	0
AT1G36200	1	13577454	13580996	3542	-	0
AT1G36210	1	13594513	13597863	3350	+	0
AT1G36220	1	13601055	13601579	524	-	0
AT1G36225	1	13606639	13607930	1291	+	0
AT1G36230	1	13610984	13614051	3067	-	0
AT1G36240	1	13614889	13616233	1344	+	0
AT1G36250	1	13617738	13623656	5918	+	0
AT1G36260	1	13625929	13628052	2123	-	0
AT1G36270	1	13628847	13633367	4520	-	0
AT1G36272	1	13635335	13635521	186	-	0
AT1G36280	1	13640507	13643126	2619	+	350
AT1G36290	1	13643130	13644547	1417	-	0
AT1G36300	1	13647772	13652173	4401	-	0
AT1G36305	1	13660679	13665533	4854	+	0
AT1G36310	1	13669440	13671156	1716	+	518
AT1G36320	1	13671813	13674098	2285	+	2481
AT1G36330	1	13677205	13680593	3388	-	0
AT1G36340	1	13683662	13684952	1290	-	0
AT1G36350	1	13686425	13686498	73	+	0
AT1G36360	1	13689533	13695235	5702	+	0
AT1G36370	1	13696041	13698639	2598	-	555
AT1G36380	1	13700813	13701632	819	+	119
AT1G36390	1	13701400	13703572	2172	-	1202
AT1G36395	1	13707879	13708633	754	+	0
AT1G36400	1	13711162	13711683	521	+	0
AT1G36403	1	13713117	13713789	672	-	0
AT1G36406	1	13715002	13715997	995	-	0
AT1G36420	1	13720794	13721659	865	+	0
AT1G36430	1	13722743	13724425	1682	+	0
AT1G36440	1	13725801	13727976	2175	+	0
AT1G36441	1	13728577	13729561	984	-	0
AT1G36445	1	13730183	13731569	1386	+	0
AT1G36450	1	13732951	13734576	1625	+	0
AT1G36460	1	13735497	13737957	2460	-	0
AT1G36470	1	13738828	13742675	3847	-	0
AT1G36480	1	13743573	13745382	1809	+	0
AT1G36485	1	13746697	13748098	1401	+	0
AT1G36490	1	13751348	13753857	2509	+	0
AT1G36495	1	13754936	13756247	1311	+	0
AT1G36500	1	13757369	13758805	1436	+	0
AT1G36510	1	13761925	13764265	2340	+	0
AT1G36520	1	13768836	13774806	5970	+	0
AT1G36530	1	13782101	13784776	2675	-	0
AT1G36540	1	13788722	13792563	3841	+	0
AT1G36550	1	13795530	13797285	1755	+	0
AT1G36560	1	13799885	13801807	1922	-	0
AT1G36570	1	13803928	13806745	2817	+	0
AT1G36580	1	13816458	13818556	2098	-	1
AT1G36590	1	13818975	13823475	4500	+	0
AT1G36595	1	13824801	13825075	274	-	0
AT1G36600	1	13825465	13827399	1934	-	0
AT1G36605	1	13828268	13828477	209	-	0
AT1G36610	1	13828492	13831555	3063	+	1
AT1G36620	1	13832105	13835564	3459	-	0
AT1G36622	1	13836130	13836954	824	-	9
AT1G36630	1	13840144	13847625	7481	-	0
AT1G36640	1	13853170	13853687	517	-	0
AT1G36650	1	13854498	13855674	1176	-	0
AT1G36660	1	13861469	13862969	1500	-	0
AT1G36670	1	13864234	13865336	1102	-	0
AT1G36675	1	13867567	13869490	1923	+	3
AT1G36680	1	13871079	13872202	1123	+	1
AT1G36690	1	13873687	13875764	2077	-	0
AT1G36700	1	13877989	13878553	564	-	0
AT1G36710	1	13880248	13881542	1294	+	0
AT1G36720	1	13884482	13888886	4404	+	0
AT1G36730	1	13898209	13900831	2622	-	0
AT1G36732	1	13898209	13900831	2622	-	0
AT1G36740	1	13908905	13910793	1888	-	0
AT1G36745	1	13911136	13911679	543	+	0
AT1G36750	1	13913604	13914682	1078	+	0
AT1G36756	1	13917330	13917816	486	+	0
AT1G36763	1	13921109	13921504	395	-	0
AT1G36770	1	13921667	13925773	4106	+	1
AT1G36775	1	13930100	13932323	2223	+	0
AT1G36790	1	13936158	13938917	2759	+	0
AT1G36795	1	13942798	13945667	2869	-	0
AT1G36800	1	13948346	13950729	2383	-	0
AT1G36810	1	13950802	13953811	3009	+	0
AT1G36830	1	13954826	13955600	774	-	0
AT1G36840	1	13955621	13958831	3210	+	0
AT1G36850	1	13959389	13961285	1896	-	0
AT1G36880	1	13961889	13963772	1883	-	0
AT1G36890	1	13967606	13971416	3810	-	0
AT1G36910	1	13974516	13975976	1460	-	0
AT1G36915	1	13977808	13979110	1302	-	0
AT1G36920	1	13983511	13984424	913	+	1
AT1G36922	1	13984575	13985290	715	+	0
AT1G36925	1	13986435	13987289	854	+	0
AT1G36927	1	13991778	13993095	1317	-	0
AT1G36933	1	13993195	13994997	1802	-	0
AT1G36936	1	13996758	13997730	972	-	0
AT1G36940	1	14003865	14005502	1637	+	37
AT1G36942	1	14006146	14006341	195	-	0
AT1G36950	1	14009672	14010822	1150	-	2
AT1G36960	1	14014795	14015508	713	+	0
AT1G36970	1	14016384	14018356	1972	-	0
AT1G36975	1	14019940	14024331	4391	+	0
AT1G36980	1	14025027	14026941	1914	+	1009
AT1G36990	1	14027291	14030500	3209	-	426
AT1G36992	1	14029922	14030768	846	+	0
AT1G37000	1	14036037	14037145	1108	+	0
AT1G37007	1	14039861	14040020	159	-	0
AT1G37010	1	14040917	14041227	310	+	0
AT1G37012	1	14042709	14043727	1018	-	0
AT1G37015	1	14044014	14044859	845	+	0
AT1G37020	1	14046734	14049742	3008	+	0
AT1G37030	1	14050454	14056318	5864	+	0
AT1G37035	1	14056480	14058908	2428	-	0
AT1G37036	1	14060524	14061004	480	-	0
AT1G37037	1	14066919	14067409	490	-	0
AT1G37038	1	14069501	14070837	1336	+	0
AT1G37040	1	14071387	14076253	4866	+	0
AT1G37045	1	14079030	14079707	677	-	0
AT1G37050	1	14079840	14083072	3232	+	0
AT1G37057	1	14094305	14097437	3132	+	0
AT1G37060	1	14084521	14090143	5622	+	0
AT1G37063	1	14101592	14102348	756	-	0
AT1G37070	1	14103156	14105790	2634	-	0
AT1G37080	1	14111457	14112255	798	-	0
AT1G37090	1	14114788	14116885	2097	-	0
AT1G37095	1	14120422	14121025	603	+	0
AT1G37100	1	14124805	14128188	3383	-	0
AT1G37110	1	14130251	14134322	4071	-	0
AT1G37113	1	14136412	14138245	1833	+	0
AT1G37120	1	14143805	14146001	2196	-	0
AT1G37130	1	14158526	14161938	3412	+	15215
AT1G37140	1	14170350	14172041	1691	-	0
AT1G37150	1	14174980	14177992	3012	-	16
AT1G37160	1	14181395	14183264	1869	-	0
AT1G37162	1	14184748	14184853	105	-	0
AT1G37170	1	14188823	14190995	2172	+	0
AT1G37180	1	14193584	14194819	1235	-	0
AT1G37190	1	14197637	14200137	2500	+	0
AT1G37200	1	14201053	14206371	5318	-	0
AT1G37210	1	14208781	14211487	2706	+	0
AT1G37275	1	14213198	14213730	532	+	0
AT1G37340	1	14218096	14223712	5616	-	0
AT1G37405	1	14226803	14232764	5961	+	0
AT1G37471	1	14234556	14237169	2613	+	0
AT1G37537	1	14241086	14242190	1104	+	0
AT1G37603	1	14243164	14245015	1851	+	0
AT1G37669	1	14248947	14251512	2565	+	0
AT1G37735	1	14257070	14260655	3585	-	0
AT1G37801	1	14262830	14263586	756	+	0
AT1G37867	1	14266730	14272193	5463	-	0
AT1G37933	1	14273364	14276511	3147	-	0
AT1G37999	1	14278110	14282034	3924	-	0
AT1G38065	1	14289577	14292060	2483	-	0
AT1G38131	1	14293063	14296191	3128	-	240
AT1G38140	1	14300841	14302929	2088	+	0
AT1G38149	1	14313048	14315934	2886	+	0
AT1G38158	1	14316987	14319492	2505	+	0
AT1G38167	1	14320219	14323789	3570	+	0
AT1G38176	1	14324215	14325619	1404	+	0
AT1G38185	1	14334139	14338177	4038	+	0
AT1G38194	1	14339342	14340227	885	+	0
AT1G38203	1	14343492	14344380	888	+	0
AT1G38212	1	14344570	14347153	2583	+	1
AT1G38221	1	14350649	14353298	2649	+	0
AT1G38230	1	14357005	14361028	4023	-	0
AT1G38240	1	14368340	14369630	1290	+	0
AT1G38250	1	14370225	14372238	2013	+	0
AT1G38260	1	14375705	14379741	4036	-	0
AT1G38270	1	14386829	14389799	2970	+	0
AT1G38280	1	14390722	14392546	1824	+	0
AT1G38290	1	14396302	14398681	2379	+	0
AT1G38300	1	14403153	14406576	3423	-	0
AT1G38310	1	14413974	14415294	1320	+	0
AT1G38320	1	14415951	14417511	1560	+	0
AT1G38330	1	14421358	14425394	4036	-	0
AT1G38340	1	14430746	14432225	1479	+	0
AT1G38350	1	14434172	14436840	2668	+	0
AT1G38360	1	14437602	14445999	8397	+	0
AT1G38380	1	14446399	14447996	1597	+	0
AT1G38390	1	14449810	14450341	531	+	0
AT1G38400	1	14453711	14456432	2721	+	0
AT1G38410	1	14457605	14458805	1200	+	0
AT1G38416	1	14462413	14463247	834	+	0
AT1G38423	1	14467815	14471421	3606	-	0
AT1G38430	1	14478901	14482448	3547	-	0
AT1G38440	1	14487342	14488365	1023	+	0
AT1G38450	1	14492061	14495814	3753	+	0
AT1G38460	1	14501392	14505229	3837	+	0
AT1G38550	1	14506539	14507184	645	+	0
AT1G38630	1	14510883	14511342	459	-	0
AT1G38710	1	14538738	14542790	4052	-	0
AT1G38790	1	14543276	14544528	1252	-	0
AT1G38870	1	14581870	14584396	2526	-	0
AT1G38950	1	14587851	14588419	568	+	0
AT1G39030	1	14588590	14590038	1448	-	0
AT1G39110	1	14591054	14593550	2496	-	0
AT1G39190	1	14594406	14598190	3784	-	0
AT1G39270	1	14598689	14604275	5586	-	4
AT1G39350	1	14607832	14608653	821	-	0
AT1G39430	1	14656852	14657326	474	-	0
AT1G39510	1	14662281	14664117	1836	-	0
AT1G39511	1	14664798	14667705	2907	-	0
AT1G39513	1	14715461	14717297	1836	+	0
AT1G39515	1	14747210	14749046	1836	-	0
AT1G39590	1	14807799	14813997	6198	+	0
AT1G39670	1	14817509	14819595	2086	+	0
AT1G39750	1	14825235	14825643	408	-	0
AT1G39830	1	14840743	14846755	6012	-	0
AT1G39910	1	14849634	14852390	2756	+	0
AT1G39990	1	14853295	14855175	1880	+	0
AT1G40069	1	14860339	14860514	175	+	0
AT1G40070	1	14857704	14859910	2206	-	0
AT1G40071	1	14864165	14864927	762	+	0
AT1G40072	1	14867446	14869477	2031	-	0
AT1G40073	1	14870409	14873234	2825	-	0
AT1G40074	1	14876078	14882030	5952	+	0
AT1G40075	1	14892435	14896886	4451	-	0
AT1G40076	1	15422186	15422672	486	+	0
AT1G40077	1	14899837	14906596	6759	-	0
AT1G40078	1	14912939	14915024	2085	+	0
AT1G40079	1	14915763	14916351	588	+	0
AT1G40080	1	14917167	14917632	465	-	0
AT1G40081	1	14918652	14919588	936	+	0
AT1G40083	1	14922422	14923055	633	-	0
AT1G40084	1	14924034	14924676	642	+	0
AT1G40085	1	14925851	14926970	1119	+	0
AT1G40087	1	14999614	15001868	2254	-	0
AT1G40089	1	15003025	15004333	1308	-	0
AT1G40091	1	15005206	15008662	3456	-	0
AT1G40093	1	15038152	15041098	2946	-	0
AT1G40095	1	15044572	15050812	6240	-	0
AT1G40097	1	15053798	15056507	2709	+	0
AT1G40099	1	15057068	15058112	1044	+	0
AT1G40100	1	15410100	15411111	1011	+	0
AT1G40101	1	15063542	15076496	12954	-	1
AT1G40103	1	15078533	15081356	2823	-	0
AT1G40104	1	15081951	15085893	3942	+	0
AT1G40105	1	15139932	15142292	2360	+	0
AT1G40106	1	15402419	15404846	2427	-	0
AT1G40107	1	15151215	15154824	3609	+	0
AT1G40109	1	15155044	15158202	3158	+	0
AT1G40112	1	15398666	15402377	3711	+	0
AT1G40113	1	15160609	15166681	6072	+	0
AT1G40115	1	15179140	15179593	453	+	0
AT1G40117	1	15180907	15186517	5610	+	0
AT1G40118	1	15392513	15394091	1578	+	0
AT1G40119	1	15187718	15189614	1896	+	0
AT1G40121	1	15190971	15191991	1020	+	0
AT1G40123	1	15209958	15213729	3771	+	0
AT1G40124	1	15390383	15392123	1740	+	0
AT1G40125	1	15214279	15215365	1086	+	0
AT1G40127	1	15215965	15221264	5299	-	0
AT1G40129	1	15240552	15244036	3484	+	0
AT1G40130	1	15384547	15387010	2463	-	0
AT1G40131	1	15281235	15285925	4690	+	0
AT1G40133	1	15286439	15288755	2316	-	0
AT1G40135	1	15292280	15296006	3726	+	0
AT1G40136	1	15378554	15384011	5457	+	0
AT1G40137	1	15300584	15304478	3894	+	0
AT1G40139	1	15304580	15306764	2184	-	0
AT1G40141	1	15312018	15313131	1113	+	0
AT1G40143	1	15313131	15316914	3783	-	0
AT1G40150	1	15412719	15414517	1798	+	0
AT1G40230	1	15414894	15415806	912	+	0
AT1G40310	1	15415947	15417870	1923	+	0
AT1G40390	1	15432575	15434674	2099	-	0
AT1G40470	1	15438169	15441167	2998	+	0
AT1G40630	1	15448705	15452414	3709	-	0
AT1G41115	1	15457544	15460358	2814	+	0
AT1G41600	1	15464484	15467298	2814	+	0
AT1G41630	1	15471423	15474237	2814	+	0
AT1G41650	1	15476464	15477001	537	+	0
AT1G41660	1	15478364	15481172	2808	+	0
AT1G41680	1	15482851	15484057	1206	+	0
AT1G41690	1	15485349	15486558	1209	+	0
AT1G41700	1	15488096	15491832	3736	-	0
AT1G41710	1	15493687	15499345	5658	+	0
AT1G41720	1	15500527	15502597	2070	+	0
AT1G41723	1	15491952	15492534	582	+	0
AT1G41726	1	15503359	15503986	627	+	0
AT1G41730	1	15504917	15507474	2557	-	0
AT1G41740	1	15508896	15512095	3199	-	0
AT1G41743	1	15514267	15517653	3386	-	0
AT1G41746	1	15518697	15521174	2477	-	0
AT1G41750	1	15522010	15522436	426	-	0
AT1G41755	1	15526430	15530110	3680	+	0
AT1G41760	1	15530419	15530963	544	-	0
AT1G41770	1	15537220	15537532	312	+	0
AT1G41775	1	15539175	15544377	5202	-	0
AT1G41790	1	15547316	15550186	2870	+	0
AT1G41795	1	15554516	15557528	3012	-	0
AT1G41797	1	15560038	15563509	3471	-	4
AT1G41798	1	15567002	15567812	810	-	0
AT1G41803	1	15570513	15578278	7765	+	0
AT1G41810	1	15579816	15580557	741	-	0
AT1G41820	1	15582422	15585143	2721	-	0
AT1G41825	1	15590928	15594141	3213	+	0
AT1G41827	1	15596074	15596434	360	+	0
AT1G41830	1	15603616	15607966	4350	-	2615
AT1G41835	1	15610590	15615111	4521	-	0
AT1G41840	1	15617321	15622910	5589	-	0
AT1G41850	1	15626401	15630507	4106	+	0
AT1G41855	1	15637604	15639738	2134	+	0
AT1G41860	1	15640155	15640794	639	+	0
AT1G41870	1	15647490	15649051	1561	+	0
AT1G41875	1	15650171	15650405	234	+	0
AT1G41880	1	15651026	15652542	1516	-	1873
AT1G41890	1	15652634	15656463	3829	-	1
AT1G41893	1	15657491	15660261	2770	+	0
AT1G41896	1	15665039	15669938	4899	+	0
AT1G41900	1	15670937	15673358	2421	-	0
AT1G41910	1	15677552	15680073	2521	+	0
AT1G41920	1	15680977	15684487	3510	-	0
AT1G41930	1	15685410	15695693	10283	+	0
AT1G42003	1	15703231	15703863	632	-	0
AT1G42040	1	15705081	15705651	570	-	1
AT1G42045	1	15698373	15699976	1603	+	0
AT1G42050	1	15707076	15710285	3209	-	3
AT1G42060	1	15710484	15713211	2727	-	0
AT1G42070	1	15714407	15715882	1475	-	0
AT1G42080	1	15716713	15717169	456	-	0
AT1G42090	1	15720082	15720696	614	-	4
AT1G42100	1	15721694	15724485	2791	+	0
AT1G42110	1	15725297	15727434	2137	+	0
AT1G42120	1	15730614	15730686	72	-	0
AT1G42130	1	15733168	15735656	2488	+	0
AT1G42140	1	15736520	15741101	4581	-	3
AT1G42150	1	15742398	15746446	4048	+	0
AT1G42160	1	15751579	15753070	1491	+	0
AT1G42170	1	15755673	15757335	1662	+	0
AT1G42180	1	15758771	15759280	509	-	0
AT1G42190	1	15761081	15761276	195	+	0
AT1G42200	1	15761927	15763310	1383	-	0
AT1G42210	1	15765946	15766943	997	-	0
AT1G42220	1	15768327	15769506	1179	-	0
AT1G42230	1	15770770	15771103	333	+	0
AT1G42240	1	15773498	15775778	2280	+	0
AT1G42250	1	15776844	15777526	682	+	0
AT1G42260	1	15778351	15779505	1154	+	0
AT1G42270	1	15780469	15781736	1267	+	0
AT1G42280	1	15784116	15784486	370	+	0
AT1G42290	1	15786431	15789561	3130	+	0
AT1G42300	1	15790726	15791778	1052	-	0
AT1G42310	1	15797908	15799506	1598	-	0
AT1G42320	1	15800928	15805502	4574	+	0
AT1G42350	1	15813843	15821323	7480	-	11
AT1G42360	1	15824725	15826576	1851	-	0
AT1G42365	1	15827695	15833426	5731	-	0
AT1G42367	1	15834634	15835087	453	-	0
AT1G42370	1	15836928	15838788	1860	-	0
AT1G42375	1	15839907	15845642	5735	-	0
AT1G42377	1	15849232	15851353	2121	-	0
AT1G42380	1	15852692	15854979	2287	-	0
AT1G42385	1	15855844	15856162	318	-	0
AT1G42390	1	15857747	15860849	3102	+	1
AT1G42393	1	15861616	15862273	657	-	0
AT1G42396	1	15862857	15863802	945	-	0
AT1G42400	1	15864605	15865541	936	-	0
AT1G42410	1	15869106	15871453	2347	+	0
AT1G42420	1	15873297	15878184	4887	-	0
AT1G42430	1	15891370	15894444	3074	+	566
AT1G42440	1	15895284	15900055	4771	-	709
AT1G42450	1	15909366	15912626	3260	+	0
AT1G42460	1	15913519	15917485	3966	-	0
AT1G42470	1	15926986	15935208	8222	+	1003
AT1G42480	1	15936206	15938863	2657	+	358
AT1G42490	1	15945876	15946985	1109	-	0
AT1G42500	1	15951374	15953706	2332	-	0
AT1G42510	1	15954730	15958558	3828	-	0
AT1G42515	1	15958626	15959343	717	+	0
AT1G42520	1	15962139	15964392	2253	+	0
AT1G42525	1	15966380	15968239	1859	+	0
AT1G42530	1	15968805	15971112	2307	-	0
AT1G42540	1	15973053	15976703	3650	+	900
AT1G42550	1	15977013	15979952	2939	+	3248
AT1G42560	1	15980134	15983328	3194	-	3
AT1G42570	1	15988783	15990469	1686	+	0
AT1G42580	1	15991695	15992175	480	-	0
AT1G42590	1	15997016	16000380	3364	+	0
AT1G42595	1	16000966	16003487	2521	-	0
AT1G42600	1	16006215	16008693	2478	+	0
AT1G42602	1	16011819	16012506	687	+	0
AT1G42605	1	16014496	16018871	4375	-	0
AT1G42610	1	16020906	16021371	465	+	0
AT1G42620	1	16023255	16024291	1036	-	0
AT1G42630	1	16025297	16025762	465	+	0
AT1G42635	1	16027027	16027570	543	-	0
AT1G42650	1	16028190	16034022	5832	-	0
AT1G42655	1	16035844	16036867	1023	+	0
AT1G42680	1	16041655	16042880	1225	+	0
AT1G42690	1	16043754	16045041	1287	+	0
AT1G42695	1	16046269	16049993	3724	+	0
AT1G42697	1	16056324	16058625	2301	-	0
AT1G42698	1	16059192	16060839	1647	+	0
AT1G42699	1	16051794	16051935	141	+	0
AT1G42700	1	16066930	16067592	662	+	0
AT1G42703	1	16053778	16055767	1989	+	0
AT1G42705	1	16071340	16073512	2172	+	0
AT1G42710	1	16077591	16078567	976	-	0
AT1G42718	1	16081064	16084787	3723	+	0
AT1G42727	1	16085798	16088273	2475	+	0
AT1G42736	1	16090060	16090544	484	+	0
AT1G42740	1	16092684	16093839	1155	-	0
AT1G42745	1	16097269	16099306	2037	-	0
AT1G42780	1	16100289	16102965	2676	-	0
AT1G42816	1	16104713	16105401	688	-	0
AT1G42852	1	16107023	16109446	2423	-	0
AT1G42888	1	16110312	16113421	3109	+	0
AT1G42924	1	16118445	16121623	3178	+	0
AT1G42960	1	16125781	16127288	1507	+	3031
AT1G42970	1	16127380	16129843	2463	+	92107
AT1G42980	1	16133285	16135587	2302	+	3
AT1G42990	1	16135851	16137463	1612	-	453
AT1G43000	1	16140815	16141655	840	+	1
AT1G43005	1	16151094	16152240	1146	+	0
AT1G43010	1	16153608	16154468	860	+	0
AT1G43020	1	16155402	16157911	2509	+	1
AT1G43030	1	16177090	16181460	4370	+	0
AT1G43040	1	16184208	16184523	315	+	0
AT1G43050	1	16185837	16187658	1821	-	0
AT1G43060	1	16189209	16203832	14623	+	15
AT1G43070	1	16208690	16209749	1059	+	0
AT1G43080	1	16213994	16215828	1834	-	0
AT1G43090	1	16217196	16219150	1954	-	0
AT1G43100	1	16220518	16222473	1955	-	0
AT1G43110	1	16223980	16225810	1830	-	0
AT1G43120	1	16227317	16227779	462	-	0
AT1G43130	1	16228207	16231233	3026	-	358
AT1G43140	1	16232784	16236109	3325	+	0
AT1G43145	1	16238524	16240015	1491	+	0
AT1G43150	1	16240476	16244557	4081	+	0
AT1G43160	1	16263812	16264818	1006	+	0
AT1G43170	1	16266640	16268870	2230	+	10835
AT1G43171	1	16269074	16270513	1439	+	0
AT1G43180	1	16271200	16272798	1598	-	8
AT1G43190	1	16275107	16278624	3517	-	1590
AT1G43195	1	16279369	16279882	513	+	0
AT1G43200	1	16282131	16285446	3315	+	0
AT1G43205	1	16285962	16286376	414	-	0
AT1G43210	1	16287982	16290339	2357	-	0
AT1G43220	1	16296359	16297391	1032	+	0
AT1G43230	1	16297944	16298358	414	-	0
AT1G43240	1	16300013	16302277	2264	-	0
AT1G43245	1	16308881	16310930	2049	-	113
AT1G43250	1	16311523	16316838	5315	+	3
AT1G43260	1	16318252	16319234	982	+	0
AT1G43270	1	16319950	16324362	4412	+	0
AT1G43280	1	16330758	16332502	1744	+	0
AT1G43290	1	16333782	16334448	666	-	0
AT1G43300	1	16335699	16338702	3003	-	0
AT1G43310	1	16345973	16346475	502	-	9
AT1G43320	1	16356761	16357118	357	+	0
AT1G43330	1	16359028	16360023	995	+	0
AT1G43387	1	16370493	16374521	4028	-	0
AT1G43415	1	16378973	16379405	432	+	0
AT1G43444	1	16382156	16386291	4135	-	0
AT1G43502	1	16388534	16392796	4262	+	0
AT1G43560	1	16398098	16399878	1780	-	2333
AT1G43570	1	16401869	16402916	1047	-	0
AT1G43575	1	16405709	16406745	1036	-	0
AT1G43580	1	16410531	16412728	2197	-	656
AT1G43590	1	16414120	16414627	507	+	13
AT1G43600	1	16415356	16416022	666	+	0
AT1G43610	1	16424577	16425345	768	+	0
AT1G43620	1	16425411	16430200	4789	-	481
AT1G43624	1	16432841	16432946	105	-	0
AT1G43630	1	16436370	16437755	1385	-	0
AT1G43640	1	16439434	16441844	2410	-	2
AT1G43650	1	16443684	16446886	3202	-	101
AT1G43660	1	16450359	16450644	285	+	0
AT1G43665	1	16452980	16453804	824	-	0
AT1G43666	1	16461071	16461734	663	-	0
AT1G43667	1	16465055	16465565	510	-	0
AT1G43670	1	16468043	16470500	2457	+	10134
AT1G43675	1	16470871	16471248	377	+	56
AT1G43680	1	16472204	16473266	1062	+	0
AT1G43690	1	16478246	16482837	4591	+	1082
AT1G43700	1	16484230	16486241	2011	+	618
AT1G43710	1	16486319	16488384	2065	-	2305
AT1G43715	1	16489027	16491339	2312	-	0
AT1G43720	1	16495079	16496078	999	+	0
AT1G43722	1	16496402	16497377	975	+	0
AT1G43723	1	16498988	16500296	1308	-	0
AT1G43724	1	16501542	16502406	864	-	0
AT1G43725	1	16503435	16507468	4033	+	0
AT1G43730	1	16508722	16509784	1062	-	0
AT1G43740	1	16513075	16515138	2063	-	0
AT1G43745	1	16516118	16518727	2609	-	0
AT1G43750	1	16522212	16524114	1902	-	0
AT1G43755	1	16525241	16527812	2571	-	0
AT1G43760	1	16528879	16531065	2186	-	0
AT1G43763	1	16531127	16533402	2275	+	0
AT1G43765	1	16537510	16538091	581	+	5
AT1G43766	1	16546066	16546415	349	+	0
AT1G43770	1	16548440	16551909	3469	+	145
AT1G43775	1	16552269	16556524	4255	-	0
AT1G43777	1	16557573	16558819	1246	-	0
AT1G43780	1	16563810	16567399	3589	+	0
AT1G43781	1	16568966	16575486	6520	+	0
AT1G43785	1	16569859	16574910	5051	-	0
AT1G43790	1	16575894	16576417	523	+	329
AT1G43800	1	16577609	16579722	2113	+	93
AT1G43810	1	16580446	16580800	354	-	0
AT1G43820	1	16585704	16585776	72	-	0
AT1G43830	1	16585762	16589507	3745	+	0
AT1G43835	1	16606611	16607394	783	+	0
AT1G43840	1	16608897	16611040	2143	+	0
AT1G43845	1	16613540	16614137	597	+	0
AT1G43850	1	16617128	16622049	4921	+	1306
AT1G43860	1	16622067	16624469	2402	-	420
AT1G43870	1	16627093	16628095	1002	+	0
AT1G43880	1	16628309	16629945	1636	+	1
AT1G43883	1	16630703	16635864	5161	-	4
AT1G43886	1	16638996	16645265	6269	-	163
AT1G43890	1	16646731	16648648	1917	+	848
AT1G43895	1	16648566	16649643	1077	-	0
AT1G43897	1	16650294	16650804	510	-	0
AT1G43900	1	16654029	16655928	1899	+	616
AT1G43910	1	16655883	16657658	1775	-	91
AT1G43920	1	16659989	16660756	767	+	0
AT1G43930	1	16660999	16664004	3005	-	0
AT1G43940	1	16666417	16667817	1400	+	0
AT1G43950	1	16672581	16673952	1371	-	0
AT1G43960	1	16675519	16680354	4835	+	0
AT1G43970	1	16681268	16682933	1665	+	0
AT1G43980	1	16687636	16689502	1866	-	16
AT1G43990	1	16694925	16698219	3294	-	0
AT1G43995	1	16698562	16699056	494	-	0
AT1G43997	1	16704095	16704586	491	-	1
AT1G44000	1	16708067	16709713	1646	-	5569
AT1G44010	1	16714621	16715564	943	+	0
AT1G44020	1	16716111	16718656	2545	-	0
AT1G44030	1	16724236	16726643	2407	-	0
AT1G44040	1	16727607	16729008	1401	-	0
AT1G44045	1	16730936	16735967	5031	-	0
AT1G44050	1	16739260	16741513	2253	+	2
AT1G44060	1	16743176	16745699	2523	-	1
AT1G44070	1	16746725	16750580	3855	-	0
AT1G44075	1	16752597	16752864	267	+	0
AT1G44080	1	16753943	16755670	1727	-	0
AT1G44085	1	16758109	16758508	399	-	0
AT1G44090	1	16760676	16762486	1810	-	0
AT1G44094	1	16763284	16763407	123	+	0
AT1G44100	1	16764404	16767685	3281	-	689
AT1G44110	1	16774864	16777247	2383	-	287
AT1G44120	1	16780609	16787414	6805	+	34
AT1G44125	1	16780605	16786764	6159	-	4
AT1G44130	1	16787507	16789318	1811	-	8
AT1G44140	1	16791283	16791703	420	+	0
AT1G44150	1	16792694	16793084	390	+	6
AT1G44160	1	16794828	16796450	1622	+	2
AT1G44170	1	16796399	16800321	3922	-	636
AT1G44180	1	16807952	16810413	2461	-	1
AT1G44191	1	16813653	16814733	1080	-	0
AT1G44224	1	16820945	16821808	863	-	0
AT1G44286	1	16823437	16823822	385	+	0
AT1G44318	1	16831015	16833916	2901	+	0
AT1G44350	1	16834209	16838286	4077	-	60
AT1G44382	1	16846734	16847325	591	+	0
AT1G44414	1	16847780	16848086	306	+	2
AT1G44446	1	16848358	16851224	2866	-	11971
AT1G44478	1	16852340	16853238	898	-	5
AT1G44510	1	16853446	16857835	4389	-	0
AT1G44542	1	16864969	16866605	1636	-	0
AT1G44575	1	16871695	16873383	1688	+	72894
AT1G44608	1	16875118	16876258	1140	-	1
AT1G44641	1	16879448	16879642	194	+	0
AT1G44674	1	16881890	16882133	243	+	0
AT1G44707	1	16882724	16882942	218	-	0
AT1G44740	1	16887403	16889155	1752	+	40
AT1G44750	1	16892638	16895465	2827	+	508
AT1G44760	1	16896685	16898612	1927	-	409
AT1G44770	1	16907538	16909495	1957	-	841
AT1G44780	1	16909707	16912270	2563	+	140
AT1G44790	1	16912153	16913664	1511	-	535
AT1G44800	1	16914008	16916997	2989	-	912
AT1G44810	1	16923542	16924821	1279	+	491
AT1G44820	1	16926323	16928704	2381	+	798
AT1G44830	1	16933791	16934511	720	+	4
AT1G44835	1	16939796	16942524	2728	+	482
AT1G44840	1	16943329	16946110	2781	+	1
AT1G44850	1	16947239	16949417	2178	-	0
AT1G44860	1	16950303	16951318	1015	-	0
AT1G44870	1	16951951	16952437	486	-	0
AT1G44875	1	16952807	16953474	667	+	1
AT1G44880	1	16954385	16960042	5657	-	0
AT1G44890	1	16963143	16964966	1823	+	32
AT1G44900	1	16970213	16974641	4428	+	615
AT1G44910	1	16975603	16982965	7362	+	741
AT1G44920	1	16982903	16984419	1516	-	2126
AT1G44935	1	16985001	16985852	851	+	0
AT1G44940	1	16994154	16995044	890	+	1
AT1G44941	1	16995112	16995295	183	-	0
AT1G44960	1	16999537	17001729	2192	+	152
AT1G44970	1	17002116	17003688	1572	+	5
AT1G44980	1	17004255	17005923	1668	-	0
AT1G44990	1	17007541	17007808	267	-	0
AT1G45000	1	17009140	17011886	2746	+	1836
AT1G45010	1	17013399	17015497	2098	-	587
AT1G45015	1	17021609	17022781	1172	+	0
AT1G45020	1	17024407	17028720	4313	-	0
AT1G45030	1	17029223	17029595	372	-	0
AT1G45035	1	17029612	17030382	770	+	0
AT1G45040	1	17030497	17030855	358	-	0
AT1G45050	1	17031280	17033198	1918	+	248
AT1G45063	1	17033334	17035105	1771	-	1
AT1G45070	1	17035870	17038630	2760	+	0
AT1G45080	1	17039234	17040180	946	+	0
AT1G45090	1	17044540	17049561	5021	-	0
AT1G45100	1	17050630	17052189	1559	+	0
AT1G45110	1	17052533	17054792	2259	+	78
AT1G45120	1	17055354	17059755	4401	+	154
AT1G45130	1	17065251	17069262	4011	+	592
AT1G45140	1	17071357	17074556	3199	-	0
AT1G45145	1	17074941	17076330	1389	-	273
AT1G45150	1	17077447	17082503	5056	-	338
AT1G45160	1	17083545	17090545	7000	-	1148
AT1G45163	1	17090676	17091464	788	-	0
AT1G45165	1	17090806	17091338	532	+	0
AT1G45170	1	17095979	17098006	2027	-	283
AT1G45180	1	17098490	17101896	3406	+	207
AT1G45190	1	17104350	17105004	654	+	0
AT1G45191	1	17116043	17119174	3131	+	669
AT1G45201	1	17123820	17128651	4831	+	3624
AT1G45207	1	17130350	17133548	3198	-	359
AT1G45211	1	17136064	17136392	328	+	0
AT1G45215	1	17137702	17138231	529	+	0
AT1G45221	1	17139447	17140012	565	+	0
AT1G45223	1	17141191	17141771	580	+	0
AT1G45225	1	17143006	17143354	348	+	0
AT1G45227	1	17144752	17145100	348	+	0
AT1G45229	1	17154920	17159397	4477	-	37
AT1G45230	1	17169536	17171472	1936	-	1174
AT1G45231	1	17147836	17151194	3358	-	159
AT1G45233	1	17152933	17154843	1910	+	186
AT1G45234	1	17156606	17156678	72	+	5
AT1G45236	1	17157359	17157431	72	+	1
AT1G45238	1	17158530	17158602	72	+	2
AT1G45240	1	17158978	17159050	72	+	2
AT1G45242	1	17160527	17160599	72	+	0
AT1G45243	1	17147057	17147849	792	+	0
AT1G45244	1	17160968	17161040	72	+	0
AT1G45246	1	17162021	17162093	72	+	0
AT1G45248	1	17162962	17164779	1817	-	100
AT1G45249	1	17165126	17167907	2781	-	735
AT1G45256	1	17145614	17145902	288	-	0
AT1G45332	1	17172321	17176821	4500	-	232
AT1G45403	1	17177803	17178415	612	+	0
AT1G45474	1	17179301	17180806	1505	+	5862
AT1G45545	1	17180614	17182957	2343	-	51
AT1G45616	1	17183549	17186534	2985	-	31
AT1G45688	1	17191389	17193158	1769	+	1845
AT1G45760	1	17194069	17194801	732	+	0
AT1G45832	1	17196164	17197506	1342	+	0
AT1G45904	1	17198261	17198818	557	-	0
AT1G45976	1	17199324	17200735	1411	+	335
AT1G46048	1	17202374	17202565	191	-	0
AT1G46120	1	17203684	17207422	3738	+	2
AT1G46192	1	17212569	17217336	4767	+	0
AT1G46264	1	17224841	17226280	1439	+	163
AT1G46336	1	17230410	17230653	243	-	0
AT1G46408	1	17232134	17232935	801	-	0
AT1G46480	1	17236677	17238053	1376	-	80
AT1G46552	1	17247858	17252452	4594	-	8
AT1G46554	1	17252951	17253903	952	+	71
AT1G46624	1	17255759	17261332	5573	+	1
AT1G46696	1	17261859	17264183	2324	-	0
AT1G46768	1	17265700	17266536	836	-	55
AT1G46840	1	17270184	17271706	1522	+	0
AT1G46912	1	17272520	17273629	1109	+	0
AT1G46984	1	17274721	17275834	1113	+	0
AT1G47056	1	17276102	17277659	1557	-	304
AT1G47128	1	17282824	17285670	2846	-	10597
AT1G47200	1	17298030	17298817	787	-	777
AT1G47210	1	17300950	17302866	1916	+	288
AT1G47220	1	17303675	17305197	1522	+	0
AT1G47230	1	17306573	17308848	2275	+	229
AT1G47240	1	17308802	17311397	2595	-	421
AT1G47250	1	17319176	17321074	1898	+	556
AT1G47260	1	17321172	17323484	2312	-	2700
AT1G47265	1	17324317	17324911	594	+	0
AT1G47270	1	17326555	17328728	2173	+	294
AT1G47271	1	17328812	17330343	1531	+	5
AT1G47278	1	17330818	17331899	1081	+	256
AT1G47280	1	17332055	17334406	2351	-	0
AT1G47290	1	17335848	17339273	3425	+	356
AT1G47300	1	17339560	17340972	1412	-	0
AT1G47310	1	17342913	17344802	1889	+	379
AT1G47317	1	17347093	17347515	422	+	0
AT1G47320	1	17349098	17350163	1065	+	0
AT1G47330	1	17351049	17353875	2826	+	449
AT1G47340	1	17353846	17356533	2687	-	114
AT1G47350	1	17358446	17360722	2276	-	0
AT1G47360	1	17361269	17365328	4059	+	1
AT1G47370	1	17365897	17368703	2806	-	24
AT1G47380	1	17372536	17376075	3539	-	293
AT1G47389	1	17378651	17379374	723	+	0
AT1G47390	1	17379543	17380656	1113	+	0
AT1G47395	1	17383033	17383408	375	+	17
AT1G47400	1	17385716	17386186	470	+	15
AT1G47405	1	17389678	17390781	1103	+	0
AT1G47410	1	17394081	17395673	1592	+	118
AT1G47420	1	17395517	17397255	1738	-	2509
AT1G47430	1	17397501	17398191	690	+	0
AT1G47435	1	17399464	17400740	1276	+	0
AT1G47440	1	17400932	17402268	1336	+	18
AT1G47450	1	17402683	17403193	510	-	0
AT1G47460	1	17403893	17404298	405	+	0
AT1G47465	1	17406819	17407592	773	-	0
AT1G47470	1	17414610	17415132	522	-	0
AT1G47480	1	17417578	17419432	1854	+	17
AT1G47485	1	17422447	17423066	619	+	0
AT1G47490	1	17424668	17427475	2807	+	1031
AT1G47495	1	17428944	17429813	869	-	0
AT1G47497	1	17431008	17432401	1393	-	0
AT1G47500	1	17432517	17435064	2547	+	412
AT1G47510	1	17435564	17438396	2832	-	93
AT1G47520	1	17443287	17446628	3341	+	202
AT1G47530	1	17451679	17454421	2742	+	2026
AT1G47540	1	17455532	17456170	638	-	0
AT1G47550	1	17457121	17464386	7265	+	989
AT1G47560	1	17466750	17473294	6544	+	57
AT1G47565	1	17473921	17476333	2412	+	146
AT1G47570	1	17478654	17483502	4848	+	328
AT1G47578	1	17484364	17485470	1106	+	26
AT1G47580	1	17485649	17486463	814	+	526
AT1G47590	1	17486690	17487863	1173	-	0
AT1G47595	1	17489054	17489450	396	-	1
AT1G47600	1	17491731	17494759	3028	+	0
AT1G47603	1	17496838	17498110	1272	-	0
AT1G47606	1	17503030	17503732	702	-	0
AT1G47610	1	17504782	17505964	1182	+	0
AT1G47620	1	17507941	17509702	1761	-	0
AT1G47625	1	17510809	17511489	680	-	0
AT1G47630	1	17516248	17517850	1602	-	0
AT1G47640	1	17518188	17520128	1940	-	485
AT1G47650	1	17520859	17524957	4098	+	0
AT1G47655	1	17525364	17526306	942	+	48
AT1G47660	1	17533940	17535551	1611	-	0
AT1G47670	1	17536666	17539538	2872	-	344
AT1G47680	1	17540774	17541089	315	+	0
AT1G47690	1	17544078	17544231	153	+	0
AT1G47700	1	17547324	17547477	153	+	0
AT1G47705	1	17549376	17550724	1348	-	0
AT1G47710	1	17558208	17560269	2061	+	402
AT1G47720	1	17561354	17562883	1529	-	92
AT1G47730	1	17563930	17565106	1176	-	0
AT1G47740	1	17566510	17569297	2787	+	908
AT1G47750	1	17569255	17570159	904	-	150
AT1G47760	1	17572450	17573159	709	+	17
AT1G47765	1	17574905	17576092	1187	-	0
AT1G47770	1	17590265	17591261	996	+	0
AT1G47780	1	17594682	17595343	661	+	0
AT1G47783	1	17596609	17597023	414	+	0
AT1G47786	1	17597897	17599099	1202	+	0
AT1G47790	1	17600003	17601173	1170	-	0
AT1G47800	1	17601512	17602676	1164	+	0
AT1G47810	1	17603503	17604559	1056	+	0
AT1G47813	1	17606557	17606818	261	+	0
AT1G47816	1	17608739	17611427	2688	-	1
AT1G47820	1	17611962	17612548	586	+	125
AT1G47830	1	17613097	17614926	1829	-	447
AT1G47840	1	17616106	17618894	2788	-	63
AT1G47860	1	17620676	17630270	9594	-	154
AT1G47870	1	17634756	17637772	3016	+	201
AT1G47880	1	17640045	17641148	1103	+	1
AT1G47885	1	17642396	17642805	409	-	0
AT1G47890	1	17643975	17647035	3060	+	0
AT1G47900	1	17647143	17651425	4282	-	807
AT1G47910	1	17656859	17660288	3429	+	0
AT1G47915	1	17660751	17660973	222	+	1
AT1G47920	1	17661094	17662394	1300	+	1
AT1G47930	1	17662899	17663940	1041	+	7
AT1G47940	1	17668284	17669713	1429	+	0
AT1G47946	1	17673331	17673526	195	-	0
AT1G47950	1	17675487	17681953	6466	-	0
AT1G47960	1	17681156	17683629	2473	-	217
AT1G47970	1	17687268	17688816	1548	+	1178
AT1G47980	1	17691833	17693867	2034	-	0
AT1G47990	1	17698654	17700834	2180	+	3
AT1G48000	1	17704178	17706460	2282	-	4
AT1G48010	1	17711490	17712660	1170	-	0
AT1G48020	1	17716050	17716808	758	-	3
AT1G48030	1	17717132	17719141	2009	-	13292
AT1G48040	1	17719739	17721841	2102	-	166
AT1G48050	1	17723451	17727043	3592	+	531
AT1G48060	1	17728294	17729448	1154	+	2
AT1G48070	1	17730416	17731122	706	-	0
AT1G48080	1	17731840	17731913	73	+	0
AT1G48090	1	17732009	17758444	26435	-	3789
AT1G48095	1	17760141	17761998	1857	+	0
AT1G48100	1	17766873	17769951	3078	+	743
AT1G48110	1	17769937	17773493	3556	-	1185
AT1G48120	1	17773687	17779955	6268	-	350
AT1G48130	1	17780501	17781727	1226	+	0
AT1G48140	1	17782030	17784211	2181	+	147
AT1G48145	1	17784506	17784913	407	-	0
AT1G48150	1	17785396	17786368	972	+	0
AT1G48160	1	17786544	17789024	2480	-	436
AT1G48170	1	17788785	17790093	1308	+	140
AT1G48175	1	17790506	17792331	1825	+	159
AT1G48180	1	17792448	17793717	1269	-	1
AT1G48190	1	17794559	17795163	604	-	0
AT1G48195	1	17796334	17796784	450	+	1
AT1G48200	1	17796763	17798337	1574	-	110
AT1G48210	1	17798430	17801987	3557	+	180
AT1G48220	1	17802862	17804955	2093	+	0
AT1G48230	1	17805760	17808885	3125	+	653
AT1G48240	1	17809006	17811895	2889	-	448
AT1G48250	1	17812458	17813523	1065	-	0
AT1G48260	1	17813975	17817283	3308	-	208
AT1G48267	1	17825729	17825819	90	+	1
AT1G48268	1	17826621	17827824	1203	-	0
AT1G48270	1	17827952	17830420	2468	-	148
AT1G48280	1	17835087	17837717	2630	+	217
AT1G48290	1	17842667	17844907	2240	+	0
AT1G48300	1	17847355	17848564	1209	+	3387
AT1G48310	1	17848420	17853807	5387	-	181
AT1G48315	1	17854116	17855811	1695	+	34
AT1G48320	1	17854812	17855715	903	-	38
AT1G48325	1	17857270	17857722	452	+	0
AT1G48330	1	17863836	17864386	550	+	88
AT1G48340	1	17865827	17866707	880	+	0
AT1G48350	1	17867203	17868342	1139	+	7051
AT1G48360	1	17868649	17873032	4383	+	201
AT1G48370	1	17874511	17877397	2886	+	46
AT1G48380	1	17877412	17879270	1858	-	215
AT1G48390	1	17879447	17880903	1456	-	40
AT1G48400	1	17882135	17883855	1720	-	3
AT1G48405	1	17884644	17885614	970	-	1
AT1G48410	1	17885632	17892596	6964	-	4092
AT1G48420	1	17896596	17898804	2208	-	1782
AT1G48422	1	17899421	17900707	1286	-	0
AT1G48430	1	17902635	17906806	4171	-	796
AT1G48440	1	17906986	17908534	1548	+	798
AT1G48450	1	17908502	17910450	1948	-	3426
AT1G48460	1	17911345	17913300	1955	+	271
AT1G48470	1	17913710	17916098	2388	+	6
AT1G48480	1	17918390	17920985	2595	+	1472
AT1G48490	1	17921934	17928930	6996	-	824
AT1G48500	1	17931475	17934662	3187	+	5
AT1G48510	1	17934828	17936915	2087	+	1
AT1G48520	1	17940087	17942822	2735	+	2041
AT1G48530	1	17943241	17944315	1074	-	1
AT1G48540	1	17945375	17950521	5146	+	1387
AT1G48550	1	17950568	17952694	2126	-	244
AT1G48560	1	17952858	17955336	2478	+	59
AT1G48570	1	17955277	17957719	2442	-	326
AT1G48580	1	17958262	17960610	2348	-	59
AT1G48590	1	17962579	17964429	1850	+	5
AT1G48598	1	17965863	17969354	3491	+	0
AT1G48600	1	17965870	17969354	3484	+	3
AT1G48605	1	17969394	17970282	888	-	18
AT1G48610	1	17970677	17973303	2626	-	494
AT1G48620	1	17973696	17976389	2693	-	1369
AT1G48625	1	17979560	17980815	1255	+	0
AT1G48630	1	17981772	17983327	1555	-	1679
AT1G48635	1	17983703	17986116	2413	+	395
AT1G48640	1	17986357	17988991	2634	+	2
AT1G48650	1	17989397	17995326	5929	-	1622
AT1G48660	1	17995947	17997972	2025	-	33
AT1G48670	1	17998945	18001200	2255	-	0
AT1G48680	1	18002751	18006845	4094	-	0
AT1G48690	1	18009056	18009989	933	-	0
AT1G48698	1	18010728	18011214	486	+	0
AT1G48700	1	18011034	18012871	1837	-	0
AT1G48710	1	18013631	18017690	4059	+	0
AT1G48720	1	18018147	18018441	294	+	0
AT1G48730	1	18020336	18022277	1941	-	0
AT1G48740	1	18023386	18026065	2679	-	6
AT1G48742	1	18026837	18027009	172	-	0
AT1G48745	1	18030703	18031439	736	+	173
AT1G48750	1	18035966	18036510	544	+	0
AT1G48760	1	18035966	18039405	3439	-	405
AT1G48770	1	18040284	18040916	632	+	80
AT1G48780	1	18041988	18042744	756	+	83
AT1G48790	1	18043671	18047659	3988	-	916
AT1G48800	1	18049843	18052975	3132	+	0
AT1G48810	1	18053368	18054359	991	-	0
AT1G48820	1	18055228	18059367	4139	+	8
AT1G48830	1	18059635	18061302	1667	-	2156
AT1G48840	1	18061520	18065031	3511	+	414
AT1G48850	1	18064904	18068090	3186	-	1931
AT1G48860	1	18068706	18071466	2760	-	1141
AT1G48870	1	18072324	18074457	2133	-	40
AT1G48880	1	18081032	18082925	1893	+	110
AT1G48890	1	18082901	18084169	1268	-	0
AT1G48900	1	18084781	18087879	3098	-	1115
AT1G48910	1	18091680	18093774	2094	+	0
AT1G48912	1	18094899	18095046	147	+	0
AT1G48920	1	18098094	18101623	3529	+	4097
AT1G48930	1	18101642	18104661	3019	-	0
AT1G48940	1	18105807	18106422	615	-	1
AT1G48950	1	18106896	18110237	3341	+	399
AT1G48953	1	18111089	18111380	291	-	0
AT1G48960	1	18112457	18113733	1276	+	116
AT1G48970	1	18113713	18117833	4120	-	396
AT1G48980	1	18118016	18120667	2651	+	0
AT1G48990	1	18121433	18122155	722	+	0
AT1G49000	1	18123458	18124165	707	-	3
AT1G49005	1	18128685	18131522	2837	-	2
AT1G49010	1	18132644	18133925	1281	+	969
AT1G49015	1	18134527	18135312	785	+	0
AT1G49020	1	18135597	18135669	72	-	0
AT1G49030	1	18136704	18137946	1242	+	1
AT1G49032	1	18138267	18139005	738	+	142
AT1G49040	1	18139233	18148981	9748	-	1027
AT1G49050	1	18150537	18153361	2824	+	321
AT1G49060	1	18154044	18154459	415	+	0
AT1G49070	1	18155150	18159680	4530	+	0
AT1G49080	1	18159888	18160464	576	+	0
AT1G49090	1	18161319	18162686	1367	+	0
AT1G49100	1	18166146	18170105	3959	-	0
AT1G49110	1	18171594	18172450	856	+	0
AT1G49120	1	18173426	18174416	990	+	2
AT1G49130	1	18174739	18176022	1283	-	124
AT1G49140	1	18176771	18178298	1527	-	993
AT1G49150	1	18178576	18179023	447	+	4
AT1G49160	1	18179303	18182391	3088	-	98
AT1G49170	1	18183265	18184443	1178	-	92
AT1G49180	1	18184653	18187529	2876	-	278
AT1G49190	1	18191266	18193782	2516	+	0
AT1G49200	1	18198226	18199168	942	+	39
AT1G49210	1	18201888	18202764	876	+	1
AT1G49220	1	18205933	18206701	768	+	2
AT1G49230	1	18209260	18210128	868	+	44
AT1G49240	1	18215871	18218313	2442	+	3102
AT1G49245	1	18218749	18219261	512	+	99
AT1G49250	1	18220532	18224256	3724	+	1
AT1G49260	1	18225869	18226967	1098	+	0
AT1G49270	1	18227333	18230227	2894	-	0
AT1G49280	1	18230478	18230552	74	-	0
AT1G49290	1	18232607	18233624	1017	-	0
AT1G49300	1	18234723	18237543	2820	+	973
AT1G49310	1	18237862	18238367	505	-	23
AT1G49320	1	18246304	18247992	1688	+	133
AT1G49330	1	18250042	18251038	996	+	1
AT1G49340	1	18252354	18264462	12108	+	2065
AT1G49350	1	18264970	18267270	2300	+	173
AT1G49360	1	18267230	18269448	2218	-	194
AT1G49370	1	18275049	18276477	1428	-	8
AT1G49380	1	18276706	18279528	2822	+	1874
AT1G49390	1	18279599	18280978	1379	+	8
AT1G49400	1	18283031	18284202	1171	+	275
AT1G49405	1	18284334	18284947	613	-	18
AT1G49410	1	18285447	18286902	1455	-	539
AT1G49420	1	18287858	18288650	792	-	0
AT1G49430	1	18291042	18295825	4783	+	1068
AT1G49435	1	18299429	18299862	433	-	0
AT1G49440	1	18302710	18304784	2074	+	0
AT1G49450	1	18305540	18307557	2017	+	34
AT1G49460	1	18308902	18308939	37	+	0
AT1G49470	1	18310493	18311634	1141	+	304
AT1G49475	1	18312919	18314016	1097	+	10
AT1G49480	1	18314177	18316645	2468	-	761
AT1G49490	1	18317562	18320106	2544	-	143
AT1G49500	1	18321294	18322284	990	-	397
AT1G49510	1	18326869	18328610	1741	+	864
AT1G49520	1	18329695	18331869	2174	+	124
AT1G49530	1	18332428	18333689	1261	+	50
AT1G49540	1	18333622	18337520	3898	-	198
AT1G49550	1	18338840	18339830	990	+	0
AT1G49560	1	18342553	18344363	1810	+	215
AT1G49570	1	18347035	18348951	1916	+	0
AT1G49580	1	18351457	18354619	3162	+	612
AT1G49590	1	18354743	18356642	1899	+	417
AT1G49600	1	18356885	18360150	3265	-	1087
AT1G49610	1	18361678	18363192	1514	-	1
AT1G49620	1	18365490	18366559	1069	-	58
AT1G49630	1	18367592	18375381	7789	-	738
AT1G49640	1	18375537	18376729	1192	-	0
AT1G49650	1	18377251	18378634	1383	-	231
AT1G49660	1	18378696	18379799	1103	-	512
AT1G49670	1	18380803	18386108	5305	-	1347
AT1G49680	1	18386866	18387166	300	+	0
AT1G49690	1	18387801	18387874	73	+	0
AT1G49700	1	18388791	18390496	1705	-	25
AT1G49710	1	18391337	18393947	2610	-	500
AT1G49715	1	18396771	18397339	568	-	0
AT1G49720	1	18400091	18402628	2537	+	213
AT1G49730	1	18402505	18405681	3176	-	914
AT1G49740	1	18407517	18410022	2505	+	713
AT1G49750	1	18410928	18412801	1873	-	4453
AT1G49760	1	18416473	18420083	3610	+	2218
AT1G49770	1	18424577	18426782	2205	+	0
AT1G49780	1	18428905	18430319	1414	-	472
AT1G49790	1	18435350	18437068	1718	-	33
AT1G49800	1	18438364	18438939	575	-	0
AT1G49810	1	18440012	18442237	2225	-	1
AT1G49820	1	18442881	18445098	2217	+	614
AT1G49830	1	18445110	18446659	1549	-	18
AT1G49832	1	18447620	18448239	619	+	13
AT1G49840	1	18452069	18454358	2289	+	305
AT1G49850	1	18455063	18456544	1481	-	222
AT1G49860	1	18458665	18459906	1241	+	2
AT1G49870	1	18460211	18463785	3574	+	162
AT1G49880	1	18464016	18466077	2061	+	94
AT1G49890	1	18470074	18473823	3749	+	494
AT1G49900	1	18473907	18477643	3736	-	0
AT1G49910	1	18479024	18481475	2451	+	48
AT1G49920	1	18481773	18484233	2460	-	10
AT1G49930	1	18484931	18485639	708	+	0
AT1G49938	1	18487544	18488107	563	-	3
AT1G49940	1	18488359	18491179	2820	-	33
AT1G49950	1	18494102	18497239	3137	-	676
AT1G49952	1	18492122	18493258	1136	-	1
AT1G49960	1	18498638	18501886	3248	+	1
AT1G49970	1	18501569	18504609	3040	-	7093
AT1G49975	1	18504801	18505597	796	+	1283
AT1G49980	1	18507970	18513172	5202	+	446
AT1G49990	1	18513627	18515099	1472	+	116
AT1G50000	1	18515058	18517249	2191	-	123
AT1G50010	1	18517585	18520000	2415	+	5295
AT1G50020	1	18519945	18521695	1750	-	3070
AT1G50030	1	18522440	18539995	17555	-	1786
AT1G50040	1	18542129	18543948	1819	+	52
AT1G50050	1	18546164	18549046	2882	+	2
AT1G50055	1	18549203	18550042	839	-	135
AT1G50060	1	18551185	18552578	1393	+	0
AT1G50070	1	18552998	18553078	80	+	0
AT1G50080	1	18554000	18554276	276	-	0
AT1G50090	1	18554640	18556794	2154	-	1
AT1G50100	1	18557899	18557979	80	+	0
AT1G50110	1	18558016	18560274	2258	-	137
AT1G50120	1	18561828	18566172	4344	+	576
AT1G50130	1	18566603	18569401	2798	+	0
AT1G50140	1	18569734	18578702	8968	-	981
AT1G50160	1	18581428	18581650	222	+	0
AT1G50170	1	18582023	18583724	1701	+	527
AT1G50180	1	18584234	18587136	2902	+	102
AT1G50190	1	18588228	18590799	2571	-	6
AT1G50200	1	18591193	18598481	7288	-	5015
AT1G50210	1	18600977	18601717	740	+	5
AT1G50220	1	18602957	18604575	1618	-	0
AT1G50240	1	18607046	18614162	7116	+	300
AT1G50250	1	18614208	18617063	2855	-	9857
AT1G50260	1	18617592	18621739	4147	-	428
AT1G50270	1	18622025	18624250	2225	+	75
AT1G50280	1	18623697	18626395	2698	-	201
AT1G50290	1	18627558	18628434	876	-	214
AT1G50300	1	18628554	18631946	3392	-	325
AT1G50310	1	18635983	18638110	2127	+	13
AT1G50320	1	18638383	18639536	1153	-	4670
AT1G50325	1	18639873	18640488	615	-	0
AT1G50330	1	18644316	18645154	838	-	0
AT1G50340	1	18647375	18647849	474	-	0
AT1G50350	1	18648755	18649227	472	+	1
AT1G50360	1	18649746	18657376	7630	+	486
AT1G50370	1	18658646	18661974	3328	+	776
AT1G50380	1	18662308	18666478	4170	+	737
AT1G50390	1	18666985	18667677	692	-	1
AT1G50400	1	18668154	18670546	2392	+	6
AT1G50410	1	18672162	18677556	5394	+	650
AT1G50420	1	18677925	18680117	2192	-	277
AT1G50430	1	18681931	18685652	3721	-	1543
AT1G50440	1	18685776	18687907	2131	+	527
AT1G50450	1	18687784	18690371	2587	-	1978
AT1G50460	1	18693683	18697659	3976	+	709
AT1G50470	1	18699999	18700444	445	-	0
AT1G50480	1	18701950	18704938	2988	+	4397
AT1G50490	1	18704804	18706478	1674	-	359
AT1G50500	1	18707986	18715977	7991	-	802
AT1G50510	1	18716111	18719328	3217	+	355
AT1G50520	1	18719377	18721219	1842	+	32
AT1G50530	1	18721211	18721729	518	-	0
AT1G50550	1	18721897	18722866	969	+	1
AT1G50560	1	18724206	18726272	2066	+	3
AT1G50570	1	18726234	18728289	2055	-	748
AT1G50575	1	18728718	18730409	1691	-	407
AT1G50580	1	18730830	18732177	1347	+	0
AT1G50590	1	18732377	18734053	1676	-	136
AT1G50600	1	18737131	18739547	2416	-	845
AT1G50603	1	18740559	18740661	102	+	0
AT1G50610	1	18742134	18744725	2591	+	0
AT1G50620	1	18748536	18751338	2802	+	348
AT1G50630	1	18751455	18753669	2214	-	135
AT1G50640	1	18757147	18758433	1286	-	490
AT1G50650	1	18763772	18764297	525	-	1
AT1G50659	1	18770936	18771930	994	-	1
AT1G50660	1	18770936	18774686	3750	+	982
AT1G50670	1	18774855	18776959	2104	-	671
AT1G50680	1	18777600	18778614	1014	-	0
AT1G50690	1	18779605	18780604	999	+	0
AT1G50691	1	18780821	18781070	249	-	0
AT1G50700	1	18781913	18784582	2669	+	192
AT1G50710	1	18784508	18787802	3294	-	445
AT1G50720	1	18789179	18789644	465	-	0
AT1G50730	1	18795209	18802189	6980	+	581
AT1G50732	1	18802687	18803363	676	+	1142
AT1G50735	1	18806507	18807394	887	-	0
AT1G50740	1	18807671	18809004	1333	+	172
AT1G50750	1	18809183	18812290	3107	-	16
AT1G50760	1	18814946	18815260	314	-	1
AT1G50770	1	18818558	18820503	1945	-	1
AT1G50780	1	18821266	18823077	1811	+	2
AT1G50790	1	18824049	18826488	2439	-	36
AT1G50800	1	18826908	18828338	1430	-	0
AT1G50810	1	18828867	18832972	4105	+	0
AT1G50820	1	18833274	18834861	1587	-	0
AT1G50830	1	18835270	18837942	2672	-	3
AT1G50840	1	18839106	18844559	5453	+	1516
AT1G50850	1	18847409	18849654	2245	-	0
AT1G50860	1	18850510	18854356	3846	-	0
AT1G50870	1	18855146	18856337	1191	+	0
AT1G50880	1	18860836	18861982	1146	+	0
AT1G50890	1	18862170	18866039	3869	-	212
AT1G50900	1	18866196	18867204	1008	+	1686
AT1G50910	1	18866752	18869933	3181	-	41
AT1G50920	1	18870138	18872930	2792	+	1645
AT1G50930	1	18876836	18877844	1008	+	0
AT1G50940	1	18877811	18880010	2199	-	441
AT1G50950	1	18880319	18884225	3906	+	135
AT1G50954	1	18886532	18886628	96	-	0
AT1G50960	1	18889548	18891719	2171	+	0
AT1G50970	1	18896322	18900268	3946	+	254
AT1G50980	1	18900540	18902057	1517	-	0
AT1G50990	1	18902929	18905204	2275	+	0
AT1G51000	1	18909923	18910142	219	+	0
AT1G51010	1	18911596	18911845	249	+	0
AT1G51020	1	18913109	18913828	719	+	0
AT1G51030	1	18915133	18915596	463	+	0
AT1G51035	1	18917546	18917774	228	+	0
AT1G51040	1	18920657	18923314	2657	+	0
AT1G51050	1	18923354	18923966	612	-	0
AT1G51055	1	18925285	18926315	1030	-	15
AT1G51060	1	18926875	18927646	771	+	1970
AT1G51070	1	18927876	18929762	1886	+	1340
AT1G51080	1	18929743	18930752	1009	-	370
AT1G51085	1	18931465	18931691	226	-	0
AT1G51090	1	18932936	18933950	1014	+	87
AT1G51100	1	18934307	18935193	886	+	821
AT1G51110	1	18935328	18937665	2337	+	5332
AT1G51120	1	18938090	18939149	1059	+	0
AT1G51130	1	18939276	18941704	2428	-	92
AT1G51140	1	18943456	18945753	2297	-	1383
AT1G51150	1	18948369	18949290	921	-	0
AT1G51160	1	18949590	18951783	2193	+	723
AT1G51170	1	18953457	18954892	1435	-	329
AT1G51172	1	18963204	18965571	2367	+	0
AT1G51175	1	18965954	18971576	5622	-	0
AT1G51190	1	18977283	18980618	3335	+	0
AT1G51200	1	18984418	18986653	2235	+	3698
AT1G51210	1	18987808	18989110	1302	+	0
AT1G51220	1	18989750	18992149	2399	-	0
AT1G51230	1	18997025	18997434	409	-	0
AT1G51240	1	19000508	19000892	384	-	0
AT1G51250	1	19001543	19002215	672	-	0
AT1G51260	1	19003375	19005641	2266	-	0
AT1G51270	1	19007509	19011272	3763	+	407
AT1G51290	1	19012172	19013306	1134	+	0
AT1G51300	1	19014259	19016103	1844	-	0
AT1G51310	1	19018978	19021804	2826	-	430
AT1G51320	1	19025641	19026769	1128	+	0
AT1G51330	1	19028840	19029844	1004	-	0
AT1G51340	1	19031996	19034979	2983	+	465
AT1G51350	1	19035754	19039341	3587	+	564
AT1G51355	1	19041396	19042146	750	+	25
AT1G51360	1	19044183	19044900	717	+	179
AT1G51370	1	19045058	19047518	2460	+	113
AT1G51380	1	19047881	19050162	2281	+	18
AT1G51390	1	19050343	19052094	1751	+	310
AT1G51400	1	19052022	19052582	560	-	1532
AT1G51402	1	19052192	19053534	1342	+	18
AT1G51405	1	19057779	19059582	1803	+	56
AT1G51410	1	19059884	19061424	1540	+	1
AT1G51420	1	19064767	19066704	1937	-	0
AT1G51430	1	19068240	19069776	1536	+	509
AT1G51440	1	19070912	19072694	1782	+	352
AT1G51450	1	19074370	19076520	2150	+	202
AT1G51460	1	19076981	19081433	4452	-	88
AT1G51470	1	19087412	19090414	3002	+	0
AT1G51480	1	19090846	19094306	3460	-	0
AT1G51490	1	19094887	19097452	2565	+	0
AT1G51500	1	19097796	19101080	3284	-	4327
AT1G51510	1	19102798	19104850	2052	-	945
AT1G51520	1	19106686	19109587	2901	+	58
AT1G51530	1	19109853	19112157	2304	+	3
AT1G51538	1	19113182	19115273	2091	+	5
AT1G51540	1	19115560	19117534	1974	+	145
AT1G51550	1	19117031	19119371	2340	-	218
AT1G51560	1	19119634	19121938	2304	-	624
AT1G51570	1	19122169	19124688	2519	-	2002
AT1G51580	1	19125582	19128161	2579	+	401
AT1G51590	1	19128143	19132318	4175	-	502
AT1G51600	1	19132220	19135541	3321	+	256
AT1G51610	1	19136250	19139918	3668	+	466
AT1G51620	1	19140129	19141787	1658	+	12
AT1G51630	1	19141972	19144294	2322	-	835
AT1G51640	1	19149760	19151852	2092	-	6
AT1G51645	1	19149495	19151730	2235	+	4
AT1G51650	1	19152614	19153929	1315	+	2048
AT1G51660	1	19154322	19155947	1625	+	260
AT1G51670	1	19156503	19158749	2246	+	28
AT1G51680	1	19158751	19161552	2801	-	3318
AT1G51690	1	19164062	19170449	6387	+	1646
AT1G51700	1	19174069	19175189	1120	+	561
AT1G51710	1	19175641	19179967	4326	-	1310
AT1G51720	1	19180771	19186532	5761	+	809
AT1G51730	1	19186491	19188788	2297	-	723
AT1G51740	1	19188842	19191300	2458	+	219
AT1G51745	1	19191522	19194787	3265	+	334
AT1G51750	1	19195193	19197149	1956	+	0
AT1G51760	1	19199418	19201642	2224	+	439
AT1G51770	1	19201788	19203224	1436	+	4
AT1G51780	1	19204511	19206586	2075	+	1
AT1G51790	1	19206710	19211417	4707	-	17
AT1G51800	1	19214147	19217970	3823	+	15
AT1G51802	1	19218591	19218783	192	-	0
AT1G51805	1	19220976	19225690	4714	-	3693
AT1G51810	1	19227118	19232359	5241	-	0
AT1G51820	1	19237406	19241883	4477	-	1
AT1G51823	1	19242293	19242437	144	+	0
AT1G51830	1	19243024	19246010	2986	-	2
AT1G51840	1	19249448	19250709	1261	-	0
AT1G51850	1	19252846	19256783	3937	-	3
AT1G51860	1	19257633	19261479	3846	-	5
AT1G51870	1	19262878	19267001	4123	-	0
AT1G51880	1	19270192	19274068	3876	-	0
AT1G51890	1	19274657	19278528	3871	-	6
AT1G51900	1	19279883	19282895	3012	-	0
AT1G51910	1	19284276	19288385	4109	-	0
AT1G51913	1	19292908	19293339	431	+	0
AT1G51915	1	19293477	19293969	492	+	0
AT1G51920	1	19294228	19294579	351	+	0
AT1G51930	1	19294837	19295236	399	-	0
AT1G51940	1	19295903	19299118	3215	-	588
AT1G51950	1	19305314	19307510	2196	+	926
AT1G51960	1	19310354	19311683	1329	+	1
AT1G51965	1	19312077	19314145	2068	-	205
AT1G51970	1	19314541	19314916	375	-	0
AT1G51980	1	19323381	19326916	3535	-	3477
AT1G51990	1	19330948	19332667	1719	+	0
AT1G52000	1	19333158	19336115	2957	-	472
AT1G52010	1	19337047	19339384	2337	+	0
AT1G52020	1	19339340	19345112	5772	-	0
AT1G52030	1	19345939	19349088	3149	-	42
AT1G52040	1	19350374	19352782	2408	-	56
AT1G52050	1	19354918	19356764	1846	-	0
AT1G52060	1	19359038	19360675	1637	-	0
AT1G52070	1	19364887	19366924	2037	-	0
AT1G52080	1	19369130	19372065	2935	+	111
AT1G52085	1	19372154	19372421	267	-	0
AT1G52087	1	19375641	19378214	2573	+	0
AT1G52090	1	19378142	19378487	345	-	0
AT1G52100	1	19383121	19385602	2481	-	20
AT1G52110	1	19386788	19389740	2952	-	0
AT1G52120	1	19396080	19398244	2164	-	0
AT1G52130	1	19400618	19402363	1745	-	0
AT1G52140	1	19407363	19408254	891	-	107
AT1G52150	1	19409710	19414678	4968	-	1258
AT1G52155	1	19417665	19419853	2188	+	140
AT1G52160	1	19420714	19424439	3725	-	153
AT1G52170	1	19424554	19424628	74	+	0
AT1G52180	1	19424943	19425928	985	-	0
AT1G52185	1	19430077	19430277	200	-	0
AT1G52190	1	19434508	19438971	4463	+	2020
AT1G52191	1	19439366	19441400	2034	-	0
AT1G52200	1	19442067	19443529	1462	-	19
AT1G52210	1	19446189	19450533	4344	+	0
AT1G52211	1	19450844	19452032	1188	-	0
AT1G52220	1	19453568	19454697	1129	-	12117
AT1G52230	1	19454835	19455668	833	+	45041
AT1G52240	1	19455765	19459586	3821	-	260
AT1G52260	1	19460569	19463445	2876	+	246
AT1G52270	1	19463677	19464355	678	-	39
AT1G52280	1	19467968	19469586	1618	-	475
AT1G52290	1	19470032	19472449	2417	-	641
AT1G52300	1	19474897	19476234	1337	-	3529
AT1G52310	1	19478123	19480610	2487	+	635
AT1G52315	1	19481187	19482674	1487	+	42
AT1G52320	1	19484354	19487997	3643	+	423
AT1G52325	1	19487792	19488418	626	-	0
AT1G52330	1	19488942	19489914	972	+	4
AT1G52340	1	19489793	19491648	1855	-	618
AT1G52342	1	19492254	19492769	515	-	664
AT1G52343	1	19494126	19495718	1592	-	0
AT1G52347	1	19496505	19497703	1198	+	119
AT1G52350	1	19498418	19498492	74	-	0
AT1G52360	1	19499161	19506170	7009	+	1700
AT1G52370	1	19506434	19508934	2500	+	217
AT1G52380	1	19508982	19511539	2557	+	439
AT1G52390	1	19511967	19512234	267	-	0
AT1G52400	1	19515142	19518411	3269	+	2694
AT1G52410	1	19520727	19525624	4897	+	516
AT1G52415	1	19526165	19526888	723	+	0
AT1G52420	1	19527841	19531287	3446	+	733
AT1G52430	1	19531349	19535955	4606	-	3
AT1G52440	1	19538820	19540907	2087	+	0
AT1G52450	1	19541683	19546266	4583	-	19
AT1G52460	1	19549330	19551282	1952	+	0
AT1G52470	1	19553212	19555543	2331	+	0
AT1G52490	1	19556217	19559011	2794	-	0
AT1G52500	1	19559982	19563113	3131	+	291
AT1G52510	1	19561505	19565272	3767	-	4073
AT1G52520	1	19565768	19568384	2616	+	154
AT1G52530	1	19568587	19570058	1471	+	32
AT1G52540	1	19570057	19572204	2147	-	298
AT1G52550	1	19572926	19574030	1104	-	154
AT1G52560	1	19574759	19575866	1107	-	14
AT1G52565	1	19579885	19580686	801	-	122
AT1G52570	1	19583939	19587050	3111	-	70
AT1G52580	1	19587636	19589052	1416	+	11
AT1G52590	1	19589008	19590273	1265	-	645
AT1G52600	1	19590486	19592695	2209	+	451
AT1G52610	1	19596594	19599402	2808	-	0
AT1G52615	1	19600530	19602345	1815	-	2
AT1G52618	1	19603146	19603662	516	+	29
AT1G52620	1	19603810	19606287	2477	+	93
AT1G52630	1	19606334	19608639	2305	-	225
AT1G52640	1	19608730	19610452	1722	-	2
AT1G52650	1	19610641	19612594	1953	+	7
AT1G52660	1	19613474	19614796	1322	+	0
AT1G52670	1	19614941	19617572	2631	-	1184
AT1G52680	1	19618142	19619021	879	-	0
AT1G52690	1	19619744	19621534	1790	+	2
AT1G52695	1	19621237	19623461	2224	-	0
AT1G52696	1	19624921	19625777	856	-	0
AT1G52700	1	19631125	19633440	2315	-	52
AT1G52710	1	19638284	19640239	1955	-	70
AT1G52720	1	19640898	19641665	767	+	319
AT1G52730	1	19642489	19645134	2645	+	735
AT1G52740	1	19645267	19646482	1215	+	1781
AT1G52750	1	19646464	19649261	2797	-	48
AT1G52760	1	19651324	19652743	1419	+	780
AT1G52770	1	19655838	19657734	1896	+	114
AT1G52780	1	19658642	19662181	3539	+	657
AT1G52790	1	19662193	19663301	1108	-	3
AT1G52800	1	19664043	19665362	1319	+	43
AT1G52810	1	19667126	19668237	1111	+	1
AT1G52820	1	19669182	19670427	1245	+	50
AT1G52825	1	19670488	19670967	479	-	94
AT1G52827	1	19671447	19671925	478	-	160
AT1G52830	1	19672495	19673644	1149	-	28
AT1G52840	1	19674539	19676111	1572	+	0
AT1G52850	1	19677576	19679780	2204	+	0
AT1G52855	1	19682945	19683498	553	-	70
AT1G52857	1	19681419	19681681	262	-	0
AT1G52860	1	19685182	19685219	37	-	0
AT1G52870	1	19685744	19687907	2163	+	9202
AT1G52880	1	19688956	19690542	1586	-	223
AT1G52890	1	19697003	19698482	1479	-	6
AT1G52900	1	19702210	19702916	706	-	1
AT1G52905	1	19706084	19706706	622	+	25
AT1G52910	1	19708056	19709323	1267	+	115
AT1G52920	1	19709274	19711052	1778	-	16
AT1G52930	1	19711236	19713230	1994	+	316
AT1G52940	1	19716401	19723725	7324	+	0
AT1G52942	1	19724221	19724588	367	+	0
AT1G52950	1	19725482	19728007	2525	+	0
AT1G52960	1	19731630	19735204	3574	+	0
AT1G52970	1	19736633	19737083	450	-	0
AT1G52980	1	19737431	19740348	2917	+	1276
AT1G52990	1	19740502	19743449	2947	-	15
AT1G53000	1	19745045	19747245	2200	-	571
AT1G53010	1	19747846	19748383	537	+	0
AT1G53020	1	19751371	19753064	1693	-	0
AT1G53023	1	19754213	19755843	1630	-	0
AT1G53025	1	19756823	19759623	2800	-	111
AT1G53030	1	19760000	19761452	1452	-	144
AT1G53035	1	19761699	19762551	852	-	31
AT1G53039	1	19764079	19764220	141	+	0
AT1G53040	1	19764309	19767348	3039	-	531
AT1G53050	1	19772044	19775747	3703	+	807
AT1G53060	1	19776051	19776780	729	+	25
AT1G53070	1	19778332	19779373	1041	+	204
AT1G53080	1	19781367	19782219	852	+	1
AT1G53090	1	19783351	19786902	3551	+	681
AT1G53100	1	19786899	19789029	2130	-	15
AT1G53110	1	19790188	19792489	2301	+	137
AT1G53120	1	19792756	19794778	2022	+	606
AT1G53130	1	19794722	19795544	822	-	0
AT1G53140	1	19799237	19802598	3361	+	178
AT1G53160	1	19806418	19807608	1190	+	153
AT1G53163	1	19812261	19813286	1025	+	9
AT1G53165	1	19813803	19819564	5761	+	515
AT1G53170	1	19821336	19822252	916	-	207
AT1G53180	1	19831440	19832895	1455	+	16
AT1G53190	1	19837109	19840227	3118	+	601
AT1G53200	1	19840375	19843403	3028	-	134
AT1G53210	1	19844631	19847836	3205	+	4249
AT1G53220	1	19847972	19848046	74	+	0
AT1G53230	1	19849787	19851725	1938	-	48
AT1G53233	1	19850030	19852127	2097	+	10
AT1G53240	1	19854614	19856937	2323	-	8595
AT1G53250	1	19857350	19859256	1906	+	269
AT1G53260	1	19859266	19860976	1710	-	4
AT1G53265	1	19861097	19861475	378	-	0
AT1G53270	1	19862877	19864650	1773	+	7
AT1G53280	1	19864769	19867389	2620	-	1479
AT1G53282	1	19867929	19868335	406	-	0
AT1G53285	1	19869559	19870095	536	-	0
AT1G53290	1	19871298	19873490	2192	+	308
AT1G53300	1	19879421	19882375	2954	+	1180
AT1G53310	1	19884026	19888369	4343	-	3297
AT1G53320	1	19891013	19893504	2491	-	511
AT1G53325	1	19895226	19895733	507	-	0
AT1G53330	1	19896026	19897442	1416	+	4
AT1G53340	1	19898927	19900931	2004	-	3
AT1G53345	1	19902494	19903700	1206	+	28
AT1G53350	1	19903898	19907515	3617	+	329
AT1G53360	1	19907516	19908548	1032	+	0
AT1G53366	1	19909839	19909977	138	-	0
AT1G53370	1	19910515	19911646	1131	+	0
AT1G53380	1	19913075	19916517	3442	-	531
AT1G53390	1	19918046	19923807	5761	+	673
AT1G53400	1	19924751	19926631	1880	+	491
AT1G53410	1	19925838	19925910	72	-	7
AT1G53420	1	19926625	19931494	4869	-	0
AT1G53430	1	19935162	19941088	5926	+	1041
AT1G53440	1	19945958	19951562	5604	+	747
AT1G53450	1	19951005	19954115	3110	-	291
AT1G53460	1	19954489	19956632	2143	-	185
AT1G53470	1	19958586	19961578	2992	+	18
AT1G53480	1	19963046	19964712	1666	-	0
AT1G53490	1	19963266	19966952	3686	+	17
AT1G53500	1	19966943	19969757	2814	-	1624
AT1G53510	1	19970663	19974393	3730	-	1411
AT1G53520	1	19976414	19977955	1541	-	813
AT1G53530	1	19978145	19980084	1939	+	107
AT1G53540	1	19980461	19981109	648	+	2
AT1G53541	1	19981384	19981495	111	-	9
AT1G53542	1	19981627	19981813	186	+	18
AT1G53543	1	19981968	19982124	156	+	0
AT1G53550	1	19983410	19984637	1227	+	0
AT1G53560	1	19984741	19985983	1242	-	399
AT1G53570	1	19987190	19991135	3945	+	667
AT1G53580	1	19991274	19993334	2060	-	1140
AT1G53590	1	19996314	20000265	3951	+	730
AT1G53600	1	20001262	20003416	2154	+	11
AT1G53610	1	20008995	20009320	325	-	0
AT1G53620	1	20011428	20011925	497	-	3
AT1G53625	1	20014409	20014923	514	-	3
AT1G53630	1	20016220	20017332	1112	-	0
AT1G53633	1	20017388	20017932	544	-	4
AT1G53635	1	20019292	20019799	507	-	0
AT1G53640	1	20020884	20025461	4577	-	0
AT1G53645	1	20026146	20028635	2489	-	291
AT1G53650	1	20029028	20031566	2538	-	244
AT1G53660	1	20034031	20035946	1915	+	1
AT1G53670	1	20036640	20038219	1579	+	2914
AT1G53680	1	20038357	20039117	760	+	41
AT1G53683	1	20039462	20039616	154	-	0
AT1G53687	1	20041517	20041734	217	+	0
AT1G53690	1	20042639	20043344	705	-	10
AT1G53700	1	20048585	20050115	1530	+	18
AT1G53705	1	20050474	20051451	977	-	0
AT1G53708	1	20052392	20053195	803	+	0
AT1G53710	1	20053160	20056396	3236	-	270
AT1G53720	1	20056532	20059638	3106	+	269
AT1G53730	1	20061700	20065713	4013	+	926
AT1G53750	1	20065713	20068466	2753	-	3156
AT1G53760	1	20068967	20071096	2129	-	147
AT1G53770	1	20071310	20073758	2448	-	217
AT1G53780	1	20073995	20078228	4233	-	1232
AT1G53785	1	20077797	20079002	1205	-	335
AT1G53790	1	20079080	20081455	2375	-	57
AT1G53800	1	20081698	20084500	2802	+	699
AT1G53801	1	20083210	20084173	963	-	0
AT1G53810	1	20085583	20090152	4569	+	0
AT1G53815	1	20090248	20090962	714	-	0
AT1G53820	1	20091490	20092423	933	+	0
AT1G53830	1	20098521	20100889	2368	+	8
AT1G53840	1	20101444	20103667	2223	+	1806
AT1G53850	1	20103952	20106015	2063	-	997
AT1G53860	1	20107106	20109511	2405	-	52
AT1G53870	1	20112261	20113522	1261	+	0
AT1G53880	1	20115068	20118485	3417	+	0
AT1G53885	1	20119722	20120458	736	+	0
AT1G53887	1	20122425	20122866	441	-	17
AT1G53890	1	20124826	20126109	1283	+	1
AT1G53900	1	20127633	20131050	3417	+	0
AT1G53903	1	20132287	20133017	730	+	0
AT1G53910	1	20135111	20136970	1859	+	1707
AT1G53920	1	20137711	20139637	1926	+	82
AT1G53930	1	20140410	20140887	477	-	0
AT1G53935	1	20142064	20142866	802	-	0
AT1G53940	1	20143278	20145780	2502	+	0
AT1G53950	1	20146447	20147988	1541	-	0
AT1G53970	1	20148418	20148898	480	+	0
AT1G53980	1	20149333	20149609	276	-	0
AT1G53990	1	20151015	20152752	1737	+	0
AT1G54000	1	20154168	20156419	2251	-	17
AT1G54010	1	20158663	20160815	2152	-	295
AT1G54020	1	20161669	20163748	2079	-	3
AT1G54030	1	20167628	20169600	1972	+	720
AT1G54035	1	20169919	20170665	746	-	0
AT1G54040	1	20170714	20173949	3235	-	625
AT1G54050	1	20179421	20180281	860	-	149
AT1G54060	1	20180678	20182324	1646	+	530
AT1G54070	1	20182638	20183242	604	+	1
AT1G54080	1	20183580	20187096	3516	-	2181
AT1G54090	1	20189566	20191900	2334	+	525
AT1G54095	1	20192961	20193867	906	+	0
AT1G54100	1	20195263	20199130	3867	-	1360
AT1G54110	1	20199417	20201729	2312	+	214
AT1G54115	1	20202117	20204177	2060	+	369
AT1G54120	1	20207019	20207540	521	+	56
AT1G54130	1	20210872	20213942	3070	+	1559
AT1G54140	1	20213966	20215223	1257	-	151
AT1G54150	1	20215431	20217489	2058	+	300
AT1G54160	1	20217335	20219452	2117	-	88
AT1G54170	1	20221059	20225948	4889	-	663
AT1G54180	1	20227276	20230237	2961	+	122
AT1G54200	1	20235711	20237065	1354	+	166
AT1G54210	1	20241225	20242615	1390	+	210
AT1G54215	1	20243117	20243627	510	+	2
AT1G54217	1	20243920	20245527	1607	-	29
AT1G54220	1	20246036	20250310	4274	-	715
AT1G54230	1	20250517	20252365	1848	+	0
AT1G54240	1	20252781	20254708	1927	+	0
AT1G54250	1	20254937	20256557	1620	+	145
AT1G54260	1	20256935	20259417	2482	+	279
AT1G54270	1	20259691	20262266	2575	+	2522
AT1G54280	1	20262765	20267821	5056	-	2
AT1G54290	1	20268484	20270107	1623	-	377
AT1G54300	1	20270809	20272106	1297	+	0
AT1G54310	1	20273566	20275574	2008	+	443
AT1G54320	1	20275533	20277957	2424	-	938
AT1G54330	1	20279566	20280952	1386	-	15
AT1G54340	1	20283479	20286786	3307	+	726
AT1G54350	1	20286881	20290401	3520	+	1389
AT1G54355	1	20288803	20290316	1513	-	6
AT1G54360	1	20290555	20293324	2769	+	838
AT1G54370	1	20293150	20297133	3983	-	811
AT1G54380	1	20297964	20300908	2944	-	243
AT1G54385	1	20301125	20303885	2760	-	345
AT1G54390	1	20304566	20307024	2458	-	433
AT1G54400	1	20307666	20308768	1102	+	9
AT1G54410	1	20309774	20310767	993	-	19866
AT1G54420	1	20311618	20312418	800	+	0
AT1G54430	1	20313855	20319554	5699	-	0
AT1G54440	1	20323035	20328067	5032	+	449
AT1G54445	1	20332427	20332862	435	+	0
AT1G54450	1	20336339	20339535	3196	-	88
AT1G54460	1	20340599	20343530	2931	-	612
AT1G54470	1	20344697	20349202	4505	+	1
AT1G54490	1	20350190	20356916	6726	+	1237
AT1G54500	1	20356953	20357788	835	-	4100
AT1G54510	1	20358318	20362593	4275	-	257
AT1G54520	1	20363447	20366061	2614	+	3097
AT1G54530	1	20366504	20366888	384	+	19
AT1G54540	1	20367571	20368434	863	-	3
AT1G54550	1	20369650	20370986	1336	+	0
AT1G54560	1	20371648	20379745	8097	-	4
AT1G54570	1	20380477	20385125	4648	-	302
AT1G54575	1	20387059	20387710	651	+	137
AT1G54580	1	20389346	20391015	1669	+	1390
AT1G54590	1	20391559	20393503	1944	-	0
AT1G54600	1	20392507	20393630	1123	+	0
AT1G54610	1	20393761	20397195	3434	-	1253
AT1G54620	1	20400436	20401025	589	-	0
AT1G54630	1	20401376	20403041	1665	-	1341
AT1G54640	1	20403891	20404807	916	-	0
AT1G54650	1	20405597	20407753	2156	-	154
AT1G54660	1	20408412	20411449	3037	-	26
AT1G54670	1	20412927	20413000	73	-	0
AT1G54680	1	20413134	20414574	1440	+	79
AT1G54690	1	20414315	20415287	972	-	551
AT1G54700	1	20415897	20417506	1609	+	0
AT1G54710	1	20416769	20421035	4266	-	545
AT1G54720	1	20422830	20423754	924	+	0
AT1G54730	1	20424409	20430123	5714	+	560
AT1G54740	1	20430768	20431986	1218	+	190
AT1G54750	1	20432889	20433236	347	+	0
AT1G54760	1	20433911	20434397	486	+	0
AT1G54770	1	20434638	20436008	1370	+	276
AT1G54775	1	20437783	20438014	231	-	0
AT1G54780	1	20439433	20441159	1726	+	20501
AT1G54790	1	20440978	20444029	3051	-	93
AT1G54820	1	20447315	20450861	3546	+	1431
AT1G54830	1	20451082	20452671	1589	+	431
AT1G54840	1	20452592	20454249	1657	-	19
AT1G54850	1	20454388	20456220	1832	+	186
AT1G54860	1	20457420	20458631	1211	-	0
AT1G54870	1	20459005	20460647	1642	+	0
AT1G54880	1	20461037	20461558	521	-	0
AT1G54890	1	20463082	20464470	1388	+	0
AT1G54905	1	20470024	20470247	223	+	0
AT1G54920	1	20470677	20475180	4503	+	1134
AT1G54923	1	20475756	20476568	812	-	0
AT1G54926	1	20476623	20477773	1150	-	0
AT1G54930	1	20478266	20479671	1405	-	21
AT1G54940	1	20481689	20484541	2852	+	0
AT1G54950	1	20490527	20491275	748	-	0
AT1G54955	1	20493748	20494834	1086	+	0
AT1G54960	1	20499949	20503841	3892	+	98
AT1G54970	1	20504999	20506488	1489	+	0
AT1G54980	1	20507374	20508355	981	-	2
AT1G54985	1	20509839	20511162	1323	+	0
AT1G54990	1	20511518	20513681	2163	+	618
AT1G55000	1	20514633	20516496	1863	+	558
AT1G55010	1	20517077	20517403	326	+	9
AT1G55020	1	20525707	20530273	4566	+	647
AT1G55030	1	20530416	20531768	1352	-	0
AT1G55035	1	20532843	20534375	1532	-	0
AT1G55040	1	20534873	20539113	4240	+	81
AT1G55045	1	20540692	20540890	198	+	0
AT1G55050	1	20541886	20545762	3876	+	16
AT1G55060	1	20549532	20550225	693	+	0
AT1G55070	1	20551451	20552633	1182	+	0
AT1G55080	1	20553010	20554254	1244	-	150
AT1G55090	1	20554351	20558529	4178	+	1200
AT1G55100	1	20558234	20559103	869	-	0
AT1G55110	1	20560283	20563171	2888	-	504
AT1G55120	1	20566029	20569286	3257	+	265
AT1G55130	1	20569653	20572393	2740	+	529
AT1G55140	1	20572404	20574348	1944	-	749
AT1G55150	1	20574479	20577320	2841	+	432
AT1G55152	1	20577423	20578292	869	-	147
AT1G55160	1	20578405	20580010	1605	+	406
AT1G55170	1	20580273	20581975	1702	+	168
AT1G55175	1	20582964	20584430	1466	+	4
AT1G55180	1	20585056	20587629	2573	-	171
AT1G55190	1	20588396	20589199	803	+	170
AT1G55200	1	20589128	20592063	2935	-	186
AT1G55205	1	20594558	20596034	1476	+	52
AT1G55207	1	20595968	20596498	530	-	2
AT1G55210	1	20597789	20598708	919	-	1069
AT1G55220	1	20600882	20601436	554	-	0
AT1G55221	1	20601013	20601794	781	+	0
AT1G55230	1	20602818	20603924	1106	+	0
AT1G55240	1	20604915	20606405	1490	+	1
AT1G55250	1	20607029	20612410	5381	+	538
AT1G55260	1	20614609	20616436	1827	+	1509
AT1G55265	1	20617312	20618005	693	+	195
AT1G55270	1	20617953	20620136	2183	-	458
AT1G55280	1	20622959	20624630	1671	-	230
AT1G55290	1	20626120	20627488	1368	-	2
AT1G55300	1	20628022	20629692	1670	-	185
AT1G55310	1	20630064	20632973	2909	+	644
AT1G55320	1	20633359	20636892	3533	+	310
AT1G55325	1	20637379	20648434	11055	+	1075
AT1G55330	1	20648464	20648891	427	-	1390
AT1G55340	1	20651830	20653648	1818	+	647
AT1G55350	1	20653819	20665095	11276	-	2419
AT1G55360	1	20666221	20668726	2505	-	2398
AT1G55365	1	20673982	20674363	381	-	2
AT1G55370	1	20674782	20676449	1667	+	1063
AT1G55380	1	20676621	20678607	1986	-	18
AT1G55390	1	20680875	20683043	2168	-	0
AT1G55400	1	20684232	20684965	733	-	0
AT1G55410	1	20688613	20691034	2421	-	0
AT1G55420	1	20691774	20693952	2178	-	8
AT1G55430	1	20697648	20699622	1974	-	2
AT1G55440	1	20701498	20703460	1962	-	0
AT1G55450	1	20704917	20706893	1976	-	592
AT1G55460	1	20707477	20709024	1547	+	410
AT1G55470	1	20709476	20711311	1835	-	0
AT1G55475	1	20711513	20713310	1797	+	107
AT1G55480	1	20713683	20715547	1864	+	10550
AT1G55490	1	20715562	20719196	3634	-	17940
AT1G55500	1	20719547	20722739	3192	+	519
AT1G55510	1	20723301	20725668	2367	+	275
AT1G55520	1	20725725	20728091	2366	-	577
AT1G55525	1	20728328	20728745	417	-	0
AT1G55530	1	20729181	20731283	2102	-	682
AT1G55535	1	20731645	20733997	2352	-	212
AT1G55540	1	20734607	20743174	8567	-	605
AT1G55546	1	20743827	20745109	1282	+	0
AT1G55550	1	20748914	20753079	4165	+	113
AT1G55560	1	20754320	20756656	2336	-	0
AT1G55570	1	20757766	20760076	2310	+	0
AT1G55580	1	20764010	20765752	1742	+	4
AT1G55590	1	20769319	20771871	2552	-	344
AT1G55591	1	20772217	20772302	85	+	0
AT1G55600	1	20774045	20776294	2249	-	0
AT1G55604	1	20777726	20778130	404	+	0
AT1G55610	1	20779873	20784017	4144	-	68
AT1G55615	1	20785573	20785771	198	-	0
AT1G55620	1	20787133	20791189	4056	-	376
AT1G55625	1	20791310	20791392	82	+	0
AT1G55630	1	20791674	20793564	1890	-	119
AT1G55640	1	20793770	20794334	564	+	0
AT1G55650	1	20796339	20798481	2142	+	0
AT1G55660	1	20800693	20802340	1647	+	0
AT1G55670	1	20802669	20803449	780	-	58704
AT1G55675	1	20803703	20804573	870	-	281
AT1G55680	1	20804591	20807940	3349	-	1817
AT1G55690	1	20808260	20812840	4580	-	796
AT1G55700	1	20821600	20823640	2040	+	0
AT1G55710	1	20825923	20826142	219	-	0
AT1G55720	1	20828117	20830640	2523	-	0
AT1G55730	1	20831051	20834519	3468	-	289
AT1G55740	1	20835365	20838778	3413	-	57
AT1G55750	1	20840194	20845182	4988	-	337
AT1G55760	1	20846907	20849054	2147	-	210
AT1G55770	1	20851038	20851566	528	-	3
AT1G55790	1	20852323	20856122	3799	-	0
AT1G55800	1	20856921	20858235	1314	-	18
AT1G55805	1	20858722	20859439	717	-	525
AT1G55810	1	20860608	20864266	3658	+	554
AT1G55820	1	20864338	20867611	3273	+	111
AT1G55830	1	20867871	20870338	2467	-	199
AT1G55840	1	20873601	20876272	2671	+	1252
AT1G55850	1	20876698	20879482	2784	+	369
AT1G55860	1	20879465	20895393	15928	-	3052
AT1G55870	1	20895584	20898422	2838	+	259
AT1G55880	1	20898897	20901183	2286	-	189
AT1G55890	1	20901345	20902800	1455	+	362
AT1G55900	1	20903052	20905728	2676	+	248
AT1G55910	1	20906133	20907413	1280	+	564
AT1G55915	1	20907546	20909638	2092	+	101
AT1G55920	1	20912115	20913447	1332	+	951
AT1G55928	1	20917189	20918462	1273	+	0
AT1G55930	1	20918716	20922232	3516	+	384
AT1G55940	1	20922458	20925619	3161	-	18
AT1G55950	1	20926838	20927450	612	-	2
AT1G55960	1	20927642	20930017	2375	-	4088
AT1G55964	1	20931031	20931975	944	+	3
AT1G55970	1	20932128	20938290	6162	-	496
AT1G55980	1	20938898	20941813	2915	-	6
AT1G55990	1	20942486	20942951	465	-	1
AT1G56000	1	20944140	20946718	2578	+	179
AT1G56010	1	20946570	20949281	2711	-	260
AT1G56020	1	20952143	20953547	1404	+	68
AT1G56030	1	20957097	20958550	1453	-	0
AT1G56040	1	20960355	20962334	1979	-	1
AT1G56045	1	20962623	20963464	841	+	1675
AT1G56050	1	20963718	20966341	2623	+	1678
AT1G56060	1	20966527	20967144	617	-	9
AT1G56070	1	20967929	20971742	3813	-	19841
AT1G56080	1	20974160	20976291	2131	-	20
AT1G56085	1	20976514	20977541	1027	+	0
AT1G56090	1	20977694	20979357	1663	-	130
AT1G56100	1	20980368	20984058	3690	-	0
AT1G56110	1	20984388	20986951	2563	-	1491
AT1G56120	1	20987287	20993072	5785	-	124
AT1G56130	1	20994930	21000887	5957	-	37
AT1G56140	1	21001573	21007809	6236	-	206
AT1G56145	1	21008092	21014018	5926	-	114
AT1G56150	1	21017384	21017939	555	+	24
AT1G56160	1	21022383	21023587	1204	+	0
AT1G56165	1	21022758	21024402	1644	-	11
AT1G56170	1	21024763	21025883	1120	+	240
AT1G56180	1	21025903	21028064	2161	-	460
AT1G56190	1	21028215	21030649	2434	+	10009
AT1G56200	1	21030793	21032078	1285	+	1582
AT1G56210	1	21035617	21037211	1594	+	148
AT1G56220	1	21043347	21044738	1391	+	3097
AT1G56230	1	21046008	21049194	3186	-	485
AT1G56233	1	21050539	21051017	478	-	0
AT1G56240	1	21056231	21057577	1346	-	1
AT1G56242	1	21056400	21057815	1415	+	1
AT1G56250	1	21061599	21062995	1396	-	15
AT1G56260	1	21064278	21065853	1575	-	115
AT1G56270	1	21071016	21071650	634	-	0
AT1G56280	1	21072854	21074877	2023	-	5512
AT1G56290	1	21075285	21078778	3493	+	286
AT1G56300	1	21078819	21080423	1604	-	102
AT1G56310	1	21082862	21085651	2789	+	229
AT1G56320	1	21085547	21086494	947	-	8
AT1G56330	1	21086554	21088549	1995	-	2232
AT1G56340	1	21089843	21092660	2817	-	3086
AT1G56345	1	21092992	21094461	1469	-	102
AT1G56350	1	21094777	21097988	3211	+	145
AT1G56360	1	21098602	21100842	2240	-	0
AT1G56380	1	21101326	21102701	1375	+	0
AT1G56385	1	21106314	21106797	483	-	0
AT1G56390	1	21107987	21110752	2765	+	1
AT1G56400	1	21111804	21113621	1817	-	0
AT1G56410	1	21117146	21119241	2095	+	0
AT1G56415	1	21119828	21120395	567	+	0
AT1G56418	1	21122029	21122448	419	+	0
AT1G56420	1	21122550	21124234	1684	-	101
AT1G56423	1	21128911	21130839	1928	+	276
AT1G56430	1	21136943	21138087	1144	+	685
AT1G56440	1	21138529	21141571	3042	-	197
AT1G56450	1	21141882	21144400	2518	+	1559
AT1G56460	1	21146238	21149805	3567	+	581
AT1G56470	1	21149705	21150153	448	+	1
AT1G56480	1	21150292	21152844	2552	-	0
AT1G56490	1	21155294	21157567	2273	-	0
AT1G56500	1	21159743	21167321	7578	+	6595
AT1G56510	1	21167588	21173632	6044	+	984
AT1G56520	1	21174663	21178974	4311	-	382
AT1G56530	1	21179236	21180888	1652	+	0
AT1G56540	1	21181663	21185306	3643	+	59
AT1G56550	1	21185661	21188369	2708	-	7
AT1G56553	1	21189721	21190175	454	+	0
AT1G56555	1	21191120	21192217	1097	-	5
AT1G56560	1	21192498	21195112	2614	+	562
AT1G56570	1	21195803	21197721	1918	+	65
AT1G56580	1	21198258	21198956	698	-	2690
AT1G56590	1	21202019	21204742	2723	-	397
AT1G56600	1	21207536	21209596	2060	+	874
AT1G56605	1	21210481	21211008	527	+	0
AT1G56610	1	21211718	21214562	2844	+	264
AT1G56612	1	21214117	21215406	1289	-	104
AT1G56620	1	21219817	21220357	540	+	0
AT1G56630	1	21223592	21226943	3351	-	0
AT1G56640	1	21229998	21230469	471	-	0
AT1G56650	1	21233594	21235137	1543	-	147
AT1G56660	1	21237887	21240558	2671	+	259
AT1G56670	1	21241672	21244047	2375	+	211
AT1G56675	1	21244465	21248926	4461	-	0
AT1G56680	1	21250337	21251417	1080	-	2
AT1G56690	1	21253816	21255931	2115	+	25
AT1G56700	1	21256175	21257973	1798	+	916
AT1G56710	1	21258007	21259933	1926	-	25
AT1G56720	1	21263419	21266368	2949	-	552
AT1G56730	1	21268786	21268868	82	+	0
AT1G56740	1	21269121	21269158	37	+	0
AT1G56750	1	21269551	21269588	37	+	0
AT1G56760	1	21270295	21270377	82	+	0
AT1G56770	1	21270630	21270667	37	+	0
AT1G56780	1	21271060	21271097	37	+	0
AT1G56790	1	21271804	21271886	82	+	0
AT1G56800	1	21272139	21272176	37	+	0
AT1G56810	1	21272569	21272606	37	+	0
AT1G56820	1	21273313	21273395	82	+	0
AT1G56830	1	21273648	21273685	37	+	0
AT1G56840	1	21274078	21274115	37	+	0
AT1G56850	1	21274822	21274904	82	+	0
AT1G56860	1	21275157	21275194	37	+	0
AT1G56870	1	21275608	21275645	37	+	0
AT1G56880	1	21276351	21276433	82	+	0
AT1G56890	1	21276686	21276723	37	+	0
AT1G56900	1	21277116	21277153	37	+	0
AT1G56910	1	21277860	21277942	82	+	0
AT1G56920	1	21278195	21278232	37	+	0
AT1G56930	1	21278646	21278683	37	+	0
AT1G56940	1	21279389	21279471	82	+	0
AT1G56950	1	21279719	21279756	37	+	0
AT1G56960	1	21280177	21280214	37	+	0
AT1G56970	1	21280921	21281003	82	+	0
AT1G56980	1	21281251	21281288	37	+	0
AT1G56990	1	21281709	21281746	37	+	0
AT1G57000	1	21282453	21282535	82	+	0
AT1G57010	1	21282783	21282820	37	+	0
AT1G57020	1	21283241	21283278	37	+	0
AT1G57030	1	21283985	21284067	82	+	0
AT1G57040	1	21284315	21284352	37	+	0
AT1G57050	1	21284773	21284810	37	+	0
AT1G57060	1	21285518	21285600	82	+	0
AT1G57070	1	21285848	21285885	37	+	0
AT1G57080	1	21286305	21286342	37	+	0
AT1G57090	1	21287049	21287131	82	+	0
AT1G57100	1	21287379	21287416	37	+	0
AT1G57110	1	21287836	21287873	37	+	0
AT1G57120	1	21288580	21288662	82	+	0
AT1G57130	1	21288909	21288946	37	+	0
AT1G57140	1	21289367	21289404	37	+	0
AT1G57150	1	21290111	21290193	82	+	0
AT1G57160	1	21290444	21290481	37	+	0
AT1G57170	1	21290902	21290939	37	+	0
AT1G57180	1	21291460	21291542	82	+	0
AT1G57190	1	21291790	21291827	37	+	0
AT1G57200	1	21292247	21292284	37	+	0
AT1G57210	1	21292991	21293073	82	+	0
AT1G57220	1	21293324	21293361	37	+	0
AT1G57230	1	21293782	21293819	37	+	0
AT1G57240	1	21294340	21294422	82	+	0
AT1G57250	1	21294670	21294707	37	+	0
AT1G57260	1	21295127	21295164	37	+	0
AT1G57270	1	21295871	21295953	82	+	0
AT1G57280	1	21296204	21296241	37	+	0
AT1G57290	1	21296662	21296699	37	+	0
AT1G57300	1	21297220	21297302	82	+	0
AT1G57310	1	21297550	21297587	37	+	0
AT1G57320	1	21298008	21298045	37	+	0
AT1G57330	1	21298752	21298834	82	+	0
AT1G57340	1	21299085	21299122	37	+	0
AT1G57350	1	21299543	21299580	37	+	0
AT1G57360	1	21300101	21300183	82	+	0
AT1G57370	1	21300431	21300468	37	+	0
AT1G57380	1	21300889	21300926	37	+	0
AT1G57390	1	21301633	21301715	82	+	0
AT1G57400	1	21301966	21302003	37	+	0
AT1G57410	1	21302424	21302461	37	+	0
AT1G57420	1	21302982	21303064	82	+	0
AT1G57430	1	21303316	21303353	37	+	0
AT1G57440	1	21303776	21303813	37	+	0
AT1G57450	1	21304519	21304603	84	+	0
AT1G57460	1	21304855	21304892	37	+	0
AT1G57470	1	21305310	21305347	37	+	0
AT1G57480	1	21306054	21306136	82	+	0
AT1G57490	1	21306388	21306425	37	+	0
AT1G57500	1	21306848	21306885	37	+	0
AT1G57510	1	21307591	21307675	84	+	0
AT1G57520	1	21307927	21307964	37	+	0
AT1G57530	1	21308386	21308423	37	+	0
AT1G57540	1	21310328	21311502	1174	-	158
AT1G57550	1	21312540	21312809	269	-	0
AT1G57560	1	21316827	21318064	1237	+	13
AT1G57565	1	21319634	21320213	579	+	0
AT1G57570	1	21320937	21324637	3700	+	3
AT1G57580	1	21325078	21326252	1174	+	0
AT1G57590	1	21327359	21329763	2404	-	346
AT1G57600	1	21330511	21334727	4216	-	343
AT1G57610	1	21337208	21338756	1548	-	544
AT1G57613	1	21340182	21340716	534	+	0
AT1G57620	1	21342720	21344804	2084	+	319
AT1G57630	1	21345638	21346157	519	+	21
AT1G57640	1	21346353	21350793	4440	-	0
AT1G57650	1	21351290	21354311	3021	+	2
AT1G57660	1	21355519	21356537	1018	+	1045
AT1G57670	1	21357168	21359872	2704	-	2
AT1G57680	1	21362487	21364728	2241	-	1340
AT1G57690	1	21366720	21368150	1430	-	0
AT1G57700	1	21370682	21374080	3398	+	169
AT1G57710	1	21374318	21374389	71	-	0
AT1G57720	1	21377614	21380382	2768	+	4825
AT1G57730	1	21380857	21381382	525	-	0
AT1G57740	1	21382130	21383304	1174	+	0
AT1G57750	1	21383980	21385709	1729	-	4
AT1G57760	1	21390002	21390565	563	+	0
AT1G57765	1	21393350	21394962	1612	+	242
AT1G57770	1	21395195	21398280	3085	+	2560
AT1G57775	1	21399617	21400068	451	-	0
AT1G57777	1	21401234	21401798	564	-	0
AT1G57780	1	21402999	21404228	1229	+	0
AT1G57790	1	21404407	21405956	1549	-	95
AT1G57800	1	21408622	21412283	3661	-	1
AT1G57810	1	21413054	21413738	684	-	0
AT1G57820	1	21414169	21417946	3777	-	625
AT1G57830	1	21420308	21420803	495	+	0
AT1G57835	1	21422459	21423346	887	+	0
AT1G57840	1	21424798	21426173	1375	+	3
AT1G57850	1	21425480	21427349	1869	+	0
AT1G57860	1	21429897	21430865	968	-	523
AT1G57870	1	21431050	21436103	5053	-	613
AT1G57906	1	21435426	21436810	1384	+	1
AT1G57943	1	21437601	21438889	1288	-	1
AT1G57980	1	21439231	21440805	1574	-	155
AT1G57990	1	21441504	21442920	1416	-	223
AT1G58007	1	21445902	21447341	1439	-	6
AT1G58010	1	21448884	21449134	250	-	0
AT1G58020	1	21450212	21455851	5639	-	0
AT1G58025	1	21457666	21462243	4577	-	438
AT1G58030	1	21464000	21468420	4420	-	1201
AT1G58037	1	21472964	21474602	1638	-	0
AT1G58040	1	21476021	21476737	716	+	0
AT1G58050	1	21478589	21487839	9250	-	0
AT1G58055	1	21488740	21489132	392	+	0
AT1G58060	1	21489284	21501811	12527	-	623
AT1G58070	1	21502904	21504075	1171	+	117
AT1G58080	1	21504313	21507540	3227	-	3505
AT1G58090	1	21510509	21511625	1116	+	0
AT1G58100	1	21512383	21514022	1639	-	325
AT1G58110	1	21515473	21518159	2686	-	514
AT1G58120	1	21520400	21522457	2057	+	0
AT1G58122	1	21520400	21522457	2057	+	0
AT1G58130	1	21523335	21524056	721	-	1
AT1G58140	1	21525421	21529384	3963	-	0
AT1G58150	1	21530102	21530458	356	+	31
AT1G58160	1	21533756	21534598	842	+	27
AT1G58170	1	21536127	21536836	709	+	33
AT1G58180	1	21537769	21539914	2145	-	491
AT1G58190	1	21540631	21548112	7481	+	6
AT1G58200	1	21548186	21553127	4941	-	1157
AT1G58210	1	21553620	21558056	4436	+	150
AT1G58220	1	21558242	21562965	4723	-	345
AT1G58225	1	21564110	21565171	1061	+	24
AT1G58230	1	21566147	21579123	12976	+	1307
AT1G58235	1	21579684	21580696	1012	-	144
AT1G58242	1	21581963	21582370	407	-	0
AT1G58245	1	21584251	21584524	273	-	0
AT1G58248	1	21586035	21586311	276	-	0
AT1G58250	1	21587141	21601621	14480	-	1733
AT1G58260	1	21605751	21607995	2244	+	0
AT1G58265	1	21610908	21611388	480	+	0
AT1G58270	1	21612115	21614117	2002	-	832
AT1G58280	1	21620330	21622611	2281	-	837
AT1G58290	1	21623725	21626200	2475	-	25085
AT1G58300	1	21628011	21629996	1985	-	13
AT1G58310	1	21631946	21633642	1696	+	0
AT1G58320	1	21634122	21635303	1181	-	0
AT1G58330	1	21641129	21642041	912	+	0
AT1G58340	1	21653007	21655439	2432	+	47
AT1G58350	1	21662915	21667445	4530	-	578
AT1G58360	1	21676529	21680502	3973	+	1802
AT1G58370	1	21684583	21688321	3738	+	214
AT1G58380	1	21689031	21690256	1225	+	336
AT1G58390	1	21690961	21694447	3486	-	14
AT1G58400	1	21696164	21699118	2954	-	11
AT1G58410	1	21701184	21704255	3071	-	8
AT1G58420	1	21707378	21708118	740	+	14
AT1G58430	1	21711564	21713103	1539	-	7
AT1G58440	1	21713841	21717290	3449	-	819
AT1G58450	1	21718013	21718916	903	+	0
AT1G58460	1	21721403	21722429	1026	+	11
AT1G58470	1	21727023	21728760	1737	+	116
AT1G58520	1	21729912	21738652	8740	+	3427
AT1G58561	1	21748674	21753246	4572	+	175
AT1G58590	1	21742943	21743891	948	-	123
AT1G58602	1	21746353	21765705	19352	+	3272
AT1G58643	1	21767341	21769456	2115	+	0
AT1G58684	1	21769761	21771229	1468	-	0
AT1G58725	1	21771934	21773365	1431	-	0
AT1G58766	1	21774380	21776765	2385	-	0
AT1G58807	1	21780184	21784314	4130	+	113
AT1G58808	1	21784644	21786869	2225	+	1
AT1G58848	1	21791782	21797050	5268	+	260
AT1G58889	1	21797093	21801662	4569	-	4
AT1G58936	1	21803599	21805714	2115	+	0
AT1G58983	1	21806019	21807487	1468	-	0
AT1G59030	1	21808192	21809509	1317	-	0
AT1G59077	1	21810643	21813023	2380	-	0
AT1G59124	1	21816442	21820572	4130	+	0
AT1G59171	1	21821023	21822548	1525	+	0
AT1G59218	1	21828032	21832708	4676	+	3
AT1G59265	1	21833351	21837779	4428	-	2
AT1G59312	1	21839857	21841972	2115	+	0
AT1G59359	1	21842303	21843745	1442	-	0
AT1G59406	1	21844450	21845881	1431	-	0
AT1G59453	1	21846901	21853384	6483	-	0
AT1G59500	1	21854492	21856614	2122	-	0
AT1G59510	1	21859594	21861076	1482	+	87
AT1G59520	1	21861381	21866190	4809	+	272
AT1G59530	1	21868261	21868708	447	+	0
AT1G59535	1	21871207	21871527	320	-	0
AT1G59540	1	21874011	21879539	5528	+	169
AT1G59550	1	21879648	21880788	1140	-	0
AT1G59560	1	21881598	21883792	2194	+	110
AT1G59570	1	21883842	21883924	82	-	0
AT1G59580	1	21884042	21886051	2009	+	525
AT1G59590	1	21887751	21888792	1041	+	64
AT1G59600	1	21889694	21891962	2268	-	229
AT1G59610	1	21893220	21901086	7866	+	1973
AT1G59620	1	21902283	21905685	3402	+	497
AT1G59630	1	21907176	21907955	779	-	0
AT1G59640	1	21909174	21911201	2027	-	84
AT1G59650	1	21919744	21922923	3179	+	266
AT1G59660	1	21924692	21929424	4732	+	271
AT1G59670	1	21930009	21931366	1357	+	0
AT1G59675	1	21931832	21932403	571	-	0
AT1G59680	1	21933020	21934216	1196	+	0
AT1G59690	1	21935309	21935820	511	-	0
AT1G59700	1	21936295	21937959	1664	+	593
AT1G59710	1	21938366	21940184	1818	+	304
AT1G59720	1	21939751	21941784	2033	-	149
AT1G59722	1	21944688	21945221	533	-	0
AT1G59725	1	21950737	21952210	1473	+	3
AT1G59730	1	21952633	21953456	823	-	0
AT1G59740	1	21968070	21972411	4341	+	180
AT1G59750	1	21979288	21984433	5145	+	1399
AT1G59760	1	21984444	21990175	5731	-	688
AT1G59770	1	21991526	21992653	1127	-	0
AT1G59780	1	21993580	21997691	4111	-	3
AT1G59790	1	22001503	22003385	1882	+	3
AT1G59800	1	22004963	22006172	1209	+	0
AT1G59810	1	22008603	22009455	852	+	0
AT1G59820	1	22011327	22020294	8967	+	717
AT1G59830	1	22020518	22022484	1966	-	766
AT1G59833	1	22023336	22023714	378	+	0
AT1G59835	1	22025040	22025421	381	-	0
AT1G59840	1	22026506	22029379	2873	+	690
AT1G59850	1	22028508	22030207	1699	-	30
AT1G59860	1	22031412	22032132	720	+	21
AT1G59865	1	22032312	22033297	985	-	11
AT1G59870	1	22034505	22040038	5533	+	4241
AT1G59880	1	22040611	22040683	72	-	0
AT1G59885	1	22042307	22042815	508	+	0
AT1G59890	1	22043828	22051086	7258	+	889
AT1G59900	1	22051294	22053885	2591	+	2596
AT1G59910	1	22053950	22057052	3102	-	383
AT1G59920	1	22059423	22059822	399	-	3
AT1G59930	1	22061082	22061481	399	-	7
AT1G59940	1	22065616	22066973	1357	-	0
AT1G59950	1	22068032	22070588	2556	-	0
AT1G59960	1	22071291	22073147	1856	-	259
AT1G59970	1	22073533	22074876	1343	+	186
AT1G59980	1	22080788	22083651	2863	+	199
AT1G59990	1	22090237	22093060	2823	-	686
AT1G60000	1	22093568	22094626	1058	-	3457
AT1G60010	1	22095359	22096577	1218	-	1023
AT1G60020	1	22100743	22105125	4382	-	0
AT1G60025	1	22107345	22107456	111	+	0
AT1G60030	1	22113840	22116845	3005	-	44
AT1G60040	1	22119074	22119929	855	-	0
AT1G60050	1	22121549	22123702	2153	-	0
AT1G60060	1	22139183	22141790	2607	+	75
AT1G60070	1	22142603	22149527	6924	-	1931
AT1G60072	1	22149717	22149843	126	+	0
AT1G60073	1	22149935	22150033	98	+	0
AT1G60075	1	22150915	22152139	1224	+	0
AT1G60080	1	22152229	22154589	2360	-	128
AT1G60090	1	22155581	22158065	2484	+	7
AT1G60095	1	22160098	22162419	2321	+	1
AT1G60110	1	22168501	22170649	2148	+	9
AT1G60120	1	22171632	22172685	1053	-	0
AT1G60130	1	22174178	22176321	2143	+	0
AT1G60140	1	22176933	22180875	3942	-	498
AT1G60150	1	22182518	22183143	625	-	0
AT1G60160	1	22188113	22191395	3282	-	1081
AT1G60170	1	22192772	22195400	2628	+	960
AT1G60180	1	22195524	22196685	1161	-	0
AT1G60190	1	22198402	22200678	2276	+	171
AT1G60200	1	22200732	22205288	4556	-	2055
AT1G60220	1	22208331	22212171	3840	+	664
AT1G60230	1	22212083	22214424	2341	-	618
AT1G60240	1	22215196	22216030	834	-	0
AT1G60250	1	22217076	22217832	756	-	0
AT1G60260	1	22218787	22221409	2622	-	557
AT1G60270	1	22221676	22224257	2581	-	319
AT1G60280	1	22226884	22227928	1044	-	0
AT1G60290	1	22228699	22228977	278	-	0
AT1G60300	1	22229779	22230748	969	-	0
AT1G60310	1	22231187	22232737	1550	-	0
AT1G60320	1	22235090	22235606	516	+	0
AT1G60330	1	22238007	22238362	355	-	0
AT1G60340	1	22238733	22240399	1666	-	0
AT1G60350	1	22241272	22242235	963	-	0
AT1G60360	1	22242747	22243731	984	-	17
AT1G60370	1	22244962	22245814	852	+	0
AT1G60380	1	22246454	22247411	957	-	0
AT1G60390	1	22247473	22249636	2163	-	147
AT1G60400	1	22254404	22255798	1394	+	0
AT1G60410	1	22258981	22260715	1734	+	0
AT1G60420	1	22261887	22264408	2521	+	728
AT1G60430	1	22264384	22266038	1654	-	286
AT1G60440	1	22266496	22269243	2747	-	345
AT1G60450	1	22271225	22273214	1989	-	0
AT1G60460	1	22275483	22279007	3524	+	37
AT1G60470	1	22278974	22280586	1612	-	0
AT1G60480	1	22284121	22285076	955	-	0
AT1G60490	1	22285571	22290315	4744	-	964
AT1G60500	1	22291581	22293964	2383	+	0
AT1G60505	1	22294383	22297220	2837	-	17
AT1G60510	1	22294721	22297139	2418	+	2
AT1G60520	1	22297972	22298736	764	+	0
AT1G60525	1	22299525	22301343	1818	-	90
AT1G60530	1	22299796	22301167	1371	+	2
AT1G60540	1	22302485	22304985	2500	-	0
AT1G60545	1	22302491	22305156	2665	+	3
AT1G60550	1	22305830	22308229	2399	-	2262
AT1G60560	1	22308548	22311350	2802	-	238
AT1G60570	1	22311835	22312981	1146	+	0
AT1G60580	1	22313413	22313484	71	-	0
AT1G60590	1	22314169	22316970	2801	-	2032
AT1G60600	1	22324644	22327359	2715	-	1169
AT1G60610	1	22327911	22330276	2365	-	115
AT1G60620	1	22331105	22333524	2419	+	155
AT1G60625	1	22333915	22334161	246	+	0
AT1G60630	1	22334661	22336908	2247	-	121
AT1G60640	1	22337374	22339672	2298	-	300
AT1G60650	1	22339808	22342337	2529	+	255
AT1G60660	1	22342413	22343014	601	-	223
AT1G60670	1	22343654	22347624	3970	+	280
AT1G60680	1	22347621	22349297	1676	-	7
AT1G60690	1	22349891	22351668	1777	-	356
AT1G60700	1	22351831	22354472	2641	-	112
AT1G60710	1	22354752	22356761	2009	-	2211
AT1G60720	1	22357071	22357941	870	+	1
AT1G60730	1	22358034	22360184	2150	-	225
AT1G60740	1	22361073	22361952	879	+	0
AT1G60750	1	22362292	22363854	1562	-	0
AT1G60760	1	22365831	22366323	492	+	0
AT1G60770	1	22366700	22368714	2014	-	428
AT1G60780	1	22368952	22372159	3207	-	1588
AT1G60783	1	22374908	22375846	938	+	0
AT1G60790	1	22380037	22382245	2208	-	470
AT1G60800	1	22383452	22387457	4005	-	2088
AT1G60810	1	22388526	22391165	2639	-	435
AT1G60815	1	22392728	22392974	246	+	0
AT1G60820	1	22394636	22394707	71	-	0
AT1G60830	1	22395057	22395603	546	-	0
AT1G60835	1	22396665	22396913	248	+	0
AT1G60840	1	22397591	22397662	71	-	0
AT1G60850	1	22397915	22400362	2447	-	149
AT1G60860	1	22400926	22407777	6851	-	384
AT1G60870	1	22409471	22410654	1183	+	975
AT1G60880	1	22411574	22412180	606	+	0
AT1G60890	1	22412245	22417244	4999	-	329
AT1G60900	1	22423908	22428022	4114	+	1147
AT1G60910	1	22428166	22428237	71	+	0
AT1G60913	1	22428604	22428844	240	-	0
AT1G60920	1	22429691	22430267	576	-	0
AT1G60930	1	22430846	22438877	8031	-	115
AT1G60940	1	22439122	22442217	3095	-	1713
AT1G60950	1	22444389	22445222	833	+	56938
AT1G60960	1	22445309	22447214	1905	-	646
AT1G60970	1	22447847	22449526	1679	-	1
AT1G60980	1	22452572	22454140	1568	+	0
AT1G60983	1	22455319	22455589	270	+	0
AT1G60985	1	22456748	22457321	573	+	0
AT1G60986	1	22458999	22459650	651	+	0
AT1G60987	1	22460376	22461164	788	+	2
AT1G60989	1	22462159	22462721	562	+	92
AT1G60990	1	22462025	22465424	3399	-	930
AT1G60995	1	22465639	22470716	5077	-	498
AT1G61000	1	22470923	22474105	3182	-	196
AT1G61010	1	22474297	22477731	3434	-	745
AT1G61020	1	22477772	22477846	74	-	0
AT1G61030	1	22477895	22482380	4485	+	340
AT1G61040	1	22483206	22485969	2763	+	468
AT1G61050	1	22486735	22488284	1549	+	4
AT1G61060	1	22488547	22489711	1164	-	0
AT1G61065	1	22490243	22491461	1218	-	104
AT1G61070	1	22491732	22492542	810	-	0
AT1G61080	1	22493193	22497019	3826	-	0
AT1G61090	1	22499316	22500331	1015	-	0
AT1G61093	1	22501884	22502941	1057	-	0
AT1G61095	1	22504513	22505511	998	-	0
AT1G61097	1	22506918	22507947	1029	-	0
AT1G61100	1	22508537	22512333	3796	-	1261
AT1G61105	1	22513584	22514492	908	-	0
AT1G61110	1	22516601	22518287	1686	+	0
AT1G61120	1	22523636	22528811	5175	+	0
AT1G61130	1	22529023	22531784	2761	-	0
AT1G61140	1	22534716	22540850	6134	-	592
AT1G61150	1	22542523	22544644	2121	+	837
AT1G61160	1	22544867	22546230	1363	-	0
AT1G61165	1	22548135	22548243	108	+	0
AT1G61170	1	22549637	22550675	1038	+	134
AT1G61180	1	22551331	22554649	3318	+	346
AT1G61190	1	22557601	22560687	3086	+	1793
AT1G61200	1	22563032	22563420	388	-	0
AT1G61210	1	22564494	22571907	7413	+	1205
AT1G61215	1	22572644	22575527	2883	+	111
AT1G61224	1	22577112	22577219	107	+	0
AT1G61226	1	22577416	22577691	275	+	0
AT1G61230	1	22578950	22580781	1831	+	1
AT1G61240	1	22581465	22585212	3747	+	416
AT1G61250	1	22585837	22588969	3132	+	761
AT1G61255	1	22589150	22589691	541	-	5
AT1G61260	1	22593464	22595069	1605	-	83
AT1G61270	1	22599664	22602140	2476	-	2
AT1G61275	1	22603120	22603295	175	+	4
AT1G61280	1	22603585	22604081	496	+	23
AT1G61290	1	22605008	22606216	1208	+	1
AT1G61300	1	22607465	22610273	2808	-	1032
AT1G61310	1	22613062	22615943	2881	-	157
AT1G61320	1	22617369	22619853	2484	+	0
AT1G61330	1	22622974	22624527	1553	+	0
AT1G61340	1	22628264	22630009	1745	+	55
AT1G61350	1	22633881	22635894	2013	+	447
AT1G61353	1	22636594	22636768	174	-	0
AT1G61360	1	22637727	22641825	4098	-	56
AT1G61370	1	22642095	22645147	3052	-	33
AT1G61380	1	22646071	22649521	3450	-	207
AT1G61390	1	22650337	22654395	4058	-	11
AT1G61400	1	22654595	22657774	3179	-	33
AT1G61410	1	22658551	22659461	910	-	6
AT1G61415	1	22659630	22660967	1337	+	6
AT1G61420	1	22660459	22663963	3504	-	29
AT1G61430	1	22664668	22668360	3692	-	202
AT1G61440	1	22669244	22672323	3079	-	5
AT1G61450	1	22673258	22673993	735	+	45
AT1G61460	1	22674197	22677713	3516	-	23
AT1G61470	1	22678184	22679021	837	+	15
AT1G61475	1	22679769	22680771	1002	-	0
AT1G61480	1	22681315	22684475	3160	-	0
AT1G61490	1	22685153	22688267	3114	-	45
AT1G61500	1	22689728	22692881	3153	-	155
AT1G61510	1	22694840	22697374	2534	-	0
AT1G61520	1	22699714	22701383	1669	+	156509
AT1G61540	1	22702497	22703706	1209	+	0
AT1G61542	1	22704009	22704396	387	+	0
AT1G61550	1	22704197	22707826	3629	-	3
AT1G61560	1	22708603	22712210	3607	-	16
AT1G61563	1	22714920	22715448	528	-	0
AT1G61566	1	22717059	22717610	551	-	0
AT1G61570	1	22718704	22719516	812	-	355
AT1G61575	1	22720077	22720567	490	+	8
AT1G61580	1	22720691	22723152	2461	-	382
AT1G61590	1	22723500	22726074	2574	-	0
AT1G61600	1	22729815	22731182	1367	+	196
AT1G61610	1	22733471	22736509	3038	+	29
AT1G61620	1	22737542	22739430	1888	+	606
AT1G61630	1	22744206	22746111	1905	+	0
AT1G61640	1	22746371	22749184	2813	-	141
AT1G61650	1	22750964	22751562	598	-	1
AT1G61660	1	22753714	22756300	2586	-	1048
AT1G61665	1	22701489	22701746	257	-	1
AT1G61667	1	22767662	22768501	839	+	53
AT1G61670	1	22770028	22772426	2398	+	468
AT1G61680	1	22772314	22774720	2406	-	6
AT1G61685	1	22778206	22778323	117	-	0
AT1G61688	1	22780732	22781388	656	-	0
AT1G61690	1	22782606	22786859	4253	-	540
AT1G61700	1	22787011	22788333	1322	+	0
AT1G61710	1	22788858	22790576	1718	-	7
AT1G61720	1	22791167	22792800	1633	-	0
AT1G61730	1	22793218	22794703	1485	-	332
AT1G61732	1	22795617	22795735	118	+	0
AT1G61740	1	22798068	22801073	3005	-	2158
AT1G61750	1	22804612	22806318	1706	-	0
AT1G61760	1	22807439	22808114	675	-	33
AT1G61770	1	22810164	22812607	2443	+	478
AT1G61780	1	22812614	22814153	1539	-	725
AT1G61790	1	22814389	22815430	1041	+	1234
AT1G61795	1	22819631	22821029	1398	+	178
AT1G61800	1	22824439	22826774	2335	+	20
AT1G61810	1	22830014	22834728	4714	+	10
AT1G61820	1	22835077	22838615	3538	+	85
AT1G61830	1	22839991	22841860	1869	+	21
AT1G61840	1	22847388	22849833	2445	+	0
AT1G61850	1	22856187	22862359	6172	+	812
AT1G61860	1	22862856	22864619	1763	-	7
AT1G61870	1	22865003	22866615	1612	-	387
AT1G61880	1	22866757	22866829	72	-	0
AT1G61890	1	22867769	22871280	3511	-	509
AT1G61900	1	22882214	22885053	2839	-	739
AT1G61910	1	22887089	22887169	80	+	0
AT1G61920	1	22888451	22889037	586	+	0
AT1G61930	1	22893100	22893976	876	+	37
AT1G61940	1	22897398	22898575	1177	-	0
AT1G61950	1	22899416	22901946	2530	+	0
AT1G61960	1	22902149	22903837	1688	+	143
AT1G61970	1	22904485	22907630	3145	+	196
AT1G61980	1	22908044	22909588	1544	+	164
AT1G61990	1	22911204	22912935	1731	+	325
AT1G62000	1	22913440	22914146	706	+	1
AT1G62010	1	22915744	22917330	1586	+	72
AT1G62020	1	22919533	22924024	4491	+	1641
AT1G62030	1	22924249	22926598	2349	-	202
AT1G62035	1	22930088	22930204	116	-	2
AT1G62040	1	22932759	22934549	1790	+	622
AT1G62045	1	22934687	22935343	656	-	52
AT1G62050	1	22936126	22939024	2898	-	228
AT1G62055	1	22940330	22940864	534	-	0
AT1G62060	1	22941568	22942300	732	-	0
AT1G62070	1	22943593	22944289	696	+	0
AT1G62075	1	22944720	22945242	522	-	0
AT1G62080	1	22946241	22946949	708	-	0
AT1G62085	1	22948756	22950142	1386	-	113
AT1G62090	1	22950680	22955118	4438	-	2
AT1G62095	1	22955925	22956483	558	-	0
AT1G62110	1	22957875	22959711	1836	-	64
AT1G62120	1	22960190	22961779	1589	-	97
AT1G62130	1	22962339	22968920	6581	-	258
AT1G62150	1	22970028	22971764	1736	-	71
AT1G62160	1	22972351	22973303	952	+	0
AT1G62170	1	22973839	22975754	1915	+	0
AT1G62180	1	22975529	22977625	2096	-	6445
AT1G62181	1	22977711	22977813	102	+	4
AT1G62190	1	22980975	22982007	1032	+	3
AT1G62200	1	22982035	22984359	2324	-	563
AT1G62210	1	22986001	22986861	860	+	0
AT1G62214	1	22987482	22987938	456	-	0
AT1G62220	1	22988195	22988844	649	+	0
AT1G62225	1	22989549	22990341	792	-	2
AT1G62230	1	22990974	22991679	705	-	0
AT1G62240	1	22994582	22995471	889	+	2
AT1G62250	1	22995436	22997613	2177	-	1829
AT1G62260	1	22997825	22999796	1971	-	32
AT1G62262	1	23000156	23002093	1937	-	0
AT1G62270	1	23004498	23005650	1152	+	0
AT1G62280	1	23007146	23008585	1439	-	0
AT1G62290	1	23009910	23013529	3619	-	253
AT1G62300	1	23016682	23019279	2597	-	118
AT1G62301	1	23020514	23020685	171	-	0
AT1G62305	1	23026775	23029339	2564	-	74
AT1G62310	1	23036038	23039609	3571	-	516
AT1G62320	1	23041667	23044855	3188	-	1
AT1G62330	1	23046892	23050193	3301	+	750
AT1G62333	1	23050444	23050940	496	+	1
AT1G62340	1	23051001	23055672	4671	-	0
AT1G62350	1	23056652	23058114	1462	+	18
AT1G62355	1	23058033	23058156	123	+	2
AT1G62360	1	23058581	23061722	3141	-	125
AT1G62370	1	23072574	23073189	615	+	27
AT1G62380	1	23082169	23084253	2084	+	4823
AT1G62390	1	23084292	23087127	2835	-	2625
AT1G62400	1	23090242	23091589	1347	+	62
AT1G62410	1	23092914	23093869	955	+	0
AT1G62420	1	23102792	23104647	1855	-	0
AT1G62421	1	23099483	23099889	406	+	0
AT1G62422	1	23100138	23101033	895	-	188
AT1G62430	1	23105940	23109476	3536	-	717
AT1G62440	1	23111817	23115293	3476	+	0
AT1G62450	1	23115957	23117370	1413	-	0
AT1G62460	1	23118656	23123058	4402	+	0
AT1G62480	1	23128704	23129759	1055	+	3053
AT1G62490	1	23130404	23131533	1129	-	3
AT1G62500	1	23132044	23133502	1458	+	465
AT1G62510	1	23136368	23137191	823	-	3037
AT1G62520	1	23144411	23145509	1098	+	171
AT1G62530	1	23146331	23148367	2036	-	0
AT1G62540	1	23151793	23155717	3924	+	150
AT1G62550	1	23156930	23157297	367	+	0
AT1G62560	1	23159822	23162649	2827	+	2316
AT1G62570	1	23169135	23172105	2970	+	362
AT1G62580	1	23173332	23176931	3599	+	6
AT1G62590	1	23176929	23179248	2319	-	83
AT1G62600	1	23179476	23181519	2043	+	522
AT1G62610	1	23181462	23183227	1765	-	88
AT1G62620	1	23182643	23184991	2348	+	1
AT1G62630	1	23185911	23188593	2682	+	490
AT1G62640	1	23192227	23195103	2876	+	861
AT1G62650	1	23195352	23195721	369	+	0
AT1G62660	1	23199717	23203765	4048	+	405
AT1G62670	1	23204772	23206665	1893	-	72
AT1G62680	1	23207089	23209913	2824	-	101
AT1G62690	1	23210440	23211389	949	-	1
AT1G62695	1	23211744	23212724	980	+	0
AT1G62700	1	23216217	23217916	1699	-	33
AT1G62710	1	23223873	23226916	3043	-	388
AT1G62720	1	23227531	23229150	1619	+	12
AT1G62730	1	23229058	23230736	1678	-	62
AT1G62740	1	23230955	23233543	2588	+	1201
AT1G62750	1	23233433	23236447	3014	-	19991
AT1G62760	1	23237573	23238512	939	-	7
AT1G62766	1	23240660	23242889	2229	-	0
AT1G62770	1	23245885	23246890	1005	-	25
AT1G62780	1	23249144	23251105	1961	-	3912
AT1G62790	1	23252312	23253743	1431	+	348
AT1G62800	1	23253702	23257463	3761	-	504
AT1G62810	1	23257725	23261966	4241	-	484
AT1G62820	1	23263670	23264349	679	-	345
AT1G62830	1	23264489	23267202	2713	-	298
AT1G62835	1	23267975	23268534	559	-	27
AT1G62840	1	23271415	23272578	1163	+	6
AT1G62850	1	23271702	23274302	2600	-	587
AT1G62860	1	23274675	23277017	2342	-	108
AT1G62863	1	23279165	23279333	168	+	0
AT1G62870	1	23284011	23286760	2749	-	87
AT1G62880	1	23291928	23295266	3338	+	126
AT1G62886	1	23294412	23294710	298	+	0
AT1G62890	1	23294976	23295564	588	+	0
AT1G62900	1	23297719	23298682	963	+	3
AT1G62910	1	23299056	23300958	1902	+	13
AT1G62914	1	23301575	23303162	1587	+	83
AT1G62920	1	23304312	23306374	2062	+	39
AT1G62930	1	23306533	23308683	2150	+	90
AT1G62935	1	23308879	23309410	531	-	4
AT1G62940	1	23310534	23312747	2213	+	0
AT1G62950	1	23315293	23318234	2941	+	216
AT1G62960	1	23318186	23320316	2130	-	2016
AT1G62970	1	23323316	23326053	2737	+	224
AT1G62975	1	23328849	23330776	1927	+	37
AT1G62978	1	23331461	23331608	147	-	0
AT1G62980	1	23331675	23333110	1435	+	0
AT1G62981	1	23333631	23335395	1764	+	35
AT1G62990	1	23337364	23340688	3324	+	60
AT1G63000	1	23342392	23344113	1721	+	1451
AT1G63005	1	23345376	23345511	135	-	0
AT1G63010	1	23347560	23352697	5137	-	971
AT1G63020	1	23354684	23362564	7880	-	319
AT1G63030	1	23367406	23368410	1004	-	0
AT1G63040	1	23371326	23372073	747	+	0
AT1G63050	1	23375883	23378291	2408	-	359
AT1G63055	1	23379664	23380669	1005	+	1
AT1G63057	1	23379664	23382989	3325	+	1
AT1G63060	1	23384042	23385042	1000	+	0
AT1G63070	1	23385323	23387167	1844	-	2
AT1G63080	1	23387630	23390816	3186	-	71
AT1G63090	1	23391062	23392851	1789	-	611
AT1G63100	1	23399390	23401367	1977	-	287
AT1G63105	1	23404140	23404509	369	+	0
AT1G63110	1	23404820	23408052	3232	+	553
AT1G63120	1	23408875	23410815	1940	-	367
AT1G63130	1	23412729	23415149	2420	+	180
AT1G63140	1	23417493	23419007	1514	+	2
AT1G63150	1	23419395	23421579	2184	+	61
AT1G63160	1	23421863	23423828	1965	-	130
AT1G63170	1	23425351	23427311	1960	+	712
AT1G63180	1	23427408	23429603	2195	-	90
AT1G63190	1	23431834	23433002	1168	+	0
AT1G63200	1	23433629	23434600	971	-	0
AT1G63205	1	23437688	23438677	989	-	0
AT1G63206	1	23439641	23440931	1290	+	0
AT1G63210	1	23443687	23447354	3667	+	0
AT1G63220	1	23448918	23450452	1534	+	169
AT1G63230	1	23450653	23452311	1658	+	64
AT1G63240	1	23456020	23458661	2641	-	540
AT1G63245	1	23460528	23460771	243	-	2
AT1G63250	1	23463068	23466451	3383	-	76
AT1G63260	1	23466745	23469204	2459	-	376
AT1G63270	1	23469663	23471237	1574	-	106
AT1G63280	1	23471342	23471705	363	+	1
AT1G63290	1	23471848	23473639	1791	-	729
AT1G63295	1	23474068	23475532	1464	-	91
AT1G63300	1	23482192	23486220	4028	+	222
AT1G63310	1	23486306	23487085	779	-	192
AT1G63320	1	23488883	23489530	647	-	4
AT1G63330	1	23489839	23491519	1680	+	0
AT1G63340	1	23491881	23494019	2138	-	0
AT1G63350	1	23494934	23497631	2697	-	85
AT1G63360	1	23499514	23502169	2655	-	890
AT1G63370	1	23503204	23505358	2154	-	1
AT1G63380	1	23505556	23506504	948	+	11
AT1G63390	1	23506506	23506983	477	-	9
AT1G63400	1	23507319	23509053	1734	+	27
AT1G63410	1	23510074	23511997	1923	-	0
AT1G63420	1	23515873	23518910	3037	+	543
AT1G63430	1	23522496	23526832	4336	+	807
AT1G63440	1	23527654	23531109	3455	+	102
AT1G63450	1	23531408	23534569	3161	+	0
AT1G63460	1	23535015	23536467	1452	+	316
AT1G63470	1	23536518	23539220	2702	-	416
AT1G63480	1	23539556	23542137	2581	-	137
AT1G63490	1	23544655	23552030	7375	-	547
AT1G63500	1	23555685	23558899	3214	+	585
AT1G63510	1	23559186	23559258	72	-	0
AT1G63520	1	23559886	23562143	2257	+	15
AT1G63522	1	23562204	23562482	278	-	0
AT1G63530	1	23563314	23565555	2241	+	93
AT1G63535	1	23566044	23566227	183	-	0
AT1G63540	1	23566957	23569495	2538	+	2
AT1G63550	1	23569537	23571107	1570	+	0
AT1G63560	1	23573093	23574278	1185	+	0
AT1G63570	1	23575449	23576304	855	+	15
AT1G63580	1	23577332	23578254	922	+	40
AT1G63590	1	23579895	23580702	807	+	0
AT1G63600	1	23581711	23582624	913	+	0
AT1G63610	1	23583520	23585727	2207	-	1343
AT1G63630	1	23587004	23588421	1417	+	19
AT1G63640	1	23589042	23595821	6779	-	592
AT1G63650	1	23599412	23602902	3490	+	132
AT1G63660	1	23603934	23607275	3341	-	452
AT1G63670	1	23607421	23610653	3232	-	431
AT1G63680	1	23614436	23617767	3331	+	1143
AT1G63690	1	23618377	23622396	4019	+	1526
AT1G63700	1	23624665	23629112	4447	-	990
AT1G63710	1	23632177	23633942	1765	-	77
AT1G63720	1	23635855	23637529	1674	-	46
AT1G63730	1	23641769	23645132	3363	+	48
AT1G63740	1	23645428	23648973	3545	+	201
AT1G63750	1	23650847	23655363	4516	+	149
AT1G63760	1	23655712	23657612	1900	+	0
AT1G63770	1	23657505	23664677	7172	-	8659
AT1G63780	1	23664833	23667367	2534	-	254
AT1G63790	1	23667484	23667556	72	-	0
AT1G63800	1	23667615	23669080	1465	-	1097
AT1G63810	1	23669531	23675898	6367	-	337
AT1G63820	1	23682421	23684367	1946	-	10
AT1G63830	1	23685092	23687363	2271	+	377
AT1G63835	1	23688963	23689443	480	-	1
AT1G63840	1	23689696	23690807	1111	-	141
AT1G63850	1	23696961	23698708	1747	+	679
AT1G63855	1	23699368	23700967	1599	-	125
AT1G63860	1	23701483	23706005	4522	-	150
AT1G63870	1	23707130	23711901	4771	-	0
AT1G63880	1	23712275	23716124	3849	-	1160
AT1G63900	1	23716642	23719337	2695	+	624
AT1G63910	1	23719782	23721774	1992	-	4
AT1G63920	1	23726505	23727581	1076	+	0
AT1G63930	1	23727890	23729333	1443	+	6
AT1G63940	1	23729978	23733892	3914	+	1919
AT1G63950	1	23734996	23735556	560	+	0
AT1G63960	1	23738200	23738506	306	+	4
AT1G63970	1	23738690	23740364	1674	-	2401
AT1G63980	1	23740515	23743302	2787	+	1311
AT1G63990	1	23742841	23745374	2533	-	5
AT1G64000	1	23747303	23749053	1750	+	0
AT1G64010	1	23750883	23751441	558	-	1
AT1G64020	1	23751755	23752121	366	-	1
AT1G64030	1	23752872	23754348	1476	-	0
AT1G64035	1	23755495	23757736	2241	-	0
AT1G64040	1	23758282	23760558	2276	-	911
AT1G64050	1	23762352	23766168	3816	+	667
AT1G64060	1	23769773	23776931	7158	+	486
AT1G64065	1	23778352	23779529	1177	+	44
AT1G64070	1	23779948	23783449	3501	+	3
AT1G64080	1	23785020	23786800	1780	-	162
AT1G64090	1	23789061	23790976	1915	+	1410
AT1G64100	1	23791584	23795563	3979	+	13
AT1G64105	1	23795049	23795642	593	+	1
AT1G64107	1	23796202	23796555	353	-	2
AT1G64110	1	23796718	23801725	5007	-	7
AT1G64120	1	23802552	23802636	84	+	0
AT1G64130	1	23802558	23803533	975	+	0
AT1G64140	1	23803792	23807159	3367	-	0
AT1G64142	1	23803792	23807159	3367	-	0
AT1G64150	1	23808908	23812677	3769	-	1488
AT1G64160	1	23814009	23814839	830	+	0
AT1G64170	1	23815238	23818293	3055	-	21
AT1G64180	1	23821515	23824359	2844	+	153
AT1G64185	1	23824513	23825383	870	+	28
AT1G64190	1	23825327	23827136	1809	-	1015
AT1G64195	1	23827710	23828048	338	-	0
AT1G64200	1	23828525	23830002	1477	-	333
AT1G64210	1	23831032	23832863	1831	+	6
AT1G64220	1	23833087	23833321	234	-	8
AT1G64230	1	23833550	23835536	1986	+	3341
AT1G64235	1	23836248	23836620	372	+	0
AT1G64240	1	23837560	23839897	2337	+	0
AT1G64250	1	23840887	23843251	2364	+	32
AT1G64255	1	23844953	23847206	2253	+	0
AT1G64260	1	23847755	23849915	2160	+	16
AT1G64270	1	23850571	23852785	2214	+	211
AT1G64280	1	23852747	23855566	2819	-	654
AT1G64290	1	23857177	23858488	1311	-	0
AT1G64295	1	23859553	23860624	1071	-	0
AT1G64300	1	23863065	23866045	2980	+	60
AT1G64310	1	23866052	23867711	1659	+	11
AT1G64320	1	23869035	23870548	1513	+	14
AT1G64330	1	23870904	23874198	3294	+	553
AT1G64340	1	23878124	23881073	2949	+	0
AT1G64350	1	23881511	23883297	1786	+	383
AT1G64355	1	23886083	23887212	1129	+	1137
AT1G64360	1	23887869	23888533	664	+	856
AT1G64370	1	23888919	23889661	742	+	14477
AT1G64380	1	23890645	23892173	1528	-	91
AT1G64385	1	23900034	23902281	2247	+	369
AT1G64390	1	23911118	23915229	4111	+	3356
AT1G64400	1	23915597	23919783	4186	-	967
AT1G64405	1	23923731	23924336	605	+	16
AT1G64410	1	23926392	23932203	5811	-	0
AT1G64420	1	23933136	23933209	73	+	0
AT1G64430	1	23933379	23936867	3488	+	2104
AT1G64440	1	23937029	23939899	2870	+	566
AT1G64450	1	23941597	23942846	1249	-	132
AT1G64460	1	23943498	23944680	1182	-	110
AT1G64470	1	23944721	23945772	1051	-	108
AT1G64480	1	23948027	23949751	1724	-	0
AT1G64490	1	23952132	23952713	581	+	116
AT1G64500	1	23953232	23954492	1260	+	2387
AT1G64510	1	23954802	23956255	1453	-	8336
AT1G64520	1	23956385	23958322	1937	+	1653
AT1G64530	1	23959660	23963081	3421	+	501
AT1G64540	1	23966908	23968425	1517	+	3
AT1G64550	1	23968778	23973614	4836	+	1372
AT1G64560	1	23973728	23974177	449	+	27
AT1G64561	1	23974040	23974775	735	-	24
AT1G64563	1	23975084	23978335	3251	-	38
AT1G64570	1	23978867	23983925	5058	+	737
AT1G64572	1	23984010	23984795	785	+	98
AT1G64580	1	23984789	23986731	1942	-	125
AT1G64583	1	23987050	23988740	1690	-	25
AT1G64585	1	23989932	23990097	165	-	0
AT1G64590	1	23993532	23995509	1977	+	0
AT1G64600	1	23995970	23998720	2750	+	81
AT1G64610	1	23998724	24001950	3226	-	149
AT1G64618	1	24005899	24006393	494	+	1
AT1G64620	1	24006991	24008694	1703	+	210
AT1G64625	1	24016642	24019271	2629	+	71
AT1G64628	1	24019489	24022310	2821	+	0
AT1G64630	1	24019489	24022310	2821	+	0
AT1G64640	1	24022284	24023196	912	-	304
AT1G64650	1	24023497	24026421	2924	-	1567
AT1G64660	1	24028917	24030780	1863	+	487
AT1G64670	1	24030819	24033556	2737	-	458
AT1G64680	1	24036020	24037401	1381	+	4112
AT1G64690	1	24038033	24039177	1144	+	62
AT1G64700	1	24039809	24040595	786	-	30
AT1G64710	1	24044544	24046552	2008	+	771
AT1G64720	1	24046552	24048622	2070	-	31332
AT1G64730	1	24048863	24049160	297	+	0
AT1G64740	1	24050005	24052487	2482	+	941
AT1G64750	1	24052361	24053908	1547	-	913
AT1G64760	1	24054142	24056414	2272	-	139
AT1G64770	1	24057062	24059561	2499	+	6747
AT1G64780	1	24060769	24062630	1861	-	1335
AT1G64790	1	24064936	24083428	18492	-	2830
AT1G64800	1	24085085	24085433	348	+	0
AT1G64810	1	24086557	24088538	1981	+	547
AT1G64820	1	24088604	24090558	1954	+	0
AT1G64830	1	24091270	24092566	1296	-	0
AT1G64840	1	24093557	24095399	1842	+	255
AT1G64850	1	24096434	24097650	1216	-	1292
AT1G64860	1	24097912	24100952	3040	+	6483
AT1G64870	1	24102916	24103831	915	+	0
AT1G64880	1	24105641	24109146	3505	+	848
AT1G64890	1	24109541	24111400	1859	+	103
AT1G64900	1	24113214	24114984	1770	+	1763
AT1G64910	1	24115136	24116747	1611	-	0
AT1G64920	1	24117439	24118798	1359	-	0
AT1G64930	1	24120925	24122461	1536	+	1
AT1G64940	1	24123788	24125324	1536	+	3
AT1G64950	1	24127560	24129458	1898	+	478
AT1G64960	1	24129917	24134204	4287	+	261
AT1G64970	1	24134084	24136109	2025	-	2069
AT1G64980	1	24137516	24139276	1760	-	937
AT1G64990	1	24139906	24146189	6283	-	449
AT1G65000	1	24147043	24148689	1646	+	72
AT1G65010	1	24149542	24154274	4732	+	2048
AT1G65020	1	24154343	24156605	2262	-	354
AT1G65030	1	24156769	24158675	1906	+	173
AT1G65032	1	24158649	24159585	936	-	59
AT1G65040	1	24159833	24163628	3795	-	822
AT1G65050	1	24164285	24165679	1394	-	0
AT1G65060	1	24167201	24171502	4301	-	496
AT1G65070	1	24172898	24176310	3412	-	790
AT1G65080	1	24176581	24180871	4290	+	38
AT1G65090	1	24180829	24183300	2471	-	1
AT1G65110	1	24183958	24188330	4372	-	3
AT1G65113	1	24189463	24190026	563	+	0
AT1G65120	1	24191347	24196073	4726	-	15
AT1G65130	1	24196471	24201022	4551	-	6
AT1G65140	1	24201616	24203226	1610	+	0
AT1G65150	1	24203840	24205775	1935	-	141
AT1G65160	1	24206223	24207738	1515	+	0
AT1G65170	1	24209612	24211116	1504	+	0
AT1G65180	1	24211740	24213870	2130	-	19
AT1G65190	1	24215643	24217328	1685	-	1070
AT1G65200	1	24218469	24222789	4320	-	2
AT1G65210	1	24224811	24225815	1004	+	0
AT1G65220	1	24226110	24228970	2860	+	1301
AT1G65230	1	24229147	24230902	1755	+	3482
AT1G65240	1	24230866	24233349	2483	-	6
AT1G65250	1	24234337	24235808	1471	+	77
AT1G65260	1	24236257	24240705	4448	+	6740
AT1G65270	1	24241722	24244991	3269	+	948
AT1G65280	1	24245295	24248762	3467	+	717
AT1G65290	1	24248827	24250421	1594	-	1871
AT1G65295	1	24251510	24252303	793	+	615
AT1G65300	1	24254928	24255765	837	+	1
AT1G65310	1	24257215	24258473	1258	+	66
AT1G65320	1	24259887	24262951	3064	-	673
AT1G65330	1	24266480	24267320	840	-	3
AT1G65340	1	24268134	24269646	1512	-	0
AT1G65342	1	24271275	24271700	425	+	0
AT1G65346	1	24273180	24274038	858	-	0
AT1G65347	1	24274896	24275690	794	+	0
AT1G65350	1	24272517	24277275	4758	-	0
AT1G65352	1	24277771	24278298	527	+	0
AT1G65360	1	24281336	24282151	815	+	0
AT1G65365	1	24282515	24284206	1691	-	0
AT1G65370	1	24284468	24286145	1677	-	1060
AT1G65380	1	24286825	24289249	2424	+	230
AT1G65385	1	24289657	24291024	1367	-	2
AT1G65390	1	24292477	24294631	2154	+	40
AT1G65410	1	24295168	24297595	2427	+	721
AT1G65420	1	24297479	24298570	1091	-	154
AT1G65430	1	24300897	24306236	5339	-	637
AT1G65440	1	24306610	24314620	8010	-	2561
AT1G65450	1	24315813	24319064	3251	+	130
AT1G65470	1	24319669	24324064	4395	-	275
AT1G65480	1	24331427	24333934	2507	+	3
AT1G65481	1	24341025	24341739	714	-	0
AT1G65483	1	24342482	24343731	1249	+	0
AT1G65484	1	24347749	24348609	860	+	1
AT1G65485	1	24346723	24347264	541	+	0
AT1G65486	1	24349522	24350306	784	+	74
AT1G65490	1	24354770	24355351	581	+	1083
AT1G65500	1	24357866	24358616	750	+	23
AT1G65510	1	24359452	24360081	629	+	3
AT1G65520	1	24361031	24361993	962	-	71
AT1G65540	1	24362381	24366011	3630	-	1231
AT1G65541	1	24366309	24366405	96	+	14
AT1G65550	1	24367693	24370800	3107	-	0
AT1G65560	1	24371386	24373798	2412	-	123
AT1G65570	1	24374097	24375846	1749	-	0
AT1G65580	1	24377313	24384079	6766	-	984
AT1G65585	1	24384342	24385178	836	+	0
AT1G65590	1	24385899	24391207	5308	+	1133
AT1G65610	1	24391678	24395360	3682	-	2
AT1G65620	1	24398142	24400969	2827	+	82
AT1G65630	1	24406541	24409068	2527	-	2
AT1G65640	1	24410850	24413527	2677	-	0
AT1G65642	1	24413930	24414970	1040	-	0
AT1G65650	1	24415014	24417709	2695	-	619
AT1G65660	1	24418106	24421292	3186	-	908
AT1G65670	1	24421992	24423953	1961	-	1
AT1G65680	1	24427265	24428399	1134	+	0
AT1G65681	1	24428874	24430670	1796	+	0
AT1G65690	1	24431429	24432953	1524	-	16
AT1G65700	1	24434202	24436294	2092	-	160
AT1G65710	1	24436900	24438542	1642	-	76
AT1G65720	1	24440258	24441073	815	-	1425
AT1G65730	1	24442503	24446291	3788	+	3
AT1G65740	1	24452095	24453211	1116	-	0
AT1G65750	1	24454771	24458439	3668	+	0
AT1G65760	1	24458590	24459715	1125	+	8
AT1G65770	1	24460655	24461738	1083	-	0
AT1G65780	1	24462957	24466888	3931	-	0
AT1G65790	1	24468931	24472329	3398	+	119
AT1G65800	1	24473120	24476715	3595	+	1284
AT1G65810	1	24477042	24480728	3686	-	5
AT1G65820	1	24485100	24486892	1792	+	736
AT1G65830	1	24486991	24487073	82	-	0
AT1G65840	1	24489779	24493024	3245	+	932
AT1G65845	1	24493173	24493798	625	-	44
AT1G65850	1	24494677	24498542	3865	+	0
AT1G65860	1	24499065	24502745	3680	-	886
AT1G65870	1	24503623	24504193	570	+	162
AT1G65875	1	24504724	24506342	1618	-	0
AT1G65880	1	24508632	24510742	2110	-	3
AT1G65890	1	24512456	24514659	2203	-	26
AT1G65900	1	24515836	24518487	2651	-	317
AT1G65907	1	24520174	24520267	93	+	0
AT1G65910	1	24520790	24524164	3374	-	48
AT1G65920	1	24525101	24529294	4193	-	300
AT1G65930	1	24538885	24542129	3244	+	7255
AT1G65940	1	24543651	24544101	450	+	0
AT1G65950	1	24546703	24551144	4441	-	376
AT1G65960	1	24552002	24557730	5728	+	10189
AT1G65970	1	24557371	24558322	951	-	3
AT1G65980	1	24559305	24560936	1631	-	3026
AT1G65985	1	24562552	24568530	5978	-	55
AT1G65990	1	24571602	24573471	1869	-	0
AT1G66000	1	24574343	24575438	1095	+	0
AT1G66010	1	24575697	24576055	358	-	0
AT1G66020	1	24577552	24580185	2633	+	0
AT1G66030	1	24583148	24583652	504	+	0
AT1G66040	1	24583819	24586681	2862	-	0
AT1G66045	1	24588268	24588794	526	+	0
AT1G66050	1	24589486	24592747	3261	+	10
AT1G66060	1	24593914	24595544	1630	-	0
AT1G66070	1	24595773	24598518	2745	-	432
AT1G66080	1	24600216	24601157	941	-	118
AT1G66090	1	24602145	24604763	2618	+	53
AT1G66100	1	24605670	24606537	867	-	3466
AT1G66110	1	24609093	24610232	1139	-	0
AT1G66120	1	24612619	24614805	2186	+	0
AT1G66130	1	24614961	24616930	1969	+	1514
AT1G66140	1	24619836	24622004	2168	-	391
AT1G66145	1	24628529	24628835	306	-	0
AT1G66150	1	24631408	24634749	3341	+	2229
AT1G66160	1	24637195	24638608	1413	+	27
AT1G66170	1	24638684	24641494	2810	-	1
AT1G66173	1	24642585	24644068	1483	+	13
AT1G66180	1	24647187	24648813	1626	+	348
AT1G66190	1	24652794	24653938	1144	-	160
AT1G66200	1	24655209	24657683	2474	-	7591
AT1G66210	1	24665628	24668783	3155	-	0
AT1G66220	1	24670535	24673661	3126	+	0
AT1G66230	1	24677153	24678415	1262	+	176
AT1G66235	1	24683005	24683874	869	-	0
AT1G66240	1	24686255	24687332	1077	-	1660
AT1G66245	1	24690443	24691307	864	+	0
AT1G66250	1	24692893	24695515	2622	+	494
AT1G66260	1	24695639	24698914	3275	-	1721
AT1G66270	1	24699989	24703041	3052	-	0
AT1G66280	1	24706511	24709785	3274	-	1
AT1G66290	1	24713305	24714843	1538	-	0
AT1G66300	1	24716496	24718050	1554	-	2
AT1G66310	1	24722970	24724475	1505	-	0
AT1G66320	1	24726811	24728614	1803	-	0
AT1G66330	1	24729628	24732491	2863	-	3373
AT1G66340	1	24734161	24737756	3595	+	627
AT1G66345	1	24737718	24739353	1635	+	63
AT1G66350	1	24748194	24750043	1849	+	265
AT1G66360	1	24751376	24752834	1458	+	1
AT1G66370	1	24753633	24754604	971	+	0
AT1G66380	1	24757412	24758490	1078	+	0
AT1G66390	1	24763956	24765541	1585	+	11
AT1G66400	1	24770574	24771371	797	-	27
AT1G66410	1	24774216	24775984	1768	-	1903
AT1G66420	1	24777183	24778032	849	+	0
AT1G66430	1	24778270	24780629	2359	+	1607
AT1G66440	1	24782170	24784351	2181	+	0
AT1G66450	1	24786199	24788302	2103	+	6
AT1G66460	1	24789734	24791988	2254	-	22
AT1G66470	1	24795213	24796988	1775	+	0
AT1G66475	1	24801610	24801754	144	-	0
AT1G66480	1	24805634	24807557	1923	-	42
AT1G66490	1	24809420	24810549	1129	-	0
AT1G66500	1	24811148	24812650	1502	-	69
AT1G66510	1	24812836	24816620	3784	+	210
AT1G66520	1	24816127	24818744	2617	-	212
AT1G66530	1	24818910	24822342	3432	-	699
AT1G66534	1	24823253	24823667	414	+	0
AT1G66540	1	24824458	24826670	2212	+	397
AT1G66550	1	24828501	24829639	1138	+	0
AT1G66553	1	24831159	24831270	111	+	0
AT1G66560	1	24833578	24834631	1053	+	0
AT1G66570	1	24835250	24837322	2072	-	0
AT1G66580	1	24839164	24840612	1448	+	2002
AT1G66590	1	24841122	24842411	1289	+	27
AT1G66600	1	24848319	24849364	1045	+	1
AT1G66610	1	24849715	24851450	1735	-	0
AT1G66620	1	24852805	24854153	1348	-	78
AT1G66630	1	24855285	24856714	1429	-	0
AT1G66640	1	24857437	24859011	1574	+	0
AT1G66650	1	24860112	24861821	1709	-	13
AT1G66660	1	24861875	24863368	1493	-	99
AT1G66670	1	24863784	24865702	1918	-	3014
AT1G66680	1	24866094	24868992	2898	-	467
AT1G66690	1	24869553	24870850	1297	-	15
AT1G66700	1	24873290	24874758	1468	-	4
AT1G66710	1	24878864	24880220	1356	-	0
AT1G66720	1	24881179	24882480	1301	+	0
AT1G66725	1	24883930	24884559	629	+	162
AT1G66730	1	24884680	24892046	7366	+	508
AT1G66740	1	24892339	24893766	1427	+	266
AT1G66750	1	24894714	24897253	2539	+	199
AT1G66760	1	24901977	24904443	2466	+	120
AT1G66770	1	24906450	24907236	786	-	0
AT1G66780	1	24909212	24911485	2273	+	4
AT1G66783	1	24913205	24913296	91	-	1
AT1G66790	1	24918011	24918356	345	-	0
AT1G66795	1	24921103	24921194	91	+	0
AT1G66800	1	24924812	24926365	1553	+	2
AT1G66810	1	24927612	24928803	1191	-	31
AT1G66820	1	24930039	24930551	512	+	536
AT1G66830	1	24930664	24932918	2254	-	66
AT1G66840	1	24933855	24936322	2467	-	868
AT1G66850	1	24936957	24937434	477	+	0
AT1G66852	1	24938499	24938832	333	-	0
AT1G66855	1	24939549	24940013	464	-	0
AT1G66860	1	24942187	24944497	2310	+	0
AT1G66870	1	24945483	24946968	1485	-	1
AT1G66880	1	24946927	24955611	8684	+	571
AT1G66890	1	24957557	24958114	557	+	284
AT1G66900	1	24959333	24961616	2283	+	566
AT1G66910	1	24961633	24963946	2313	-	303
AT1G66920	1	24965303	24967522	2219	-	48
AT1G66930	1	24970522	24973069	2547	+	11
AT1G66940	1	24973027	24974791	1764	-	526
AT1G66950	1	24978204	24984619	6415	+	0
AT1G66960	1	24984940	24989797	4857	-	1
AT1G66970	1	24992552	24996117	3565	-	6057
AT1G66980	1	24997308	25001983	4675	-	2449
AT1G66990	1	25002643	25003327	684	-	4
AT1G67000	1	25004108	25007647	3539	-	4
AT1G67010	1	25008797	25009712	915	-	0
AT1G67020	1	25011007	25012987	1980	-	1
AT1G67025	1	25013025	25014725	1700	-	20
AT1G67030	1	25016542	25017512	970	+	4
AT1G67035	1	25018076	25019057	981	+	21
AT1G67040	1	25019104	25022542	3438	-	300
AT1G67050	1	25028626	25029788	1162	-	475
AT1G67060	1	25036615	25039389	2774	+	248
AT1G67070	1	25042134	25044647	2513	+	138
AT1G67080	1	25045224	25046860	1636	-	1019
AT1G67090	1	25048157	25049424	1267	-	457025
AT1G67100	1	25053733	25054847	1114	+	1
AT1G67105	1	25057478	25058264	786	+	23
AT1G67110	1	25061730	25065446	3716	-	1
AT1G67120	1	25069561	25095526	25965	-	724
AT1G67130	1	25099261	25100625	1364	-	0
AT1G67140	1	25100861	25117423	16562	-	1463
AT1G67148	1	25121234	25121898	664	+	0
AT1G67150	1	25122458	25124695	2237	+	0
AT1G67160	1	25124818	25127098	2280	-	0
AT1G67170	1	25127245	25129457	2212	+	219
AT1G67180	1	25129730	25132169	2439	+	85
AT1G67190	1	25132497	25134431	1934	+	184
AT1G67195	1	25137110	25137937	827	-	550
AT1G67200	1	25140264	25140551	287	+	0
AT1G67210	1	25140814	25144043	3229	+	83
AT1G67220	1	25145586	25150558	4972	+	0
AT1G67230	1	25151269	25156323	5054	-	1791
AT1G67238	1	25158114	25158454	340	-	2
AT1G67240	1	25158857	25162322	3465	+	2
AT1G67250	1	25163641	25165056	1415	-	568
AT1G67260	1	25167461	25169307	1846	-	33
AT1G67265	1	25175557	25176202	645	-	3
AT1G67270	1	25183176	25185939	2763	-	0
AT1G67280	1	25188273	25190694	2421	-	6505
AT1G67290	1	25191020	25193237	2217	-	1
AT1G67300	1	25193703	25197089	3386	-	573
AT1G67310	1	25198181	25203126	4945	-	961
AT1G67320	1	25205278	25209033	3755	-	321
AT1G67325	1	25209393	25213253	3860	-	545
AT1G67328	1	25213842	25215050	1208	-	0
AT1G67330	1	25213851	25215174	1323	+	0
AT1G67340	1	25230264	25231840	1576	+	411
AT1G67350	1	25235270	25236878	1608	+	1378
AT1G67360	1	25236810	25238216	1406	-	1017
AT1G67365	1	25238409	25239235	826	+	47
AT1G67370	1	25239116	25243837	4721	-	2
AT1G67390	1	25244689	25247139	2450	+	1
AT1G67400	1	25247987	25250734	2747	-	109
AT1G67410	1	25251192	25253667	2475	-	158
AT1G67420	1	25255231	25260430	5199	+	119
AT1G67430	1	25262158	25263789	1631	+	5651
AT1G67440	1	25263803	25265719	1916	-	796
AT1G67450	1	25266162	25267359	1197	+	0
AT1G67455	1	25268144	25269475	1331	+	0
AT1G67460	1	25269625	25271861	2236	-	17
AT1G67470	1	25272181	25273576	1395	+	97
AT1G67480	1	25276293	25278718	2425	+	2007
AT1G67481	1	25278943	25279207	264	-	0
AT1G67490	1	25280450	25286611	6161	-	523
AT1G67500	1	25287706	25296937	9231	-	314
AT1G67510	1	25297476	25300184	2708	-	139
AT1G67520	1	25302725	25305857	3132	-	45
AT1G67530	1	25307657	25311308	3651	+	515
AT1G67540	1	25311241	25312482	1241	-	0
AT1G67550	1	25312739	25317395	4656	+	721
AT1G67560	1	25319898	25324264	4366	+	726
AT1G67570	1	25325159	25327258	2099	+	56
AT1G67580	1	25327283	25331379	4096	-	843
AT1G67590	1	25333057	25334647	1590	-	386
AT1G67600	1	25336422	25337662	1240	-	21
AT1G67610	1	25339035	25340241	1206	-	0
AT1G67620	1	25340574	25342082	1508	+	155
AT1G67623	1	25342110	25343243	1133	+	0
AT1G67626	1	25343436	25344066	630	-	5
AT1G67630	1	25344439	25348406	3967	-	293
AT1G67635	1	25349341	25350384	1043	+	0
AT1G67640	1	25352127	25353908	1781	-	3
AT1G67645	1	25354909	25356112	1203	+	0
AT1G67650	1	25359658	25362395	2737	-	32
AT1G67660	1	25363534	25365229	1695	+	282
AT1G67670	1	25365472	25365667	195	+	0
AT1G67680	1	25365755	25368526	2771	-	1038
AT1G67690	1	25369085	25373730	4645	+	190
AT1G67700	1	25374221	25376034	1813	+	8224
AT1G67710	1	25376750	25379144	2394	-	81
AT1G67720	1	25386340	25391073	4733	+	456
AT1G67730	1	25391459	25393610	2151	+	1513
AT1G67740	1	25394067	25395154	1087	-	37851
AT1G67750	1	25401587	25403503	1916	+	1121
AT1G67760	1	25405579	25406372	793	-	6
AT1G67770	1	25408042	25410153	2111	+	2
AT1G67775	1	25411311	25411696	385	-	0
AT1G67780	1	25412815	25415530	2715	+	47
AT1G67785	1	25416068	25416984	916	-	1117
AT1G67790	1	25417541	25420099	2558	-	3
AT1G67792	1	25417608	25420229	2621	+	51
AT1G67800	1	25420779	25423731	2952	-	344
AT1G67810	1	25426487	25427349	862	+	40
AT1G67820	1	25429852	25431564	1712	+	97
AT1G67830	1	25431585	25432990	1405	-	431
AT1G67840	1	25434101	25437075	2974	+	2461
AT1G67850	1	25437899	25442142	4243	+	313
AT1G67855	1	25442255	25442876	621	-	0
AT1G67856	1	25442403	25443019	616	+	3
AT1G67860	1	25444804	25445263	459	-	1744
AT1G67865	1	25446288	25446737	449	-	2773
AT1G67870	1	25449366	25451012	1646	-	19445
AT1G67875	1	25452698	25452893	195	+	0
AT1G67880	1	25453920	25455735	1815	-	313
AT1G67890	1	25457178	25462792	5614	+	792
AT1G67900	1	25464725	25470017	5292	+	2650
AT1G67910	1	25471287	25472440	1153	-	63
AT1G67920	1	25473543	25474140	597	+	13
AT1G67930	1	25474139	25477423	3284	-	576
AT1G67940	1	25477669	25478803	1134	+	313
AT1G67950	1	25478712	25480580	1868	-	501
AT1G67960	1	25480651	25484262	3611	-	345
AT1G67970	1	25484698	25486462	1764	-	73
AT1G67980	1	25487713	25489231	1518	+	2
AT1G67990	1	25489454	25490867	1413	+	1
AT1G68000	1	25491013	25493053	2040	+	604
AT1G68010	1	25493195	25495988	2793	+	32437
AT1G68020	1	25497289	25500374	3085	+	701
AT1G68030	1	25500377	25501751	1374	-	18
AT1G68040	1	25502875	25505232	2357	+	1
AT1G68050	1	25508675	25510889	2214	+	1
AT1G68060	1	25510940	25514500	3560	-	876
AT1G68070	1	25515231	25516868	1637	-	359
AT1G68080	1	25517410	25519440	2030	+	149
AT1G68090	1	25519441	25520774	1333	-	0
AT1G68100	1	25521203	25524175	2972	+	415
AT1G68110	1	25524717	25526150	1433	+	60
AT1G68120	1	25526214	25527534	1320	-	13
AT1G68130	1	25532243	25534586	2343	+	279
AT1G68140	1	25538944	25541741	2797	-	667
AT1G68150	1	25543968	25545717	1749	+	4
AT1G68160	1	25545807	25548894	3087	-	248
AT1G68170	1	25551921	25554258	2337	+	0
AT1G68180	1	25554720	25555661	941	+	7
AT1G68185	1	25556425	25558522	2097	+	189
AT1G68190	1	25559245	25561212	1967	+	1464
AT1G68200	1	25562117	25563948	1831	+	4
AT1G68210	1	25565982	25569302	3320	+	0
AT1G68220	1	25570230	25571712	1482	+	155
AT1G68230	1	25572184	25572921	737	+	94
AT1G68238	1	25574460	25574835	375	+	186
AT1G68240	1	25574863	25576129	1266	-	6
AT1G68250	1	25579372	25580194	822	-	0
AT1G68260	1	25585775	25587658	1883	-	377
AT1G68270	1	25588190	25590254	2064	-	0
AT1G68280	1	25592466	25593595	1129	-	0
AT1G68285	1	25594979	25595507	528	+	0
AT1G68290	1	25596670	25598438	1768	+	32
AT1G68300	1	25598330	25599357	1027	-	388
AT1G68310	1	25599490	25601463	1973	+	324
AT1G68320	1	25603841	25605096	1255	+	5
AT1G68330	1	25610922	25612202	1280	+	75
AT1G68340	1	25614196	25615403	1207	-	68
AT1G68350	1	25616489	25617265	776	+	4
AT1G68360	1	25621677	25622412	735	-	4
AT1G68370	1	25631744	25634738	2994	-	702
AT1G68380	1	25635837	25637462	1625	-	0
AT1G68390	1	25642733	25645607	2874	+	12
AT1G68400	1	25646038	25648946	2908	-	411
AT1G68410	1	25649998	25653019	3021	-	476
AT1G68420	1	25653892	25654156	264	+	0
AT1G68430	1	25654904	25655444	540	-	39
AT1G68440	1	25658032	25659273	1241	+	757
AT1G68450	1	25661500	25662239	739	-	0
AT1G68460	1	25668609	25670182	1573	-	9
AT1G68470	1	25676394	25678288	1894	-	109
AT1G68480	1	25684313	25686165	1852	-	8
AT1G68490	1	25693448	25695476	2028	+	1005
AT1G68500	1	25702002	25702511	509	+	8
AT1G68510	1	25706881	25708255	1374	+	0
AT1G68520	1	25709113	25710907	1794	-	2756
AT1G68526	1	25711868	25712238	370	-	0
AT1G68530	1	25712587	25714807	2220	-	7199
AT1G68540	1	25720023	25721410	1387	+	290
AT1G68550	1	25725454	25727701	2247	-	13
AT1G68552	1	25725454	25727701	2247	-	0
AT1G68560	1	25734181	25738002	3821	-	4557
AT1G68568	1	25746976	25747654	678	-	1
AT1G68570	1	25746735	25750275	3540	+	1549
AT1G68580	1	25752734	25756076	3342	+	790
AT1G68585	1	25756599	25757563	964	+	214
AT1G68590	1	25757403	25758232	829	-	6663
AT1G68600	1	25759841	25762934	3093	+	1828
AT1G68610	1	25763622	25764105	483	+	8
AT1G68620	1	25765946	25767240	1294	+	24
AT1G68630	1	25768538	25770260	1722	+	0
AT1G68640	1	25769575	25772543	2968	-	62
AT1G68650	1	25775740	25777874	2134	+	270
AT1G68660	1	25777850	25779161	1311	-	2639
AT1G68670	1	25782028	25784076	2048	+	964
AT1G68680	1	25785505	25786924	1419	+	304
AT1G68690	1	25788607	25792324	3717	+	85
AT1G68700	1	25792817	25793940	1123	+	5
AT1G68710	1	25793206	25798257	5051	-	359
AT1G68720	1	25804417	25808982	4565	+	1216
AT1G68725	1	25809297	25810130	833	+	64
AT1G68730	1	25810320	25811128	808	-	304
AT1G68735	1	25811902	25812261	359	+	1
AT1G68740	1	25812448	25816657	4209	-	331
AT1G68750	1	25822941	25828107	5166	-	0
AT1G68760	1	25829041	25829813	772	+	228
AT1G68765	1	25829951	25830487	536	-	0
AT1G68770	1	25829653	25829725	72	+	0
AT1G68780	1	25831802	25833844	2042	-	447
AT1G68790	1	25834708	25839319	4611	-	1278
AT1G68795	1	25840854	25841652	798	-	32
AT1G68800	1	25847065	25848540	1475	-	4
AT1G68810	1	25861122	25863120	1998	+	278
AT1G68820	1	25865659	25868985	3326	+	393
AT1G68825	1	25869699	25870420	721	-	0
AT1G68830	1	25872444	25875550	3106	-	5698
AT1G68840	1	25880322	25882222	1900	+	567
AT1G68845	1	25882433	25882918	485	+	0
AT1G68850	1	25883615	25885247	1632	-	10
AT1G68860	1	25886535	25886609	74	+	0
AT1G68862	1	25886803	25889024	2221	-	74
AT1G68870	1	25889080	25889734	654	+	289
AT1G68872	1	25890364	25891748	1384	-	36
AT1G68875	1	25892085	25892798	713	+	0
AT1G68880	1	25894236	25894961	725	-	3
AT1G68890	1	25896944	25906714	9770	+	2199
AT1G68905	1	25906715	25907092	377	-	0
AT1G68907	1	25907507	25907891	384	-	1
AT1G68910	1	25908130	25911108	2978	-	665
AT1G68920	1	25915006	25917906	2900	+	473
AT1G68930	1	25918313	25920545	2232	+	22
AT1G68935	1	25921524	25923094	1570	+	19
AT1G68940	1	25921452	25925845	4393	-	396
AT1G68945	1	25926962	25927331	369	+	279
AT1G68950	1	25928195	25928268	73	+	0
AT1G68960	1	25929895	25931257	1362	+	0
AT1G68970	1	25932076	25932149	73	-	0
AT1G68980	1	25932997	25935030	2033	+	181
AT1G68990	1	25934996	25940966	5970	-	320
AT1G69000	1	25941163	25941235	72	+	0
AT1G69010	1	25941674	25943836	2162	+	524
AT1G69020	1	25943885	25947197	3312	-	108
AT1G69030	1	25947264	25949262	1998	-	402
AT1G69040	1	25957818	25960307	2489	+	755
AT1G69050	1	25961923	25962348	425	+	7
AT1G69060	1	25964467	25967450	2983	+	295
AT1G69070	1	25967311	25971389	4078	-	479
AT1G69080	1	25971914	25973271	1357	-	102
AT1G69090	1	25977500	25978706	1206	-	0
AT1G69100	1	25979998	25981436	1438	+	0
AT1G69110	1	25981797	25982056	259	-	0
AT1G69120	1	25982329	25986313	3984	-	0
AT1G69130	1	25989729	25989803	74	+	0
AT1G69140	1	25991519	25991872	353	-	15
AT1G69150	1	25993658	25995212	1554	-	2
AT1G69160	1	26000213	26001588	1375	+	1013
AT1G69170	1	26005067	26007263	2196	+	274
AT1G69180	1	26007464	26009059	1595	-	1
AT1G69190	1	26013011	26014834	1823	-	1
AT1G69200	1	26015876	26018493	2617	+	852
AT1G69210	1	26018437	26020058	1621	-	37
AT1G69220	1	26020088	26026171	6083	-	716
AT1G69230	1	26026311	26027708	1397	-	43
AT1G69240	1	26027975	26030234	2259	-	0
AT1G69250	1	26032826	26035504	2678	+	385
AT1G69252	1	26036569	26037659	1090	+	1274
AT1G69260	1	26039047	26040720	1673	+	47
AT1G69270	1	26040688	26042702	2014	-	251
AT1G69280	1	26045159	26048190	3031	-	24
AT1G69290	1	26047371	26049348	1977	-	59
AT1G69295	1	26050196	26052567	2371	-	1015
AT1G69300	1	26049477	26049551	74	+	0
AT1G69310	1	26054307	26058105	3798	-	145
AT1G69320	1	26061861	26062514	653	+	12
AT1G69325	1	26063204	26063736	532	+	21
AT1G69330	1	26063815	26065505	1690	-	202
AT1G69340	1	26065723	26069821	4098	+	1083
AT1G69350	1	26069881	26072245	2364	+	12
AT1G69360	1	26072283	26076254	3971	-	333
AT1G69370	1	26079955	26081727	1772	+	248
AT1G69380	1	26081565	26083606	2041	-	152
AT1G69390	1	26084634	26086481	1847	+	1335
AT1G69400	1	26086947	26089020	2073	+	46
AT1G69410	1	26089201	26090386	1185	+	1867
AT1G69420	1	26093195	26097043	3848	+	1605
AT1G69430	1	26097786	26099388	1602	+	44
AT1G69440	1	26101526	26105166	3640	-	271
AT1G69450	1	26106910	26110267	3357	-	794
AT1G69460	1	26111808	26113243	1435	-	1532
AT1G69470	1	26113574	26113997	423	+	0
AT1G69480	1	26114111	26117797	3686	-	67
AT1G69485	1	26118228	26119576	1348	-	10
AT1G69490	1	26122138	26123421	1283	+	227
AT1G69500	1	26123939	26126057	2118	+	1
AT1G69510	1	26126349	26127961	1612	+	1694
AT1G69520	1	26128287	26129602	1315	+	37
AT1G69523	1	26129550	26131292	1742	+	865
AT1G69526	1	26131293	26133196	1903	+	183
AT1G69530	1	26141835	26143500	1665	+	6526
AT1G69540	1	26145043	26147571	2528	-	15
AT1G69543	1	26148436	26148781	345	+	0
AT1G69550	1	26148020	26153555	5535	-	772
AT1G69560	1	26157754	26159094	1340	+	2
AT1G69570	1	26161527	26163496	1969	-	19
AT1G69572	1	26161598	26162761	1163	+	0
AT1G69580	1	26171942	26173612	1670	+	278
AT1G69587	1	26175653	26179351	3698	-	57
AT1G69588	1	26178041	26178925	884	+	25
AT1G69590	1	26179662	26180244	582	-	0
AT1G69600	1	26182469	26183198	729	+	6
AT1G69610	1	26186953	26189489	2536	+	218
AT1G69620	1	26189835	26191323	1488	+	4245
AT1G69630	1	26191639	26193174	1535	-	0
AT1G69640	1	26193658	26195695	2037	-	626
AT1G69650	1	26197497	26198821	1324	-	0
AT1G69660	1	26199622	26200603	981	-	3
AT1G69670	1	26202030	26204442	2412	-	364
AT1G69680	1	26204804	26206928	2124	+	201
AT1G69690	1	26216223	26217851	1628	+	642
AT1G69700	1	26220237	26221825	1588	+	642
AT1G69710	1	26222071	26226652	4581	+	11
AT1G69720	1	26226865	26228580	1715	+	168
AT1G69730	1	26228631	26231339	2708	-	936
AT1G69740	1	26231803	26234963	3160	+	4215
AT1G69750	1	26235283	26237571	2288	+	199
AT1G69760	1	26239259	26240708	1449	-	246
AT1G69770	1	26248317	26253585	5268	-	626
AT1G69780	1	26258938	26260751	1813	+	458
AT1G69790	1	26266608	26269013	2405	+	26
AT1G69792	1	26269978	26270078	100	-	0
AT1G69795	1	26272775	26272870	95	-	0
AT1G69797	1	26273857	26273969	112	+	0
AT1G69800	1	26274229	26276329	2100	-	356
AT1G69810	1	26277237	26279118	1881	-	8
AT1G69818	1	26282368	26283012	644	+	0
AT1G69820	1	26283124	26284236	1112	-	0
AT1G69825	1	26286495	26286929	434	+	0
AT1G69828	1	26287521	26287948	427	+	0
AT1G69830	1	26288277	26293053	4776	-	3771
AT1G69840	1	26293600	26295849	2249	-	803
AT1G69850	1	26296675	26300472	3797	-	859
AT1G69860	1	26309627	26312174	2547	+	0
AT1G69870	1	26316026	26320220	4194	+	797
AT1G69880	1	26321478	26322993	1515	+	4
AT1G69890	1	26323110	26324616	1506	-	16
AT1G69900	1	26326380	26327831	1451	-	38
AT1G69910	1	26330113	26332266	2153	+	354
AT1G69920	1	26334249	26335558	1309	-	0
AT1G69930	1	26337496	26338795	1299	-	2
AT1G69935	1	26341800	26343126	1326	-	567
AT1G69940	1	26343368	26345058	1690	-	0
AT1G69950	1	26346487	26348691	2204	+	110
AT1G69960	1	26348720	26350697	1977	-	565
AT1G69970	1	26353046	26354256	1210	-	56
AT1G69980	1	26356355	26357667	1312	-	324
AT1G69981	1	26358096	26358402	306	-	0
AT1G69990	1	26360234	26362010	1776	-	0
AT1G70000	1	26363092	26364759	1667	-	545
AT1G70010	1	26367176	26371457	4281	+	0
AT1G70020	1	26377369	26378359	990	+	20
AT1G70030	1	26378793	26380379	1586	+	0
AT1G70040	1	26381232	26382131	899	+	0
AT1G70050	1	26382153	26382225	72	-	0
AT1G70060	1	26383243	26389916	6673	+	1134
AT1G70070	1	26390015	26394196	4181	-	1707
AT1G70080	1	26394668	26397565	2897	-	0
AT1G70090	1	26400789	26402727	1938	+	647
AT1G70100	1	26403082	26406119	3037	+	802
AT1G70110	1	26406237	26408323	2086	-	0
AT1G70120	1	26408920	26409597	677	+	0
AT1G70130	1	26409742	26411801	2059	-	1
AT1G70140	1	26412687	26415230	2543	-	21
AT1G70150	1	26416897	26419588	2691	+	124
AT1G70160	1	26419948	26422529	2581	+	2330
AT1G70170	1	26423873	26425356	1483	+	0
AT1G70180	1	26426340	26429361	3021	+	531
AT1G70185	1	26429732	26430069	337	+	1
AT1G70190	1	26430542	26432049	1507	+	329
AT1G70200	1	26432296	26434400	2104	-	1654
AT1G70209	1	26439652	26439796	144	-	0
AT1G70210	1	26439863	26442829	2966	+	658
AT1G70220	1	26446135	26448009	1874	-	6
AT1G70230	1	26450244	26451945	1701	+	483
AT1G70250	1	26452964	26456088	3124	+	697
AT1G70260	1	26456843	26459450	2607	-	514
AT1G70270	1	26464399	26464860	461	+	38
AT1G70280	1	26465892	26468706	2814	-	1017
AT1G70290	1	26471077	26474786	3709	-	1616
AT1G70300	1	26477879	26481630	3751	-	182
AT1G70310	1	26485305	26487435	2130	-	1515
AT1G70320	1	26488521	26501281	12760	-	4533
AT1G70330	1	26502908	26504619	1711	+	472
AT1G70340	1	26503960	26506613	2653	-	79
AT1G70350	1	26507113	26508285	1172	-	118
AT1G70360	1	26508777	26509325	548	+	31
AT1G70370	1	26512680	26515188	2508	-	4321
AT1G70380	1	26526211	26527345	1134	-	0
AT1G70390	1	26529170	26530282	1112	-	2
AT1G70400	1	26531398	26533460	2062	-	0
AT1G70410	1	26533925	26538333	4408	-	5814
AT1G70420	1	26539573	26540762	1189	-	133
AT1G70430	1	26545413	26549216	3803	+	157
AT1G70440	1	26548951	26550520	1569	-	1
AT1G70450	1	26552575	26554437	1862	+	0
AT1G70460	1	26555845	26559284	3439	+	2
AT1G70470	1	26559358	26560123	765	-	134
AT1G70480	1	26561823	26563809	1986	+	476
AT1G70490	1	26563923	26565810	1887	-	3947
AT1G70500	1	26566578	26568729	2151	-	27
AT1G70505	1	26570646	26572463	1817	+	247
AT1G70510	1	26576485	26582431	5946	+	22
AT1G70518	1	26583569	26584684	1115	+	80
AT1G70520	1	26584728	26587419	2691	-	468
AT1G70530	1	26588749	26591379	2630	-	293
AT1G70540	1	26593929	26594670	741	+	0
AT1G70550	1	26597151	26600219	3068	+	482
AT1G70560	1	26604854	26607503	2649	+	134
AT1G70570	1	26608624	26612309	3685	+	1015
AT1G70580	1	26612631	26616069	3438	+	5305
AT1G70581	1	26616266	26616996	730	+	0
AT1G70590	1	26618320	26620388	2068	+	277
AT1G70600	1	26620922	26621659	737	-	4389
AT1G70610	1	26621960	26626503	4543	+	2664
AT1G70620	1	26626554	26631104	4550	+	2562
AT1G70630	1	26631231	26634102	2871	+	110
AT1G70640	1	26636254	26637127	873	+	2
AT1G70645	1	26637999	26638107	108	+	0
AT1G70650	1	26638074	26642268	4194	+	34
AT1G70660	1	26640564	26642149	1585	+	177
AT1G70670	1	26644581	26646173	1592	+	320
AT1G70680	1	26647219	26648734	1515	+	3
AT1G70690	1	26652012	26653643	1631	+	48
AT1G70700	1	26654767	26657064	2297	+	934
AT1G70710	1	26659131	26663010	3879	-	684
AT1G70720	1	26666407	26667204	797	+	2
AT1G70730	1	26668864	26673166	4302	-	5965
AT1G70740	1	26673630	26675990	2360	-	184
AT1G70750	1	26679974	26683204	3230	-	329
AT1G70760	1	26687229	26688384	1155	+	3118
AT1G70770	1	26687797	26691277	3480	-	1667
AT1G70780	1	26695165	26696392	1227	-	0
AT1G70782	1	26695165	26696392	1227	-	0
AT1G70790	1	26700411	26702346	1935	+	228
AT1G70800	1	26702704	26703790	1086	+	38
AT1G70810	1	26704129	26705236	1107	+	347
AT1G70820	1	26705517	26708264	2747	+	2780
AT1G70830	1	26709946	26711462	1516	-	2078
AT1G70840	1	26712981	26714066	1085	-	0
AT1G70850	1	26714865	26716829	1964	-	1
AT1G70860	1	26718319	26718992	673	-	0
AT1G70870	1	26721019	26721563	544	-	0
AT1G70880	1	26722880	26723778	898	-	0
AT1G70885	1	26724924	26725233	309	-	1
AT1G70890	1	26725625	26726544	919	-	1362
AT1G70895	1	26727898	26729137	1239	+	54
AT1G70900	1	26731812	26733875	2063	+	856
AT1G70910	1	26734154	26734640	486	+	0
AT1G70920	1	26735955	26738665	2710	+	16
AT1G70940	1	26743053	26746395	3342	+	2303
AT1G70944	1	26749136	26749253	117	-	1
AT1G70949	1	26752400	26752664	264	-	0
AT1G70950	1	26752688	26755359	2671	+	37
AT1G70960	1	26756252	26757362	1110	+	0
AT1G70970	1	26759833	26761042	1209	+	0
AT1G70980	1	26762338	26764623	2285	+	338
AT1G70985	1	26764671	26765285	614	-	176
AT1G70990	1	26767296	26768076	780	-	0
AT1G71000	1	26769335	26770111	776	-	0
AT1G71002	1	26773538	26773725	187	-	1
AT1G71010	1	26782838	26788970	6132	+	1437
AT1G71015	1	26789235	26790160	925	-	24
AT1G71020	1	26790596	26793175	2579	-	581
AT1G71030	1	26795122	26796364	1242	-	1344
AT1G71040	1	26796965	26800322	3357	-	1052
AT1G71050	1	26803152	26804292	1140	-	83
AT1G71060	1	26805650	26807183	1533	-	44
AT1G71070	1	26807187	26809504	2317	-	631
AT1G71080	1	26809840	26811842	2002	-	675
AT1G71090	1	26812211	26814130	1919	+	837
AT1G71100	1	26814631	26815671	1040	+	171
AT1G71110	1	26818082	26821004	2922	+	104
AT1G71120	1	26821071	26822420	1349	-	12
AT1G71130	1	26822787	26823530	743	+	190
AT1G71140	1	26824676	26826748	2072	+	146
AT1G71150	1	26827145	26828674	1529	+	0
AT1G71160	1	26828700	26830208	1508	-	0
AT1G71170	1	26830668	26832099	1431	+	201
AT1G71180	1	26832334	26833709	1375	+	250
AT1G71190	1	26833405	26835032	1627	-	197
AT1G71200	1	26835972	26837308	1336	-	15
AT1G71210	1	26838288	26841490	3202	-	173
AT1G71220	1	26841629	26851919	10290	+	1648
AT1G71230	1	26852460	26854396	1936	+	78
AT1G71235	1	26854558	26855222	664	+	0
AT1G71240	1	26855429	26859741	4312	+	620
AT1G71250	1	26860117	26861726	1609	+	0
AT1G71260	1	26861656	26863422	1766	-	356
AT1G71270	1	26863586	26870015	6429	+	807
AT1G71280	1	26870140	26872152	2012	-	0
AT1G71290	1	26872642	26873242	600	+	0
AT1G71300	1	26874063	26878340	4277	+	1
AT1G71310	1	26877744	26880024	2280	-	276
AT1G71320	1	26882484	26883818	1334	+	0
AT1G71330	1	26884013	26885169	1156	-	56
AT1G71340	1	26885169	26888338	3169	-	1047
AT1G71350	1	26888407	26891231	2824	-	367
AT1G71360	1	26892099	26894802	2703	-	207
AT1G71370	1	26897004	26899434	2430	-	0
AT1G71380	1	26899783	26901789	2006	-	4
AT1G71390	1	26906452	26908807	2355	+	0
AT1G71400	1	26909834	26912597	2763	+	21
AT1G71410	1	26912725	26917712	4987	-	815
AT1G71420	1	26917821	26920099	2278	-	12
AT1G71430	1	26920439	26921152	713	+	105
AT1G71440	1	26921059	26924386	3327	-	467
AT1G71450	1	26927037	26928056	1019	+	1
AT1G71460	1	26927983	26930316	2333	-	177
AT1G71470	1	26930705	26931568	863	+	0
AT1G71480	1	26931939	26933313	1374	+	1305
AT1G71490	1	26932904	26935825	2921	-	89
AT1G71500	1	26935981	26937607	1626	+	8102
AT1G71520	1	26938524	26939106	582	+	0
AT1G71528	1	26939561	26942952	3391	-	9
AT1G71530	1	26939566	26942952	3386	+	0
AT1G71680	1	26944586	26947188	2602	+	0
AT1G71690	1	26947764	26949168	1404	+	8
AT1G71691	1	26949198	26951547	2349	-	4
AT1G71692	1	26952644	26955127	2483	-	10
AT1G71695	1	26964248	26966688	2440	+	2508
AT1G71696	1	26966886	26970572	3686	+	356
AT1G71697	1	26971222	26973464	2242	+	253
AT1G71700	1	26973388	26973459	71	+	0
AT1G71710	1	26973566	26981029	7463	-	893
AT1G71720	1	26983720	26985990	2270	+	1375
AT1G71730	1	26986059	26986909	850	-	471
AT1G71740	1	26987244	26987637	393	+	5
AT1G71750	1	26987774	26989199	1425	-	126
AT1G71760	1	26989349	26990617	1268	+	47
AT1G71770	1	26990524	26994259	3735	-	5
AT1G71780	1	26995085	26996650	1565	-	234
AT1G71790	1	26996808	26998977	2169	+	164
AT1G71800	1	26999451	27002342	2891	+	177
AT1G71810	1	27002413	27008176	5763	-	1773
AT1G71820	1	27009563	27017108	7545	+	1529
AT1G71828	1	27017800	27018315	515	-	0
AT1G71830	1	27018157	27022117	3960	+	193
AT1G71840	1	27022217	27024551	2334	+	770
AT1G71850	1	27024731	27026363	1632	-	105
AT1G71860	1	27026710	27029092	2382	+	787
AT1G71865	1	27029204	27030560	1356	+	128
AT1G71866	1	27030426	27031461	1035	-	5
AT1G71870	1	27032455	27034895	2440	-	79
AT1G71880	1	27054179	27056341	2162	+	1333
AT1G71890	1	27058438	27060785	2347	+	38
AT1G71900	1	27061485	27064496	3011	+	413
AT1G71910	1	27064931	27065947	1016	+	38
AT1G71920	1	27066947	27069166	2219	+	2
AT1G71930	1	27076139	27077957	1818	+	32
AT1G71940	1	27078523	27080248	1725	+	152
AT1G71950	1	27080183	27081613	1430	-	758
AT1G71960	1	27082393	27088248	5855	-	310
AT1G71970	1	27093027	27094027	1000	+	463
AT1G71980	1	27097902	27100139	2237	+	1053
AT1G71990	1	27100283	27102262	1979	+	126
AT1G72000	1	27103276	27105663	2387	+	1
AT1G72010	1	27107566	27109275	1709	+	703
AT1G72020	1	27109290	27110431	1141	-	2958
AT1G72030	1	27110864	27111932	1068	+	1732
AT1G72040	1	27111893	27114342	2449	-	1113
AT1G72050	1	27115023	27117470	2447	+	726
AT1G72060	1	27118446	27119011	565	+	0
AT1G72070	1	27118620	27119708	1088	-	9
AT1G72080	1	27120263	27122761	2498	-	0
AT1G72090	1	27123566	27126895	3329	+	605
AT1G72100	1	27127211	27128978	1767	+	0
AT1G72110	1	27129024	27131469	2445	-	0
AT1G72120	1	27132096	27133985	1889	+	51
AT1G72125	1	27134167	27136389	2222	+	4
AT1G72130	1	27137180	27139384	2204	+	1098
AT1G72131	1	27139394	27140536	1142	+	0
AT1G72140	1	27141813	27144490	2677	+	7
AT1G72141	1	27145145	27145322	177	-	0
AT1G72150	1	27148459	27150980	2521	+	4776
AT1G72160	1	27153580	27155664	2084	-	1603
AT1G72170	1	27156334	27157706	1372	+	398
AT1G72175	1	27157874	27159558	1684	+	197
AT1G72180	1	27162819	27167430	4611	+	1809
AT1G72190	1	27167362	27169717	2355	-	203
AT1G72200	1	27169794	27171321	1527	-	27
AT1G72210	1	27179789	27182430	2641	+	70
AT1G72220	1	27184280	27185830	1550	-	8
AT1G72230	1	27188065	27189244	1179	+	169
AT1G72240	1	27190178	27190749	571	+	19
AT1G72250	1	27192844	27198314	5470	+	319
AT1G72260	1	27198432	27199444	1012	-	0
AT1G72270	1	27199732	27211161	11429	-	203
AT1G72280	1	27211844	27214665	2821	-	78
AT1G72290	1	27215788	27216791	1003	+	0
AT1G72300	1	27217476	27221123	3647	-	680
AT1G72310	1	27225896	27227545	1649	+	298
AT1G72320	1	27228152	27232999	4847	-	656
AT1G72330	1	27233474	27236789	3315	+	93
AT1G72340	1	27236874	27238612	1738	+	489
AT1G72350	1	27239272	27239947	675	-	0
AT1G72360	1	27241806	27242827	1021	+	39
AT1G72370	1	27242942	27244931	1989	-	6979
AT1G72390	1	27245164	27251576	6412	+	850
AT1G72410	1	27251425	27257081	5656	-	1104
AT1G72416	1	27258828	27260291	1463	-	58
AT1G72420	1	27261193	27263669	2476	-	102
AT1G72430	1	27264910	27265630	720	-	1076
AT1G72440	1	27268164	27273596	5432	-	521
AT1G72450	1	27274064	27276317	2253	-	457
AT1G72460	1	27279509	27281533	2024	+	0
AT1G72470	1	27283692	27285895	2203	+	239
AT1G72480	1	27286057	27288368	2311	-	781
AT1G72490	1	27288899	27291042	2143	-	0
AT1G72500	1	27295335	27298556	3221	-	1419
AT1G72510	1	27303365	27304850	1485	+	1253
AT1G72520	1	27308514	27312754	4240	+	67
AT1G72530	1	27312998	27313937	939	+	57
AT1G72540	1	27314931	27316669	1738	-	52
AT1G72550	1	27319687	27324037	4350	-	1374
AT1G72560	1	27324388	27330031	5643	-	629
AT1G72570	1	27331380	27333698	2318	+	0
AT1G72580	1	27334075	27334771	696	-	0
AT1G72590	1	27335600	27337072	1472	+	1
AT1G72600	1	27338124	27340328	2204	+	55
AT1G72610	1	27339113	27340044	931	-	76
AT1G72620	1	27341078	27342455	1377	+	5
AT1G72630	1	27344269	27345576	1307	+	374
AT1G72640	1	27346260	27348256	1996	-	1713
AT1G72645	1	27348380	27349219	839	+	1282
AT1G72650	1	27349466	27353742	4276	+	787
AT1G72660	1	27353790	27356670	2880	+	7
AT1G72670	1	27356682	27358853	2171	-	195
AT1G72680	1	27359231	27361016	1785	-	188
AT1G72690	1	27361153	27361919	766	+	36
AT1G72700	1	27365895	27371733	5838	+	554
AT1G72710	1	27372270	27376584	4314	+	2213
AT1G72720	1	27376754	27377395	641	-	8
AT1G72730	1	27377797	27380182	2385	-	275
AT1G72740	1	27380293	27382924	2631	-	403
AT1G72750	1	27383364	27384524	1160	+	887
AT1G72760	1	27385420	27388274	2854	-	7
AT1G72770	1	27390021	27393281	3260	+	1371
AT1G72780	1	27393384	27393466	82	+	0
AT1G72790	1	27394746	27396799	2053	+	128
AT1G72800	1	27397215	27398500	1285	+	262
AT1G72810	1	27398590	27400417	1827	-	523
AT1G72820	1	27402877	27404673	1796	+	596
AT1G72830	1	27405455	27407969	2514	-	150
AT1G72840	1	27409236	27413851	4615	-	114
AT1G72850	1	27413970	27415335	1365	+	16
AT1G72852	1	27414414	27415173	759	-	4
AT1G72855	1	27416231	27418323	2092	+	0
AT1G72860	1	27416227	27420778	4551	-	7
AT1G72870	1	27421022	27423184	2162	+	14
AT1G72880	1	27423384	27426140	2756	-	849
AT1G72890	1	27429915	27431960	2045	+	265
AT1G72900	1	27432194	27433782	1588	+	323
AT1G72910	1	27435613	27437144	1531	+	274
AT1G72920	1	27437927	27439091	1164	+	61
AT1G72930	1	27439451	27440464	1013	+	2323
AT1G72940	1	27442237	27443856	1619	+	204
AT1G72950	1	27444584	27445980	1396	+	6
AT1G72960	1	27446235	27450862	4627	+	7
AT1G72970	1	27452765	27455964	3199	+	2712
AT1G72980	1	27456042	27456873	831	-	0
AT1G72990	1	27457265	27462392	5127	-	266
AT1G73000	1	27462994	27463877	883	+	0
AT1G73010	1	27464571	27466256	1685	-	70
AT1G73020	1	27469533	27473554	4021	-	381
AT1G73030	1	27473825	27475122	1297	+	1161
AT1G73040	1	27475059	27475962	903	-	41
AT1G73050	1	27476564	27478534	1970	-	0
AT1G73060	1	27478969	27481448	2479	+	4316
AT1G73066	1	27481784	27483715	1931	+	19
AT1G73080	1	27484512	27488201	3689	+	489
AT1G73090	1	27488216	27490766	2550	+	363
AT1G73100	1	27491183	27494182	2999	+	366
AT1G73110	1	27494120	27496878	2758	-	1498
AT1G73120	1	27497185	27497950	765	-	2
AT1G73130	1	27499034	27502055	3021	+	150
AT1G73140	1	27502132	27503819	1687	-	10
AT1G73150	1	27504111	27506112	2001	-	127
AT1G73160	1	27506533	27507994	1461	+	0
AT1G73165	1	27508724	27508949	225	-	0
AT1G73170	1	27511660	27514797	3137	-	2093
AT1G73175	1	27515032	27516568	1536	+	1
AT1G73177	1	27516571	27517854	1283	-	80
AT1G73180	1	27517915	27521649	3734	+	516
AT1G73190	1	27521943	27523332	1389	+	2
AT1G73200	1	27523453	27526718	3265	-	628
AT1G73210	1	27528051	27530952	2901	-	81
AT1G73220	1	27538275	27540235	1960	+	5
AT1G73230	1	27540227	27541944	1717	-	2091
AT1G73240	1	27542186	27544920	2734	-	226
AT1G73250	1	27545005	27546435	1430	-	232
AT1G73260	1	27547273	27548190	917	-	9
AT1G73270	1	27549020	27552517	3497	-	1
AT1G73280	1	27552969	27555322	2353	-	0
AT1G73290	1	27556396	27558773	2377	-	1
AT1G73300	1	27559672	27562048	2376	-	0
AT1G73310	1	27562814	27565177	2363	-	145
AT1G73320	1	27565393	27567222	1829	-	144
AT1G73325	1	27567517	27568186	669	-	6
AT1G73330	1	27568717	27569717	1000	-	110
AT1G73340	1	27573115	27575419	2304	+	1
AT1G73350	1	27575492	27577275	1783	-	476
AT1G73360	1	27578695	27582521	3826	-	133
AT1G73370	1	27584424	27588464	4040	-	252
AT1G73380	1	27589031	27590822	1791	+	174
AT1G73390	1	27590809	27595142	4333	-	1092
AT1G73400	1	27598105	27599812	1707	+	76
AT1G73410	1	27601631	27603317	1686	+	1
AT1G73430	1	27603654	27611068	7414	+	859
AT1G73440	1	27611362	27612815	1453	+	120
AT1G73445	1	27612615	27613350	735	-	12
AT1G73450	1	27613855	27618897	5042	+	251
AT1G73460	1	27620121	27625092	4971	+	646
AT1G73470	1	27625148	27627714	2566	+	1037
AT1G73480	1	27628938	27632806	3868	+	2267
AT1G73490	1	27633259	27634964	1705	-	751
AT1G73500	1	27639090	27640529	1439	-	102
AT1G73510	1	27642385	27643189	804	-	0
AT1G73530	1	27643632	27645394	1762	-	1041
AT1G73540	1	27645657	27646698	1041	-	259
AT1G73550	1	27647755	27648536	781	-	25
AT1G73560	1	27649694	27650471	777	-	0
AT1G73570	1	27650991	27653942	2951	+	177
AT1G73580	1	27654840	27655518	678	+	2
AT1G73590	1	27659672	27663178	3506	+	379
AT1G73600	1	27669151	27673572	4421	+	829
AT1G73602	1	27670625	27673569	2944	+	0
AT1G73603	1	27674287	27674953	666	+	0
AT1G73607	1	27676226	27676835	609	+	0
AT1G73610	1	27678376	27679807	1431	+	0
AT1G73620	1	27681407	27683130	1723	+	160
AT1G73630	1	27684735	27685453	718	+	216
AT1G73640	1	27686991	27688127	1136	+	48
AT1G73650	1	27688122	27690307	2185	-	1063
AT1G73655	1	27690358	27691814	1456	-	2826
AT1G73660	1	27691892	27697211	5319	-	1518
AT1G73670	1	27700049	27703440	3391	+	851
AT1G73680	1	27703943	27707518	3575	-	709
AT1G73687	1	27713233	27713415	182	-	3
AT1G73690	1	27714947	27717281	2334	+	40
AT1G73700	1	27717379	27719648	2269	-	115
AT1G73710	1	27721189	27724165	2976	+	562
AT1G73720	1	27725001	27729931	4930	+	484
AT1G73730	1	27730030	27732514	2484	-	440
AT1G73740	1	27734278	27736189	1911	+	353
AT1G73750	1	27736629	27739079	2450	+	1029
AT1G73760	1	27739167	27741207	2040	-	476
AT1G73770	1	27742127	27743565	1438	+	58
AT1G73780	1	27743871	27744168	297	+	2
AT1G73790	1	27744671	27745377	706	+	105
AT1G73805	1	27745426	27749178	3752	-	144
AT1G73810	1	27752399	27755297	2898	-	13
AT1G73820	1	27755511	27757211	1700	-	152
AT1G73830	1	27759972	27761588	1616	+	66
AT1G73840	1	27763684	27766364	2680	-	590
AT1G73850	1	27767262	27770457	3195	+	106
AT1G73860	1	27770985	27776857	5872	-	32
AT1G73870	1	27779165	27780676	1511	+	2809
AT1G73875	1	27781005	27784920	3915	+	210
AT1G73880	1	27784980	27786804	1824	+	82
AT1G73885	1	27786863	27787708	845	+	5687
AT1G73890	1	27787902	27788658	756	-	50
AT1G73900	1	27788982	27789054	72	+	0
AT1G73910	1	27789292	27790187	895	+	9
AT1G73920	1	27790874	27794914	4040	+	1894
AT1G73930	1	27795119	27797981	2862	-	513
AT1G73940	1	27798312	27799596	1284	-	400
AT1G73950	1	27799829	27804604	4775	-	335
AT1G73960	1	27805044	27814446	9402	-	986
AT1G73965	1	27815796	27816468	672	+	5
AT1G73970	1	27816813	27820078	3265	+	415
AT1G73980	1	27820148	27824036	3888	-	770
AT1G73990	1	27824432	27828926	4494	+	2118
AT1G74000	1	27829141	27831431	2290	-	26
AT1G74010	1	27832157	27834113	1956	-	11
AT1G74020	1	27835130	27837317	2187	-	183
AT1G74030	1	27839183	27841939	2756	-	407
AT1G74040	1	27842170	27845776	3606	+	1297
AT1G74045	1	27846110	27846840	730	+	0
AT1G74050	1	27847046	27848806	1760	-	3363
AT1G74055	1	27849229	27849812	583	+	23
AT1G74060	1	27849832	27851374	1542	-	2687
AT1G74070	1	27851487	27852976	1489	-	1871
AT1G74080	1	27855698	27857534	1836	+	0
AT1G74088	1	27861115	27862753	1638	+	65
AT1G74090	1	27862908	27864193	1285	+	1907
AT1G74100	1	27864344	27865694	1350	-	1373
AT1G74110	1	27866666	27868368	1702	-	0
AT1G74120	1	27871273	27873260	1987	-	151
AT1G74130	1	27873610	27876033	2423	+	0
AT1G74140	1	27876904	27879780	2876	+	0
AT1G74150	1	27880527	27883626	3099	+	29
AT1G74160	1	27886425	27891431	5006	+	1006
AT1G74170	1	27891493	27896355	4862	-	383
AT1G74180	1	27897196	27900908	3712	-	139
AT1G74190	1	27902589	27906158	3569	-	1
AT1G74200	1	27906908	27909358	2450	-	34
AT1G74205	1	27909480	27910384	904	-	14
AT1G74210	1	27910313	27912941	2628	+	400
AT1G74220	1	27913098	27914134	1036	-	0
AT1G74230	1	27914698	27917083	2385	+	1332
AT1G74240	1	27917395	27920139	2744	+	80
AT1G74250	1	27920327	27922414	2087	+	394
AT1G74260	1	27922832	27927904	5072	-	2173
AT1G74270	1	27928170	27929497	1327	-	1181
AT1G74280	1	27929661	27931364	1703	+	63
AT1G74290	1	27931835	27934268	2433	+	42
AT1G74300	1	27935297	27936608	1311	+	180
AT1G74310	1	27936507	27940190	3683	-	375
AT1G74320	1	27940672	27943204	2532	+	568
AT1G74330	1	27943461	27947109	3648	-	191
AT1G74340	1	27948122	27951668	3546	-	271
AT1G74350	1	27949021	27951283	2262	-	51
AT1G74360	1	27954230	27958114	3884	+	127
AT1G74370	1	27958085	27959366	1281	-	491
AT1G74380	1	27959577	27961454	1877	+	889
AT1G74390	1	27961536	27963847	2311	-	131
AT1G74400	1	27963952	27965341	1389	+	6
AT1G74410	1	27965550	27967926	2376	+	124
AT1G74420	1	27967770	27969879	2109	-	42
AT1G74430	1	27975178	27977434	2256	+	55
AT1G74440	1	27976501	27980404	3903	-	65
AT1G74448	1	27982130	27982280	150	-	0
AT1G74450	1	27982508	27984280	1772	+	274
AT1G74453	1	27984603	27984713	110	-	72
AT1G74456	1	27984744	27984826	82	-	42
AT1G74457	1	27985956	27986536	580	+	0
AT1G74458	1	27986956	27987675	719	+	93
AT1G74460	1	27987960	27989801	1841	-	13
AT1G74470	1	27991164	27993006	1842	+	50825
AT1G74480	1	27993031	27994178	1147	-	12
AT1G74490	1	27994699	27996742	2043	-	6
AT1G74500	1	27998174	27998821	647	-	0
AT1G74510	1	28005364	28007739	2375	+	505
AT1G74520	1	28007973	28009300	1327	-	994
AT1G74530	1	28009522	28012162	2640	-	580
AT1G74540	1	28013308	28015049	1741	+	12
AT1G74545	1	28014584	28015482	898	-	3
AT1G74550	1	28016044	28017711	1667	+	7
AT1G74560	1	28017583	28020049	2466	-	1045
AT1G74570	1	28020382	28020463	81	-	0
AT1G74580	1	28020776	28023068	2292	+	182
AT1G74590	1	28023626	28024726	1100	-	79
AT1G74600	1	28025152	28027840	2688	-	89
AT1G74610	1	28027959	28028040	81	+	0
AT1G74620	1	28028251	28029001	750	+	0
AT1G74630	1	28030520	28032452	1932	+	16
AT1G74640	1	28032762	28034773	2011	+	2069
AT1G74650	1	28041190	28042995	1805	+	47
AT1G74660	1	28047575	28048127	552	-	15
AT1G74670	1	28053285	28054149	864	+	3663
AT1G74680	1	28059187	28061119	1932	+	332
AT1G74690	1	28061158	28064625	3467	-	1737
AT1G74700	1	28065265	28067217	1952	+	64
AT1G74710	1	28070294	28074148	3854	+	234
AT1G74720	1	28075073	28078830	3757	+	900
AT1G74730	1	28078856	28079987	1131	+	7119
AT1G74740	1	28079945	28082644	2699	-	144
AT1G74750	1	28086799	28089367	2568	+	120
AT1G74770	1	28089570	28094834	5264	-	9
AT1G74780	1	28095814	28098185	2371	+	160
AT1G74790	1	28098764	28101896	3132	+	356
AT1G74800	1	28101967	28105112	3145	-	347
AT1G74810	1	28108473	28111534	3061	+	191
AT1G74820	1	28111881	28112565	684	-	0
AT1G74830	1	28113422	28115229	1807	-	1
AT1G74840	1	28115896	28117405	1509	-	855
AT1G74850	1	28118848	28122314	3466	-	1217
AT1G74860	1	28123318	28125882	2564	+	156
AT1G74870	1	28126927	28128463	1536	+	12
AT1G74875	1	28128469	28129745	1276	-	24
AT1G74880	1	28129857	28131077	1220	-	3572
AT1G74890	1	28131589	28132710	1121	-	261
AT1G74900	1	28133932	28135667	1735	+	35
AT1G74910	1	28135360	28138826	3466	-	2398
AT1G74920	1	28139008	28142744	3736	-	2534
AT1G74929	1	28143996	28144098	102	-	1
AT1G74930	1	28144131	28145049	918	+	32
AT1G74940	1	28146058	28147378	1320	+	367
AT1G74950	1	28148574	28150444	1870	-	285
AT1G74960	1	28151923	28156259	4336	-	4401
AT1G74970	1	28157529	28159302	1773	-	6118
AT1G74990	1	28159714	28160487	773	-	0
AT1G75000	1	28163649	28164586	937	+	89
AT1G75010	1	28164839	28170054	5215	-	690
AT1G75020	1	28171017	28173436	2419	+	256
AT1G75030	1	28174377	28175383	1006	+	61
AT1G75040	1	28177702	28178940	1238	+	403
AT1G75050	1	28180115	28181062	947	+	4
AT1G75060	1	28181274	28183503	2229	-	51
AT1G75070	1	28184531	28184603	72	+	0
AT1G75080	1	28185503	28188075	2572	+	391
AT1G75090	1	28187446	28189725	2279	-	59
AT1G75100	1	28190815	28193800	2985	-	2607
AT1G75110	1	28194114	28195933	1819	-	78
AT1G75120	1	28196856	28198802	1946	-	141
AT1G75130	1	28199969	28201950	1981	-	306
AT1G75140	1	28202052	28204279	2227	-	254
AT1G75150	1	28204386	28208573	4187	-	133
AT1G75160	1	28209436	28211804	2368	+	0
AT1G75163	1	28212394	28212474	80	+	17
AT1G75166	1	28212517	28212603	86	+	18
AT1G75170	1	28213798	28215887	2089	+	164
AT1G75180	1	28215835	28218801	2966	-	1122
AT1G75190	1	28219381	28220227	846	+	99
AT1G75200	1	28220625	28223709	3084	-	404
AT1G75210	1	28223868	28228975	5107	+	1629
AT1G75220	1	28229156	28232831	3675	-	1077
AT1G75230	1	28234348	28236741	2393	+	211
AT1G75240	1	28241071	28242756	1685	+	339
AT1G75250	1	28244316	28245501	1185	-	34
AT1G75260	1	28247808	28249441	1633	+	23
AT1G75261	1	28249566	28250016	450	+	1
AT1G75270	1	28250074	28251350	1276	-	429
AT1G75280	1	28251959	28253619	1660	+	2994
AT1G75290	1	28253889	28255173	1284	+	6
AT1G75295	1	28254365	28257151	2786	-	40
AT1G75300	1	28255494	28257040	1546	+	5
AT1G75310	1	28261003	28266124	5121	+	635
AT1G75330	1	28266258	28268412	2154	-	1631
AT1G75335	1	28268540	28269002	462	+	31
AT1G75340	1	28268967	28271965	2998	-	521
AT1G75350	1	28272070	28272832	762	+	8214
AT1G75360	1	28274587	28275990	1403	+	36
AT1G75370	1	28276425	28279898	3473	-	1950
AT1G75380	1	28281388	28284045	2657	-	9003
AT1G75388	1	28291697	28293008	1311	+	0
AT1G75390	1	28291697	28293008	1311	+	0
AT1G75394	1	28294785	28295097	312	+	1
AT1G75400	1	28296918	28299686	2768	+	424
AT1G75410	1	28299791	28302603	2812	-	1302
AT1G75420	1	28305296	28307503	2207	+	353
AT1G75430	1	28308120	28309610	1490	-	4
AT1G75440	1	28313486	28315122	1636	+	146
AT1G75450	1	28314457	28318375	3918	-	76
AT1G75460	1	28327885	28329764	1879	+	7254
AT1G75470	1	28330071	28331300	1229	+	1
AT1G75480	1	28334087	28334744	657	-	1
AT1G75490	1	28335501	28336706	1205	+	3
AT1G75500	1	28337725	28340275	2550	-	4036
AT1G75510	1	28347054	28348735	1681	-	487
AT1G75520	1	28351561	28353495	1934	-	22
AT1G75530	1	28359308	28361815	2507	+	0
AT1G75540	1	28366026	28367652	1626	+	507
AT1G75550	1	28369436	28369940	504	-	39
AT1G75560	1	28371140	28373241	2101	-	651
AT1G75570	1	28373488	28373561	73	-	0
AT1G75580	1	28377460	28378178	718	+	25
AT1G75590	1	28382895	28383768	873	-	6
AT1G75600	1	28390664	28391493	829	+	0
AT1G75610	1	28392728	28393312	584	+	0
AT1G75620	1	28394778	28396596	1818	-	20
AT1G75630	1	28400543	28402355	1812	+	1227
AT1G75640	1	28403465	28407051	3586	-	111
AT1G75650	1	28407983	28408056	73	+	0
AT1G75660	1	28408146	28415117	6971	+	1467
AT1G75670	1	28415202	28416852	1650	-	94
AT1G75680	1	28417051	28419529	2478	-	2808
AT1G75690	1	28422109	28423285	1176	-	6758
AT1G75700	1	28423895	28424931	1036	+	13
AT1G75710	1	28428705	28431249	2544	+	586
AT1G75717	1	28433918	28434261	343	+	0
AT1G75720	1	28434567	28435489	922	-	24
AT1G75730	1	28435705	28439769	4064	-	252
AT1G75740	1	28440888	28440960	72	+	0
AT1G75750	1	28441525	28442429	904	-	1304
AT1G75760	1	28446631	28448646	2015	-	328
AT1G75770	1	28449989	28451108	1119	+	138
AT1G75780	1	28451140	28453640	2500	-	342
AT1G75790	1	28454780	28457528	2748	-	0
AT1G75800	1	28458781	28460854	2073	+	1015
AT1G75810	1	28461663	28462366	703	+	176
AT1G75820	1	28463461	28466971	3510	-	1789
AT1G75830	1	28472356	28472891	535	+	0
AT1G75840	1	28475706	28477802	2096	+	739
AT1G75850	1	28477767	28483928	6161	-	815
AT1G75860	1	28484162	28485951	1789	-	319
AT1G75870	1	28486228	28487393	1165	+	0
AT1G75880	1	28490442	28492464	2022	+	63
AT1G75890	1	28493030	28495047	2017	+	11
AT1G75891	1	28493303	28494161	858	-	3
AT1G75900	1	28499059	28501138	2079	+	395
AT1G75910	1	28501433	28503283	1850	+	0
AT1G75920	1	28504451	28507168	2717	+	7
AT1G75930	1	28508071	28509857	1786	+	0
AT1G75940	1	28511167	28514284	3117	+	0
AT1G75950	1	28516547	28517699	1152	+	3362
AT1G75960	1	28518032	28519874	1842	+	61
AT1G75970	1	28519984	28520056	72	-	0
AT1G75980	1	28522553	28524337	1784	-	197
AT1G75990	1	28524492	28526776	2284	-	554
AT1G76000	1	28527766	28527838	72	+	0
AT1G76010	1	28528076	28530790	2714	-	2699
AT1G76020	1	28532096	28533567	1471	-	685
AT1G76030	1	28533797	28537194	3397	+	3505
AT1G76040	1	28537672	28540637	2965	+	255
AT1G76050	1	28540822	28543227	2405	+	530
AT1G76060	1	28543099	28543850	751	-	139
AT1G76062	1	28544453	28544853	400	-	0
AT1G76065	1	28544337	28545376	1039	-	39
AT1G76070	1	28546381	28547611	1230	+	53
AT1G76080	1	28547785	28549419	1634	-	9262
AT1G76090	1	28550408	28551781	1373	-	434
AT1G76100	1	28553986	28554768	782	-	6460
AT1G76110	1	28555041	28557586	2545	-	1337
AT1G76120	1	28558669	28560473	1804	-	218
AT1G76130	1	28561280	28564076	2796	+	802
AT1G76135	1	28568807	28568928	121	+	1
AT1G76140	1	28571129	28575036	3907	+	1295
AT1G76150	1	28574739	28577700	2961	-	624
AT1G76160	1	28577941	28581133	3192	-	1485
AT1G76170	1	28584038	28586225	2187	-	159
AT1G76180	1	28586675	28587931	1256	-	6521
AT1G76185	1	28590324	28591518	1194	+	92
AT1G76190	1	28592224	28592596	372	+	8
AT1G76200	1	28593249	28594742	1493	+	1741
AT1G76210	1	28594949	28595981	1032	-	0
AT1G76220	1	28597529	28598300	771	-	3
AT1G76230	1	28599759	28600442	683	-	1
AT1G76240	1	28602810	28603929	1119	-	522
AT1G76250	1	28606449	28609128	2679	-	11
AT1G76260	1	28610264	28613263	2999	+	120
AT1G76270	1	28613206	28616739	3533	-	198
AT1G76280	1	28617638	28622731	5093	-	463
AT1G76290	1	28623442	28625408	1966	-	0
AT1G76300	1	28625883	28627367	1484	+	314
AT1G76310	1	28628045	28630394	2349	-	160
AT1G76320	1	28631238	28634124	2886	+	422
AT1G76330	1	28634691	28634773	82	+	0
AT1G76340	1	28634954	28636716	1762	-	280
AT1G76350	1	28639576	28643086	3510	+	536
AT1G76360	1	28643037	28646712	3675	-	526
AT1G76370	1	28648448	28650484	2036	-	0
AT1G76380	1	28651153	28654580	3427	-	218
AT1G76390	1	28655389	28658711	3322	+	321
AT1G76400	1	28658553	28661710	3157	-	1011
AT1G76405	1	28661883	28663789	1906	+	331
AT1G76410	1	28668847	28669646	799	+	28
AT1G76420	1	28672028	28673934	1906	-	31
AT1G76430	1	28678934	28681995	3061	-	0
AT1G76440	1	28682128	28683750	1622	-	128
AT1G76450	1	28684550	28686244	1694	+	3574
AT1G76460	1	28686180	28689121	2941	-	526
AT1G76470	1	28689769	28691449	1680	-	0
AT1G76480	1	28692075	28693428	1353	-	0
AT1G76490	1	28695759	28698793	3034	+	3480
AT1G76500	1	28705526	28706562	1036	+	1
AT1G76510	1	28708613	28712952	4339	-	311
AT1G76520	1	28715077	28717416	2339	+	1037
AT1G76530	1	28718212	28720371	2159	+	118
AT1G76540	1	28720327	28722521	2194	-	342
AT1G76550	1	28722701	28727006	4305	-	605
AT1G76560	1	28728252	28728853	601	+	71
AT1G76570	1	28729131	28730825	1694	+	914
AT1G76580	1	28734233	28738917	4684	+	481
AT1G76590	1	28740690	28742207	1517	+	93
AT1G76600	1	28746887	28747845	958	+	36
AT1G76610	1	28750987	28751851	864	+	18
AT1G76620	1	28756520	28759297	2777	+	387
AT1G76630	1	28759698	28765042	5344	+	721
AT1G76640	1	28765323	28765803	480	-	0
AT1G76650	1	28766749	28768138	1389	-	20
AT1G76660	1	28768878	28771409	2531	-	392
AT1G76670	1	28772599	28774901	2302	-	1923
AT1G76680	1	28776845	28778467	1622	+	940
AT1G76690	1	28778889	28780483	1594	+	181
AT1G76700	1	28780407	28783248	2841	-	222
AT1G76705	1	28786449	28787328	879	+	10
AT1G76710	1	28789728	28792676	2948	-	252
AT1G76720	1	28794143	28800369	6226	-	240
AT1G76728	1	28802632	28802734	102	+	0
AT1G76730	1	28802924	28804784	1860	-	1894
AT1G76740	1	28805234	28810557	5323	+	139
AT1G76750	1	28811039	28811721	682	+	0
AT1G76760	1	28811684	28813070	1386	-	42
AT1G76770	1	28813568	28814378	810	+	7
AT1G76780	1	28816640	28822256	5616	+	65
AT1G76790	1	28822185	28823673	1488	-	40
AT1G76800	1	28829307	28830277	970	+	221
AT1G76810	1	28831002	28836586	5584	-	2649
AT1G76820	1	28837572	28842566	4994	+	151
AT1G76830	1	28844643	28845765	1122	+	0
AT1G76840	1	28846565	28847288	723	-	0
AT1G76850	1	28847950	28854499	6549	+	2001
AT1G76860	1	28854413	28855750	1337	-	347
AT1G76870	1	28857249	28858407	1158	+	47
AT1G76878	1	28866403	28867969	1566	-	0
AT1G76880	1	28865499	28868225	2726	+	200
AT1G76890	1	28873058	28875292	2234	-	82
AT1G76892	1	28873270	28874758	1488	+	1
AT1G76900	1	28881813	28884566	2753	+	1096
AT1G76910	1	28887217	28888104	887	+	0
AT1G76911	1	28887241	28887982	741	-	0
AT1G76920	1	28892061	28893676	1615	+	398
AT1G76930	1	28895300	28896883	1583	-	198
AT1G76940	1	28902427	28904311	1884	-	314
AT1G76950	1	28906522	28911564	5042	+	597
AT1G76952	1	28914283	28914952	669	-	8
AT1G76954	1	28917865	28918537	672	-	0
AT1G76955	1	28918809	28919545	736	-	187
AT1G76960	1	28920456	28920956	500	-	820
AT1G76965	1	28921728	28922292	564	-	1
AT1G76970	1	28922665	28925404	2739	-	170
AT1G76980	1	28925797	28927339	1542	-	68
AT1G76990	1	28932161	28935550	3389	+	2339
AT1G76994	1	28937636	28937798	162	+	0
AT1G77000	1	28940146	28942623	2477	+	155
AT1G77010	1	28942709	28944797	2088	+	5
AT1G77020	1	28944842	28947031	2189	-	107
AT1G77030	1	28947742	28951599	3857	-	359
AT1G77040	1	28947553	28947625	72	-	0
AT1G77060	1	28951684	28953509	1825	-	902
AT1G77080	1	28955636	28960096	4460	+	792
AT1G77090	1	28960386	28961922	1536	-	2632
AT1G77093	1	28962507	28963149	642	+	0
AT1G77095	1	28964015	28965367	1352	-	0
AT1G77100	1	28965771	28967066	1295	-	0
AT1G77110	1	28970801	28974603	3802	+	132
AT1G77120	1	28975393	28977417	2024	+	140
AT1G77122	1	28977356	28978743	1387	-	533
AT1G77130	1	28978893	28981345	2452	-	532
AT1G77131	1	28981413	28983463	2050	-	56
AT1G77138	1	28982765	28983469	704	+	0
AT1G77140	1	28984024	28987983	3959	+	490
AT1G77145	1	28989926	28991346	1420	-	9
AT1G77150	1	28992875	28993170	295	-	0
AT1G77160	1	28995145	28996594	1449	-	0
AT1G77170	1	28998046	28999537	1491	-	71
AT1G77180	1	28999607	29002135	2528	-	1714
AT1G77190	1	29002204	29002286	82	-	0
AT1G77200	1	29004356	29005091	735	-	19
AT1G77210	1	29008938	29012096	3158	-	149
AT1G77220	1	29012716	29015803	3087	+	411
AT1G77230	1	29016119	29019768	3649	+	71
AT1G77235	1	29016519	29016828	309	+	1
AT1G77240	1	29017957	29019789	1832	-	0
AT1G77250	1	29020264	29023474	3210	-	202
AT1G77260	1	29023771	29026957	3186	-	799
AT1G77270	1	29027777	29031285	3508	+	206
AT1G77280	1	29031467	29035882	4415	-	287
AT1G77290	1	29038374	29039838	1464	+	125
AT1G77300	1	29039921	29049302	9381	-	1306
AT1G77310	1	29051504	29056339	4835	+	126
AT1G77320	1	29056531	29062966	6435	+	206
AT1G77330	1	29062989	29064537	1548	-	22
AT1G77340	1	29068342	29069828	1486	-	0
AT1G77350	1	29070252	29071899	1647	+	341
AT1G77360	1	29071982	29073536	1554	-	17
AT1G77370	1	29073842	29074796	954	+	444
AT1G77380	1	29074887	29077390	2503	-	18
AT1G77390	1	29081903	29084285	2382	-	36
AT1G77400	1	29085810	29086864	1054	+	81
AT1G77405	1	29087144	29088521	1377	+	7
AT1G77410	1	29088696	29093264	4568	-	87
AT1G77420	1	29093498	29095716	2218	+	216
AT1G77440	1	29096019	29098450	2431	+	619
AT1G77450	1	29099953	29101261	1308	+	113
AT1G77460	1	29103632	29111921	8289	+	699
AT1G77470	1	29111947	29114435	2488	-	259
AT1G77480	1	29114557	29117338	2781	-	486
AT1G77490	1	29117541	29120215	2674	+	6186
AT1G77500	1	29121488	29125191	3703	+	295
AT1G77510	1	29126649	29129612	2963	+	912
AT1G77520	1	29130402	29132180	1778	+	8
AT1G77525	1	29133953	29134531	578	-	0
AT1G77530	1	29136036	29137555	1519	+	0
AT1G77540	1	29137625	29138212	587	-	234
AT1G77550	1	29138298	29143011	4713	-	358
AT1G77560	1	29143089	29143161	72	-	0
AT1G77570	1	29143349	29144003	654	+	8
AT1G77580	1	29144024	29147584	3560	-	897
AT1G77590	1	29148255	29152315	4060	-	1931
AT1G77600	1	29152747	29162448	9701	-	688
AT1G77610	1	29165209	29167773	2564	+	782
AT1G77620	1	29167763	29172867	5104	-	274
AT1G77630	1	29173456	29175530	2074	+	263
AT1G77640	1	29178736	29179675	939	+	1
AT1G77650	1	29181109	29182261	1152	+	0
AT1G77655	1	29182607	29183172	565	-	0
AT1G77660	1	29185898	29187825	1927	-	188
AT1G77670	1	29188900	29190975	2075	-	514
AT1G77680	1	29191833	29196287	4454	-	928
AT1G77682	1	29196542	29197071	529	-	0
AT1G77690	1	29200940	29203340	2400	-	210
AT1G77700	1	29204746	29206217	1471	+	45
AT1G77710	1	29206634	29208145	1511	+	1723
AT1G77720	1	29210520	29214087	3567	+	156
AT1G77730	1	29214444	29215564	1120	+	1
AT1G77740	1	29220537	29224220	3683	+	1813
AT1G77746	1	29227914	29228088	174	+	0
AT1G77750	1	29230153	29231524	1371	-	243
AT1G77760	1	29235802	29239445	3643	-	1655
AT1G77765	1	29245049	29246281	1232	+	41
AT1G77770	1	29246073	29248028	1955	-	286
AT1G77780	1	29248299	29249528	1229	-	0
AT1G77790	1	29250691	29251976	1285	-	0
AT1G77800	1	29253395	29260617	7222	+	2043
AT1G77810	1	29260561	29263113	2552	-	109
AT1G77815	1	29263347	29263650	303	-	0
AT1G77820	1	29263662	29264268	606	+	0
AT1G77830	1	29267159	29267752	593	-	0
AT1G77840	1	29268486	29270586	2100	+	897
AT1G77850	1	29272312	29275419	3107	+	294
AT1G77855	1	29277165	29278518	1353	-	52
AT1G77860	1	29282642	29284458	1816	-	7
AT1G77870	1	29285077	29285889	812	+	37
AT1G77880	1	29285901	29287067	1166	-	5
AT1G77885	1	29289872	29290915	1043	+	68
AT1G77890	1	29292122	29296160	4038	+	180
AT1G77910	1	29296137	29296407	270	+	0
AT1G77920	1	29298242	29300863	2621	+	442
AT1G77930	1	29300999	29303570	2571	+	1978
AT1G77932	1	29302724	29303519	795	-	0
AT1G77940	1	29303896	29305382	1486	-	2691
AT1G77950	1	29306956	29311194	4238	+	0
AT1G77960	1	29310056	29313571	3515	-	211
AT1G77980	1	29314840	29317067	2227	-	0
AT1G77990	1	29317898	29323352	5454	-	406
AT1G77992	1	29322410	29323358	948	+	0
AT1G78000	1	29329734	29333146	3412	+	25
AT1G78010	1	29333499	29336451	2952	+	620
AT1G78020	1	29338692	29339755	1063	+	3416
AT1G78030	1	29342156	29343824	1668	+	12
AT1G78040	1	29345837	29347107	1270	+	6794
AT1G78050	1	29347580	29349755	2175	+	81
AT1G78060	1	29349678	29352924	3246	-	899
AT1G78070	1	29355021	29358993	3972	+	2011
AT1G78080	1	29364248	29366073	1825	+	2337
AT1G78090	1	29373888	29376504	2616	+	28
AT1G78095	1	29377751	29380183	2432	+	0
AT1G78100	1	29387794	29389112	1318	+	709
AT1G78110	1	29391826	29393334	1508	+	169
AT1G78120	1	29393938	29396086	2148	-	99
AT1G78130	1	29400139	29401902	1763	+	249
AT1G78140	1	29401758	29403946	2188	-	1316
AT1G78150	1	29404647	29406752	2105	+	974
AT1G78160	1	29407899	29410184	2285	+	0
AT1G78170	1	29414058	29415094	1036	+	373
AT1G78172	1	29415529	29415921	392	+	15
AT1G78180	1	29416912	29418640	1728	+	575
AT1G78190	1	29418619	29418994	375	-	47
AT1G78200	1	29420252	29421864	1612	+	630
AT1G78206	1	29422451	29422574	123	+	5
AT1G78210	1	29422715	29424375	1660	-	415
AT1G78220	1	29425720	29427181	1461	-	0
AT1G78230	1	29430224	29432764	2540	+	955
AT1G78240	1	29432828	29436571	3743	-	951
AT1G78250	1	29443972	29444010	38	-	0
AT1G78260	1	29446984	29450515	3531	+	228
AT1G78265	1	29450771	29452378	1607	+	2
AT1G78270	1	29450562	29452417	1855	-	8
AT1G78280	1	29452554	29457373	4819	+	590
AT1G78290	1	29457204	29459400	2196	-	958
AT1G78300	1	29461670	29463385	1715	+	2190
AT1G78310	1	29463655	29465053	1398	-	45
AT1G78320	1	29467436	29468374	938	-	80
AT1G78330	1	29469847	29471958	2111	-	11
AT1G78340	1	29472891	29473863	972	-	1
AT1G78350	1	29474913	29478272	3359	+	0
AT1G78355	1	29478503	29479108	605	-	0
AT1G78360	1	29482069	29482966	897	-	2
AT1G78370	1	29484268	29485290	1022	-	12716
AT1G78380	1	29486412	29487906	1494	-	6799
AT1G78390	1	29490894	29492875	1981	-	1
AT1G78400	1	29498280	29499682	1402	-	0
AT1G78410	1	29502581	29503241	660	+	7
AT1G78420	1	29504531	29507669	3138	+	516
AT1G78430	1	29508958	29510895	1937	+	143
AT1G78440	1	29511598	29513051	1453	-	108
AT1G78450	1	29516988	29517933	945	-	269
AT1G78460	1	29518315	29519323	1008	-	512
AT1G78470	1	29521769	29523191	1422	+	0
AT1G78476	1	29523981	29526284	2303	+	10
AT1G78478	1	29525193	29525294	101	+	8
AT1G78480	1	29525500	29526363	863	-	9
AT1G78490	1	29528252	29530665	2413	+	748
AT1G78500	1	29531645	29535177	3532	+	0
AT1G78510	1	29535284	29537417	2133	-	2072
AT1G78520	1	29537975	29538656	681	-	14
AT1G78530	1	29539088	29540709	1621	-	106
AT1G78540	1	29541010	29544777	3767	-	268
AT1G78550	1	29544926	29546487	1561	-	180
AT1G78560	1	29546604	29548824	2220	-	732
AT1G78570	1	29549648	29552438	2790	+	3282
AT1G78580	1	29552339	29560912	8573	-	2168
AT1G78590	1	29564248	29566375	2127	+	220
AT1G78600	1	29567105	29568859	1754	+	287
AT1G78610	1	29569029	29572126	3097	-	636
AT1G78620	1	29572870	29575794	2924	-	1297
AT1G78630	1	29575955	29577658	1703	+	12246
AT1G78640	1	29579714	29581988	2274	-	0
AT1G78650	1	29582928	29585641	2713	+	209
AT1G78660	1	29585676	29588302	2626	+	509
AT1G78670	1	29590944	29593499	2555	+	1090
AT1G78680	1	29593755	29596270	2515	+	2464
AT1G78690	1	29596654	29598629	1975	+	204
AT1G78700	1	29599348	29601682	2334	+	326
AT1G78710	1	29601252	29604557	3305	+	0
AT1G78720	1	29605628	29607510	1882	+	1
AT1G78730	1	29607688	29609441	1753	-	116
AT1G78740	1	29610493	29611492	999	-	0
AT1G78750	1	29613121	29614695	1574	-	21
AT1G78760	1	29615173	29616738	1565	-	0
AT1G78770	1	29616918	29621447	4529	+	169
AT1G78780	1	29621339	29623156	1817	-	9
AT1G78790	1	29623528	29625078	1550	-	223
AT1G78800	1	29625658	29627989	2331	-	426
AT1G78810	1	29628268	29630553	2285	-	196
AT1G78815	1	29631742	29632745	1003	-	9
AT1G78820	1	29634123	29635813	1690	-	1332
AT1G78830	1	29636954	29638552	1598	-	1152
AT1G78840	1	29639289	29640817	1528	-	0
AT1G78850	1	29641925	29643431	1506	-	1459
AT1G78860	1	29646167	29647499	1332	-	38
AT1G78865	1	29647737	29649951	2214	-	69
AT1G78870	1	29650453	29652593	2140	+	1132
AT1G78880	1	29652632	29655949	3317	-	0
AT1G78882	1	29652632	29655949	3317	-	0
AT1G78890	1	29656576	29658065	1489	+	603
AT1G78895	1	29658115	29659976	1861	-	160
AT1G78900	1	29660183	29664951	4768	+	10414
AT1G78910	1	29665217	29667656	2439	+	86
AT1G78915	1	29667564	29671341	3777	-	1395
AT1G78920	1	29671492	29677537	6045	+	1671
AT1G78922	1	29676754	29677815	1061	-	0
AT1G78930	1	29678096	29680757	2661	-	64
AT1G78940	1	29680821	29684161	3340	-	85
AT1G78950	1	29684431	29688673	4242	-	38
AT1G78955	1	29689152	29694255	5103	-	40
AT1G78960	1	29696469	29701263	4794	+	175
AT1G78970	1	29703061	29707844	4783	+	307
AT1G78980	1	29707686	29711421	3735	-	0
AT1G78990	1	29713530	29714969	1439	-	41
AT1G78995	1	29715078	29716111	1033	-	648
AT1G79000	1	29716349	29724621	8272	-	1857
AT1G79010	1	29724878	29727028	2150	-	1700
AT1G79020	1	29727122	29730431	3309	-	269
AT1G79030	1	29730766	29733611	2845	-	352
AT1G79040	1	29736015	29737009	994	+	95548
AT1G79050	1	29736958	29740179	3221	-	749
AT1G79060	1	29741747	29743600	1853	+	94
AT1G79070	1	29744669	29745815	1146	-	80
AT1G79075	1	29745938	29746842	904	+	214
AT1G79080	1	29746971	29748944	1973	-	270
AT1G79090	1	29749111	29753307	4196	-	1083
AT1G79100	1	29753647	29754388	741	+	2
AT1G79110	1	29759156	29760704	1548	+	419
AT1G79120	1	29764088	29768789	4701	-	12
AT1G79130	1	29771277	29771887	610	+	0
AT1G79150	1	29772587	29777989	5402	-	304
AT1G79160	1	29779720	29780773	1053	-	244
AT1G79170	1	29782272	29782622	350	+	23
AT1G79180	1	29786494	29787802	1308	+	4
AT1G79190	1	29788638	29794175	5537	+	278
AT1G79200	1	29794386	29796040	1654	+	179
AT1G79210	1	29796080	29798783	2703	-	1071
AT1G79220	1	29798934	29800525	1591	+	56
AT1G79230	1	29800692	29803939	3247	+	2655
AT1G79240	1	29804122	29804195	73	+	0
AT1G79245	1	29804734	29809514	4780	-	7551
AT1G79250	1	29810133	29812526	2393	-	0
AT1G79260	1	29813243	29814309	1066	+	196
AT1G79270	1	29815505	29819104	3599	+	1744
AT1G79280	1	29819141	29833016	13875	-	2258
AT1G79290	1	29833116	29833188	72	+	0
AT1G79300	1	29833717	29833789	72	+	0
AT1G79310	1	29833920	29835545	1625	+	3
AT1G79320	1	29836685	29837908	1223	+	1
AT1G79330	1	29838652	29840137	1485	+	6
AT1G79340	1	29842770	29844638	1868	+	1723
AT1G79350	1	29844632	29853414	8782	-	1004
AT1G79360	1	29854037	29855821	1784	-	22
AT1G79370	1	29857933	29860163	2230	+	0
AT1G79380	1	29860490	29863316	2826	+	1499
AT1G79390	1	29863224	29864321	1097	-	222
AT1G79400	1	29864991	29867840	2849	+	0
AT1G79410	1	29867879	29869633	1754	-	156
AT1G79420	1	29871457	29874315	2858	+	93
AT1G79430	1	29877227	29879206	1979	-	557
AT1G79440	1	29882209	29887412	5203	-	248
AT1G79450	1	29887688	29890179	2491	+	4
AT1G79460	1	29890391	29894587	4196	+	359
AT1G79470	1	29894597	29897166	2569	-	105
AT1G79480	1	29897726	29899604	1878	-	20
AT1G79490	1	29900455	29903189	2734	+	121
AT1G79500	1	29903419	29909437	6018	+	433
AT1G79510	1	29908012	29909988	1976	-	353
AT1G79520	1	29912250	29914615	2365	-	1447
AT1G79529	1	29915661	29916410	749	+	25
AT1G79530	1	29915901	29919234	3333	-	375
AT1G79540	1	29920082	29922676	2594	-	155
AT1G79550	1	29924022	29926582	2560	-	7276
AT1G79560	1	29926793	29932585	5792	+	1631
AT1G79570	1	29932577	29938856	6279	-	1091
AT1G79580	1	29940849	29943602	2753	-	3
AT1G79590	1	29946236	29948774	2538	+	446
AT1G79600	1	29949924	29952690	2766	-	7050
AT1G79610	1	29952872	29957189	4317	-	433
AT1G79620	1	29957561	29962305	4744	-	207
AT1G79630	1	29962644	29965795	3151	-	300
AT1G79640	1	29966710	29971600	4890	-	172
AT1G79650	1	29972107	29975281	3174	-	430
AT1G79660	1	29975862	29976773	911	+	176
AT1G79670	1	29976724	29979350	2626	-	329
AT1G79680	1	29979972	29982773	2801	-	0
AT1G79690	1	29985175	29990388	5213	+	1223
AT1G79700	1	29990335	29993724	3389	-	110
AT1G79710	1	29995115	29998058	2943	+	105
AT1G79720	1	29997126	29999045	1919	-	364
AT1G79730	1	30000537	30004005	3468	-	620
AT1G79740	1	30004366	30007020	2654	-	646
AT1G79750	1	30007325	30011393	4068	-	4863
AT1G79760	1	30012047	30013495	1448	+	33
AT1G79770	1	30014360	30015078	718	+	65
AT1G79780	1	30015872	30016856	984	+	1
AT1G79790	1	30016367	30018231	1864	-	1435
AT1G79800	1	30018548	30019217	669	+	1
AT1G79810	1	30019743	30022486	2743	+	451
AT1G79820	1	30022259	30027443	5184	-	305
AT1G79830	1	30027669	30033901	6232	-	2162
AT1G79840	1	30036955	30041440	4485	+	253
AT1G79850	1	30041242	30041952	710	-	5566
AT1G79860	1	30042091	30044175	2084	-	0
AT1G79870	1	30044745	30046027	1282	+	1302
AT1G79880	1	30046027	30048378	2351	-	370
AT1G79890	1	30048654	30052203	3549	+	71
AT1G79900	1	30052296	30053936	1640	-	12
AT1G79910	1	30054883	30057170	2287	+	62
AT1G79915	1	30057219	30058657	1438	+	4
AT1G79920	1	30058631	30062744	4113	-	2981
AT1G79930	1	30063475	30067547	4072	-	1383
AT1G79940	1	30069535	30073332	3797	+	1116
AT1G79950	1	30073579	30079537	5958	+	374
AT1G79960	1	30079664	30080549	885	-	34
AT1G79970	1	30082077	30083894	1817	+	861
AT1G79980	1	30083995	30084069	74	-	1
AT1G79990	1	30084113	30092238	8125	+	2019
AT1G80000	1	30092923	30097165	4242	+	752
AT1G80010	1	30097400	30099846	2446	+	447
AT1G80020	1	30100472	30103899	3427	-	914
AT1G80030	1	30104829	30109032	4203	-	2678
AT1G80040	1	30109146	30111280	2134	-	1038
AT1G80050	1	30111513	30113324	1811	-	614
AT1G80060	1	30116208	30117588	1380	-	70
AT1G80070	1	30118051	30127811	9760	+	4246
AT1G80080	1	30128004	30129591	1587	-	473
AT1G80090	1	30130103	30131940	1837	+	1
AT1G80100	1	30133725	30134735	1010	+	0
AT1G80110	1	30135380	30136956	1576	+	43
AT1G80120	1	30139100	30140204	1104	+	79
AT1G80130	1	30140960	30142646	1686	-	152
AT1G80133	1	30143627	30144255	628	-	0
AT1G80140	1	30146610	30148180	1570	+	0
AT1G80150	1	30148387	30150517	2130	+	78
AT1G80160	1	30151002	30152190	1188	+	2
AT1G80170	1	30153407	30155713	2306	-	141
AT1G80180	1	30156825	30157584	759	-	947
AT1G80190	1	30159076	30161654	2578	+	135
AT1G80200	1	30162033	30162999	966	+	20
AT1G80210	1	30162834	30165755	2921	-	313
AT1G80220	1	30167838	30168606	768	+	0
AT1G80230	1	30169455	30171101	1646	-	822
AT1G80240	1	30171356	30172839	1483	-	3
AT1G80245	1	30174177	30175542	1365	+	69
AT1G80250	1	30174013	30174085	72	-	0
AT1G80260	1	30175784	30180681	4897	+	800
AT1G80270	1	30180953	30183507	2554	+	299
AT1G80280	1	30183540	30186586	3046	-	379
AT1G80290	1	30188320	30189726	1406	+	132
AT1G80300	1	30191855	30194519	2664	+	2427
AT1G80310	1	30194617	30196554	1937	+	345
AT1G80320	1	30196781	30197896	1115	+	0
AT1G80325	1	30196604	30198074	1470	-	14
AT1G80330	1	30198060	30199537	1477	-	0
AT1G80340	1	30200692	30202200	1508	-	17
AT1G80350	1	30205314	30208226	2912	-	466
AT1G80360	1	30208498	30210803	2305	-	1195
AT1G80370	1	30213704	30216861	3157	+	126
AT1G80380	1	30217115	30220004	2889	+	9326
AT1G80390	1	30221779	30222702	923	-	1
AT1G80400	1	30225175	30227575	2400	+	426
AT1G80410	1	30227484	30234985	7501	-	2209
AT1G80420	1	30235163	30238535	3372	-	417
AT1G80430	1	30237783	30237865	82	+	0
AT1G80440	1	30241606	30243071	1465	+	441
AT1G80450	1	30243929	30244783	854	-	44
AT1G80460	1	30246744	30249305	2561	-	1549
AT1G80470	1	30256065	30257916	1851	+	0
AT1G80480	1	30258075	30260679	2604	-	841
AT1G80490	1	30260902	30267038	6136	-	1371
AT1G80500	1	30270528	30272668	2140	+	857
AT1G80510	1	30272848	30274793	1945	+	268
AT1G80520	1	30276480	30277059	579	+	74
AT1G80530	1	30277951	30280324	2373	-	462
AT1G80540	1	30281637	30284319	2682	-	3
AT1G80550	1	30284945	30286704	1759	-	229
AT1G80555	1	30286955	30287741	786	+	6
AT1G80560	1	30287762	30290298	2536	+	837
AT1G80570	1	30290324	30292420	2096	+	35
AT1G80580	1	30293557	30294328	771	+	0
AT1G80590	1	30296209	30297156	947	-	0
AT1G80600	1	30298498	30300553	2055	-	3035
AT1G80610	1	30300732	30304033	3301	-	128
AT1G80620	1	30305361	30307417	2056	+	406
AT1G80630	1	30308695	30310656	1961	-	195
AT1G80640	1	30311665	30314375	2710	+	950
AT1G80650	1	30314535	30315819	1284	+	290
AT1G80660	1	30316025	30320197	4172	-	0
AT1G80670	1	30320575	30323780	3205	-	544
AT1G80680	1	30324007	30328769	4762	+	690
AT1G80690	1	30329067	30330803	1736	-	265
AT1G80700	1	30331921	30333400	1479	+	48
AT1G80710	1	30333422	30335871	2449	-	43
AT1G80720	1	30336137	30337565	1428	+	75
AT1G80730	1	30339322	30340247	925	-	6
AT1G80740	1	30342393	30347048	4655	+	1
AT1G80745	1	30347425	30348436	1011	+	9
AT1G80750	1	30348800	30350564	1764	+	609
AT1G80760	1	30350538	30352208	1670	-	827
AT1G80770	1	30355114	30357964	2850	+	1440
AT1G80780	1	30358114	30359606	1492	+	1669
AT1G80790	1	30359722	30363307	3585	+	1094
AT1G80800	1	30364012	30364310	298	+	119
AT1G80810	1	30365286	30368898	3612	+	325
AT1G80820	1	30370571	30372670	2099	+	26
AT1G80830	1	30372878	30375696	2818	-	772
AT1G80831	1	30376370	30376481	111	+	0
AT1G80840	1	30383690	30385499	1809	+	21
AT1G80850	1	30385448	30387522	2074	-	412
AT1G80860	1	30388034	30389302	1268	-	305
AT1G80865	1	30389537	30390557	1020	+	2
AT1G80870	1	30392132	30394383	2251	+	419
AT1G80880	1	30395193	30396921	1728	-	37
AT1G80890	1	30397127	30398210	1083	+	144
AT1G80900	1	30398149	30400340	2191	-	183
AT1G80910	1	30400733	30403676	2943	+	576
AT1G80920	1	30403643	30404690	1047	-	2503
AT1G80930	1	30405431	30409710	4279	-	1508
AT1G80940	1	30410700	30412289	1589	+	955
AT1G80950	1	30412543	30415113	2570	-	547
AT1G80960	1	30415836	30418323	2487	+	106
AT1G80970	1	30420101	30421995	1894	+	44
AT1G80980	1	30422057	30424087	2030	-	128
AT1G80990	1	30424420	30425192	772	+	0
AT1G81001	1	30425839	30426557	718	-	0
AT1G81020	1	30426838	30427577	739	+	0
AT2G01008	2	1024	2810	1786	+	83
AT2G01010	2	3705	5513	1808	+	5
AT2G01020	2	5781	5945	164	+	46
AT2G01021	2	6570	6672	102	+	721
AT2G01022	2	10477	12861	2384	-	0
AT2G01023	2	9647	9767	120	-	2
AT2G01024	2	14394	16377	1983	-	0
AT2G01026	2	17623	22540	4917	-	0
AT2G01028	2	23970	26923	2953	-	0
AT2G01029	2	28464	38652	10188	+	1
AT2G01031	2	39518	40358	840	-	0
AT2G01034	2	43426	48350	4924	-	0
AT2G01037	2	58704	64872	6168	-	0
AT2G01040	2	65435	67139	1704	-	1
AT2G01050	2	68336	69884	1548	-	0
AT2G01060	2	73257	75389	2132	-	587
AT2G01070	2	75519	77865	2346	+	556
AT2G01080	2	77887	79334	1447	+	117
AT2G01090	2	79988	81710	1722	+	233
AT2G01100	2	81435	83290	1855	+	767
AT2G01110	2	83259	85229	1970	-	4456
AT2G01120	2	85400	88186	2786	+	182
AT2G01130	2	88558	94660	6102	-	578
AT2G01140	2	94810	96655	1845	-	2459
AT2G01150	2	100648	101495	847	+	130
AT2G01160	2	102064	102138	74	+	0
AT2G01170	2	102193	104549	2356	-	243
AT2G01175	2	104883	106216	1333	-	7
AT2G01180	2	106899	108803	1904	-	144
AT2G01190	2	114974	117640	2666	+	334
AT2G01200	2	118016	119342	1326	+	2
AT2G01210	2	119440	121846	2406	-	117
AT2G01220	2	123275	126466	3191	+	917
AT2G01240	2	128439	129256	817	-	0
AT2G01250	2	132696	134455	1759	-	6233
AT2G01260	2	135243	137806	2563	-	769
AT2G01270	2	139330	142560	3230	+	701
AT2G01275	2	142497	144524	2027	-	22
AT2G01280	2	145675	149394	3719	+	1
AT2G01290	2	148918	150382	1464	-	718
AT2G01300	2	151056	151729	673	-	5
AT2G01310	2	152480	152642	162	-	0
AT2G01320	2	154130	158182	4052	-	1475
AT2G01330	2	158276	160901	2625	-	205
AT2G01340	2	163953	165290	1337	+	69
AT2G01350	2	165140	167259	2119	-	1629
AT2G01360	2	167996	168479	483	+	0
AT2G01370	2	168630	169642	1012	-	0
AT2G01372	2	169966	170613	647	-	1
AT2G01390	2	172255	174137	1882	+	50
AT2G01400	2	174270	175617	1347	+	109
AT2G01410	2	175039	176407	1368	-	281
AT2G01420	2	180104	183328	3224	-	2119
AT2G01422	2	183939	184734	795	+	2
AT2G01430	2	187797	190369	2572	-	1
AT2G01440	2	193700	199248	5548	-	664
AT2G01450	2	199510	203126	3616	-	2350
AT2G01460	2	206135	211919	5784	+	432
AT2G01470	2	211969	214472	2503	-	792
AT2G01480	2	216721	220989	4268	+	290
AT2G01490	2	221245	223418	2173	+	1204
AT2G01500	2	224155	226192	2037	-	0
AT2G01505	2	228744	229237	493	-	139
AT2G01510	2	230751	232506	1755	-	18
AT2G01520	2	235924	237147	1223	+	1
AT2G01530	2	239704	240520	816	+	0
AT2G01540	2	242122	243493	1371	-	113
AT2G01550	2	243917	249049	5132	-	0
AT2G01554	2	249686	250181	495	+	0
AT2G01560	2	250244	251806	1562	-	0
AT2G01570	2	255248	257550	2302	-	2102
AT2G01580	2	265043	265905	862	-	3
AT2G01590	2	266629	267798	1169	+	2100
AT2G01600	2	268817	272610	3793	+	930
AT2G01610	2	273916	274820	904	-	129
AT2G01620	2	278126	279296	1170	+	574
AT2G01630	2	279281	282123	2842	-	499
AT2G01640	2	282968	284598	1630	+	157
AT2G01650	2	284671	286493	1822	-	421
AT2G01660	2	290602	292590	1988	-	120
AT2G01667	2	295454	295556	102	+	0
AT2G01670	2	296509	298101	1592	-	1213
AT2G01680	2	306384	308659	2275	+	930
AT2G01690	2	308701	313805	5104	-	1309
AT2G01700	2	314843	315158	315	-	0
AT2G01710	2	315725	316993	1268	+	336
AT2G01720	2	317029	320264	3235	-	1186
AT2G01730	2	320477	323947	3470	+	17
AT2G01735	2	324471	326094	1623	+	168
AT2G01740	2	326135	327815	1680	-	36
AT2G01750	2	328088	332113	4025	+	203
AT2G01755	2	332193	332781	588	-	311
AT2G01760	2	332966	334696	1730	+	299
AT2G01770	2	334771	336438	1667	-	7
AT2G01780	2	338023	339871	1848	-	0
AT2G01790	2	341321	342480	1159	-	0
AT2G01800	2	343561	345254	1693	-	0
AT2G01810	2	347536	350179	2643	+	1
AT2G01818	2	353456	355522	2066	-	26
AT2G01820	2	357430	360681	3251	-	2254
AT2G01830	2	362982	369707	6725	-	623
AT2G01840	2	373124	378447	5323	-	1
AT2G01850	2	385198	387344	2146	+	1852
AT2G01860	2	388054	389918	1864	+	170
AT2G01870	2	389469	390405	936	-	339
AT2G01880	2	391422	394032	2610	-	0
AT2G01890	2	396767	399208	2441	-	322
AT2G01900	2	405917	409014	3097	+	3
AT2G01905	2	410326	415330	5004	+	25
AT2G01910	2	416910	420588	3678	+	1114
AT2G01913	2	421623	422626	1003	-	38
AT2G01918	2	424109	425713	1604	-	258
AT2G01920	2	426051	426990	939	+	0
AT2G01930	2	427116	428839	1723	-	465
AT2G01940	2	432274	435077	2803	+	141
AT2G01950	2	440635	444276	3641	-	526
AT2G01960	2	450378	451910	1532	+	0
AT2G01970	2	451870	454885	3015	-	1497
AT2G01973	2	455658	456088	430	-	0
AT2G01980	2	457009	463326	6317	+	483
AT2G01990	2	465000	466724	1724	-	173
AT2G02000	2	469369	472070	2701	-	1
AT2G02010	2	474164	476594	2430	-	127
AT2G02020	2	479100	481185	2085	+	396
AT2G02023	2	481466	481778	312	-	0
AT2G02026	2	481906	482086	180	+	0
AT2G02030	2	482334	483829	1495	+	0
AT2G02040	2	487422	489832	2410	+	905
AT2G02050	2	489965	491995	2030	+	1361
AT2G02060	2	495569	497747	2178	+	67
AT2G02061	2	498024	499559	1535	+	8
AT2G02070	2	505486	509425	3939	+	1276
AT2G02080	2	518158	521707	3549	-	1025
AT2G02090	2	523283	527012	3729	+	586
AT2G02100	2	528349	529108	759	+	366
AT2G02103	2	530240	531636	1396	-	0
AT2G02110	2	532319	536341	4022	-	0
AT2G02120	2	538249	539055	806	+	2
AT2G02130	2	539998	540634	636	+	1650
AT2G02135	2	541896	542173	277	+	0
AT2G02140	2	544706	545429	723	+	0
AT2G02147	2	546663	547026	363	+	0
AT2G02148	2	547214	549616	2402	-	168
AT2G02150	2	550339	552625	2286	-	72
AT2G02160	2	553109	556113	3004	-	1556
AT2G02170	2	556492	558798	2306	-	441
AT2G02180	2	560863	563233	2370	+	597
AT2G02190	2	567872	569698	1826	+	0
AT2G02200	2	570438	574368	3930	-	0
AT2G02205	2	576058	576590	532	-	0
AT2G02210	2	577380	582050	4670	-	0
AT2G02220	2	583977	587124	3147	-	268
AT2G02230	2	590220	591650	1430	-	266
AT2G02240	2	592358	593602	1244	-	7
AT2G02250	2	594654	595852	1198	-	0
AT2G02260	2	596453	597760	1307	-	0
AT2G02270	2	598111	599525	1414	-	0
AT2G02280	2	600490	601439	949	-	0
AT2G02290	2	604452	605361	909	+	0
AT2G02300	2	606181	607839	1658	-	0
AT2G02310	2	608758	610130	1372	-	0
AT2G02320	2	610427	611843	1416	-	0
AT2G02330	2	613724	614592	868	-	0
AT2G02340	2	616087	617274	1187	-	0
AT2G02350	2	617799	619091	1292	-	38
AT2G02360	2	619405	620768	1363	-	325
AT2G02370	2	621154	623344	2190	+	131
AT2G02380	2	626841	628676	1835	+	20
AT2G02390	2	628898	631114	2216	+	507
AT2G02400	2	631235	632575	1340	-	255
AT2G02410	2	632633	634919	2286	+	172
AT2G02430	2	635455	636638	1183	+	3
AT2G02440	2	638011	639305	1294	+	0
AT2G02450	2	648043	650814	2771	+	297
AT2G02470	2	652563	654915	2352	+	484
AT2G02480	2	660742	665635	4893	+	369
AT2G02490	2	667040	668284	1244	+	1
AT2G02498	2	669759	670204	445	+	2
AT2G02500	2	670877	673155	2278	-	957
AT2G02510	2	673304	674740	1436	+	770
AT2G02515	2	675255	675656	401	+	0
AT2G02520	2	676770	678145	1375	-	0
AT2G02540	2	683646	685309	1663	+	62
AT2G02550	2	687383	688764	1381	+	0
AT2G02560	2	689787	697596	7809	+	1487
AT2G02570	2	697950	700917	2967	-	938
AT2G02580	2	701945	703770	1825	+	2
AT2G02590	2	704917	706669	1752	+	220
AT2G02600	2	706795	706868	73	+	0
AT2G02610	2	710711	712819	2108	+	0
AT2G02620	2	717255	719380	2125	+	0
AT2G02630	2	723564	725620	2056	+	0
AT2G02640	2	732387	734271	1884	+	0
AT2G02650	2	735410	736546	1136	+	0
AT2G02660	2	738503	739769	1266	+	0
AT2G02670	2	742357	743302	945	+	0
AT2G02680	2	745774	748573	2799	+	0
AT2G02690	2	749918	751900	1982	+	0
AT2G02700	2	756442	757942	1500	+	0
AT2G02710	2	758692	761013	2321	-	690
AT2G02720	2	763010	765027	2017	+	1
AT2G02730	2	764546	767436	2890	-	183
AT2G02740	2	769343	771248	1905	+	298
AT2G02741	2	771376	771522	146	-	0
AT2G02750	2	771150	773540	2390	-	26
AT2G02760	2	773683	775371	1688	+	1329
AT2G02770	2	775481	779786	4305	-	251
AT2G02780	2	781846	784646	2800	-	530
AT2G02790	2	787914	790946	3032	+	474
AT2G02795	2	795895	796492	597	+	0
AT2G02800	2	795514	799443	3929	-	865
AT2G02810	2	801529	803436	1907	+	237
AT2G02820	2	804173	807208	3035	-	321
AT2G02830	2	808371	808872	501	+	0
AT2G02835	2	820436	821291	855	-	0
AT2G02840	2	821552	822858	1306	+	0
AT2G02850	2	826403	827812	1409	-	29
AT2G02860	2	828351	832455	4104	-	421
AT2G02870	2	837811	840153	2342	+	511
AT2G02880	2	841245	843429	2184	+	112
AT2G02890	2	843912	846616	2704	-	0
AT2G02900	2	846854	846927	73	-	0
AT2G02910	2	847175	849598	2423	-	293
AT2G02930	2	851163	852222	1059	-	1
AT2G02950	2	854946	856538	1592	-	271
AT2G02955	2	859452	862076	2624	+	63
AT2G02960	2	862086	864447	2361	-	542
AT2G02970	2	865069	868289	3220	-	588
AT2G02980	2	868358	870385	2027	+	140
AT2G02990	2	873505	874811	1306	+	3
AT2G03000	2	875232	877207	1975	+	0
AT2G03010	2	879246	881471	2225	+	29
AT2G03020	2	882644	884148	1504	-	8
AT2G03030	2	889763	890520	757	+	0
AT2G03040	2	892822	893572	750	-	0
AT2G03050	2	899689	900946	1257	-	132
AT2G03060	2	901142	904149	3007	+	174
AT2G03070	2	905618	909070	3452	+	419
AT2G03080	2	911691	914049	2358	+	0
AT2G03090	2	916853	918643	1790	-	504
AT2G03100	2	926808	929704	2896	-	0
AT2G03110	2	935335	936639	1304	+	19
AT2G03120	2	937419	940339	2920	+	981
AT2G03130	2	940743	941076	333	+	1
AT2G03140	2	941911	950328	8417	+	1429
AT2G03150	2	951932	959188	7256	+	1590
AT2G03160	2	959644	960247	603	+	0
AT2G03170	2	961321	961771	450	+	0
AT2G03180	2	962763	963126	363	+	0
AT2G03190	2	964213	964901	688	+	0
AT2G03200	2	966450	967918	1468	-	15
AT2G03210	2	968334	970018	1684	-	1
AT2G03220	2	970258	972407	2149	-	306
AT2G03230	2	972916	973375	459	+	0
AT2G03240	2	973412	977337	3925	-	341
AT2G03250	2	982172	986662	4490	-	0
AT2G03260	2	987933	992332	4399	-	10
AT2G03270	2	993755	996128	2373	+	248
AT2G03280	2	996087	998295	2208	-	192
AT2G03290	2	999421	1000606	1185	+	0
AT2G03291	2	1000728	1001741	1013	-	1
AT2G03300	2	1003467	1004222	755	-	0
AT2G03310	2	1006255	1007183	928	-	501
AT2G03320	2	1007381	1007945	564	+	2
AT2G03330	2	1008459	1014122	5663	+	145
AT2G03340	2	1014349	1017148	2799	-	597
AT2G03350	2	1019578	1021186	1608	-	818
AT2G03360	2	1022286	1024391	2105	-	2
AT2G03370	2	1024709	1027045	2336	-	0
AT2G03380	2	1028291	1030361	2070	+	20
AT2G03390	2	1030401	1032625	2224	-	1927
AT2G03410	2	1033597	1036009	2412	+	18
AT2G03420	2	1034997	1035969	972	-	0
AT2G03430	2	1036007	1037632	1625	-	217
AT2G03440	2	1039204	1040118	914	-	2446
AT2G03445	2	1040937	1041042	105	+	0
AT2G03450	2	1041387	1043667	2280	+	85
AT2G03460	2	1043620	1044992	1372	-	1
AT2G03470	2	1045451	1047684	2233	-	565
AT2G03480	2	1050841	1054613	3772	+	272
AT2G03490	2	1054717	1054790	73	-	0
AT2G03500	2	1059709	1062410	2701	+	145
AT2G03505	2	1064235	1065372	1137	+	47
AT2G03510	2	1066605	1069149	2544	+	687
AT2G03520	2	1069490	1071382	1892	+	13
AT2G03530	2	1071593	1073566	1973	+	426
AT2G03540	2	1073758	1074515	757	+	28
AT2G03550	2	1077035	1078083	1048	+	983
AT2G03560	2	1079638	1081376	1738	+	1
AT2G03565	2	1081591	1082003	412	+	0
AT2G03570	2	1085559	1085988	429	-	0
AT2G03580	2	1093263	1094481	1218	+	3
AT2G03590	2	1094756	1096968	2212	+	75
AT2G03600	2	1096986	1098826	1840	+	0
AT2G03610	2	1099069	1100202	1133	+	0
AT2G03620	2	1100338	1103495	3157	-	254
AT2G03630	2	1103204	1104230	1026	+	0
AT2G03640	2	1104306	1106867	2561	-	1083
AT2G03650	2	1109236	1110411	1175	-	0
AT2G03660	2	1113983	1114055	72	-	0
AT2G03667	2	1114126	1117439	3313	+	208
AT2G03670	2	1117506	1120436	2930	+	69
AT2G03680	2	1120799	1122055	1256	+	1830
AT2G03690	2	1121899	1123171	1272	-	329
AT2G03700	2	1123389	1123461	72	-	0
AT2G03710	2	1129267	1131838	2571	+	372
AT2G03720	2	1132169	1133379	1210	+	0
AT2G03730	2	1137610	1140186	2576	-	1206
AT2G03740	2	1142724	1143988	1264	-	0
AT2G03750	2	1147806	1149061	1255	-	1361
AT2G03760	2	1149336	1150663	1327	-	272
AT2G03770	2	1150870	1151845	975	-	0
AT2G03780	2	1152466	1154291	1825	-	381
AT2G03790	2	1154384	1154457	73	+	1
AT2G03800	2	1156712	1158934	2222	+	302
AT2G03810	2	1161028	1164573	3545	+	262
AT2G03820	2	1164956	1167029	2073	-	1016
AT2G03821	2	1167302	1168206	904	-	0
AT2G03822	2	1168199	1168373	174	+	0
AT2G03830	2	1171135	1172363	1228	+	0
AT2G03840	2	1173169	1174115	946	+	0
AT2G03850	2	1175580	1176702	1122	+	1
AT2G03860	2	1176898	1177637	739	+	0
AT2G03870	2	1179983	1181437	1454	+	687
AT2G03880	2	1181536	1183703	2167	+	11
AT2G03890	2	1185521	1188545	3024	+	1357
AT2G03900	2	1191785	1192996	1211	-	0
AT2G03910	2	1194701	1195599	898	-	0
AT2G03913	2	1197884	1198249	365	+	0
AT2G03915	2	1199310	1200432	1122	-	0
AT2G03920	2	1201317	1203687	2370	-	0
AT2G03930	2	1204919	1206249	1330	-	0
AT2G03931	2	1214427	1214843	416	+	0
AT2G03932	2	1213232	1213650	418	+	0
AT2G03933	2	1217567	1217932	365	+	0
AT2G03934	2	1219719	1220265	546	+	0
AT2G03935	2	1227748	1228433	685	-	0
AT2G03936	2	1221110	1221522	412	+	0
AT2G03937	2	1224388	1224753	365	+	0
AT2G03938	2	1215315	1215465	150	+	0
AT2G03940	2	1229287	1232499	3212	+	0
AT2G03950	2	1232665	1233185	520	-	0
AT2G03955	2	1238676	1239071	395	+	0
AT2G03958	2	1243662	1243992	330	+	0
AT2G03960	2	1246147	1249170	3023	-	0
AT2G03970	2	1253608	1254478	870	+	0
AT2G03972	2	1255247	1256445	1198	-	0
AT2G03980	2	1259198	1262552	3354	+	410
AT2G03990	2	1265117	1267026	1909	+	0
AT2G04000	2	1267761	1268337	576	-	0
AT2G04010	2	1269098	1271157	2059	-	0
AT2G04020	2	1274426	1275524	1098	+	0
AT2G04025	2	1276776	1277734	958	-	0
AT2G04030	2	1281840	1286104	4264	+	6686
AT2G04031	2	1304159	1304779	620	-	0
AT2G04032	2	1289831	1291383	1552	+	134
AT2G04033	2	1293111	1293488	377	+	3
AT2G04034	2	1297160	1297543	383	+	0
AT2G04035	2	1293575	1294533	958	-	0
AT2G04036	2	1327908	1330024	2116	+	0
AT2G04037	2	1305662	1306136	474	-	0
AT2G04038	2	1331918	1332419	501	+	8
AT2G04039	2	1333261	1334566	1305	+	4365
AT2G04040	2	1334511	1336489	1978	-	2
AT2G04041	2	1308088	1308544	456	-	0
AT2G04042	2	1298495	1300722	2227	+	0
AT2G04043	2	1312583	1314038	1455	+	0
AT2G04045	2	1314762	1315302	540	+	0
AT2G04046	2	1315859	1316296	437	+	0
AT2G04047	2	1317152	1317386	234	+	0
AT2G04050	2	1337385	1339270	1885	-	4
AT2G04060	2	1342136	1345164	3028	-	0
AT2G04063	2	1349757	1350177	420	-	0
AT2G04066	2	1352886	1353517	631	-	0
AT2G04070	2	1353754	1355790	2036	-	17
AT2G04080	2	1357188	1359253	2065	-	249
AT2G04090	2	1362652	1364690	2038	-	1
AT2G04100	2	1376889	1379130	2241	-	32
AT2G04110	2	1382634	1383495	861	-	518
AT2G04115	2	1385448	1386071	623	+	0
AT2G04120	2	1388193	1388947	754	+	0
AT2G04130	2	1389157	1390976	1819	-	0
AT2G04135	2	1391929	1392938	1009	-	0
AT2G04140	2	1398946	1399228	282	+	0
AT2G04150	2	1400043	1401282	1239	+	0
AT2G04160	2	1401267	1407745	6478	-	939
AT2G04170	2	1417181	1419517	2336	-	238
AT2G04180	2	1422037	1425392	3355	+	0
AT2G04190	2	1427480	1430342	2862	-	0
AT2G04200	2	1432566	1434934	2368	+	0
AT2G04210	2	1436127	1437590	1463	+	0
AT2G04220	2	1445400	1446507	1107	+	0
AT2G04230	2	1446863	1449100	2237	-	570
AT2G04235	2	1449413	1455237	5824	+	173
AT2G04240	2	1461629	1462937	1308	-	244
AT2G04250	2	1469299	1469842	543	-	0
AT2G04260	2	1470756	1471477	721	+	0
AT2G04270	2	1474678	1480586	5908	+	1193
AT2G04280	2	1480067	1482089	2022	-	1064
AT2G04290	2	1485407	1490783	5376	-	0
AT2G04300	2	1493008	1497016	4008	+	0
AT2G04305	2	1501407	1503785	2378	-	303
AT2G04310	2	1506118	1508509	2391	+	0
AT2G04320	2	1509376	1509910	534	+	0
AT2G04330	2	1510449	1513142	2693	-	0
AT2G04340	2	1513511	1515540	2029	+	269
AT2G04350	2	1515804	1519308	3504	+	1953
AT2G04360	2	1519392	1521056	1664	-	817
AT2G04370	2	1523762	1524121	359	-	0
AT2G04378	2	1525330	1526875	1545	-	356
AT2G04380	2	1525641	1526767	1126	+	0
AT2G04390	2	1527015	1528493	1478	+	677
AT2G04395	2	1529082	1529954	872	-	6
AT2G04400	2	1531147	1533737	2590	+	958
AT2G04410	2	1533696	1535118	1422	-	826
AT2G04420	2	1535488	1536250	762	+	12
AT2G04425	2	1536974	1537504	530	-	0
AT2G04430	2	1538900	1541094	2194	+	72
AT2G04440	2	1541510	1542729	1219	+	0
AT2G04450	2	1543319	1545462	2143	+	104
AT2G04460	2	1547537	1548999	1462	-	1
AT2G04470	2	1550132	1553029	2897	-	0
AT2G04480	2	1554281	1555514	1233	-	0
AT2G04490	2	1557259	1561743	4484	-	3
AT2G04495	2	1564165	1565106	941	+	9
AT2G04500	2	1568283	1570271	1988	+	2
AT2G04510	2	1570496	1571827	1331	-	0
AT2G04515	2	1573636	1574478	842	+	0
AT2G04520	2	1574591	1575863	1272	-	1416
AT2G04530	2	1576708	1578741	2033	+	353
AT2G04540	2	1581415	1584688	3273	-	260
AT2G04550	2	1588359	1590166	1807	+	439
AT2G04560	2	1590305	1592667	2362	-	86
AT2G04570	2	1594672	1596349	1677	+	531
AT2G04580	2	1599681	1600833	1152	-	0
AT2G04590	2	1607034	1607683	649	-	0
AT2G04600	2	1608075	1609758	1683	-	0
AT2G04610	2	1609934	1610372	438	+	0
AT2G04620	2	1610505	1612902	2397	-	184
AT2G04622	2	1613685	1614019	334	-	0
AT2G04625	2	1618415	1618728	313	-	0
AT2G04630	2	1618935	1620336	1401	-	553
AT2G04650	2	1621787	1624593	2806	-	111
AT2G04660	2	1624740	1629162	4422	+	247
AT2G04670	2	1631696	1636084	4388	-	0
AT2G04675	2	1637482	1638647	1165	-	0
AT2G04680	2	1640139	1642209	2070	+	0
AT2G04690	2	1644496	1646355	1859	+	879
AT2G04700	2	1646806	1648560	1754	+	3914
AT2G04710	2	1650511	1651756	1245	-	0
AT2G04720	2	1653006	1654308	1302	-	0
AT2G04730	2	1654499	1655699	1200	-	0
AT2G04740	2	1657120	1659689	2569	+	317
AT2G04750	2	1659761	1662748	2987	-	0
AT2G04760	2	1665779	1668389	2610	+	0
AT2G04770	2	1671115	1672075	960	+	0
AT2G04780	2	1676741	1678455	1714	+	1306
AT2G04790	2	1679515	1680543	1028	+	521
AT2G04795	2	1682952	1683475	523	+	121
AT2G04800	2	1687195	1687817	622	-	10
AT2G04810	2	1688772	1689966	1194	+	0
AT2G04820	2	1693576	1695310	1734	-	0
AT2G04830	2	1695354	1695856	502	+	0
AT2G04840	2	1697008	1698240	1232	+	7
AT2G04842	2	1698465	1701271	2806	-	3762
AT2G04845	2	1702220	1704003	1783	-	207
AT2G04850	2	1704282	1705778	1496	+	213
AT2G04852	2	1705147	1706465	1318	-	2
AT2G04860	2	1706786	1708865	2079	-	37
AT2G04865	2	1711595	1714877	3282	+	516
AT2G04870	2	1716167	1716386	219	-	0
AT2G04880	2	1717887	1720526	2639	+	746
AT2G04890	2	1720360	1722604	2244	-	187
AT2G04900	2	1722480	1723831	1351	+	499
AT2G04910	2	1723938	1724354	416	-	0
AT2G04920	2	1726137	1727268	1131	+	0
AT2G04925	2	1729688	1730190	502	-	1
AT2G04930	2	1733637	1734471	834	-	0
AT2G04940	2	1736484	1740388	3904	-	362
AT2G04950	2	1743181	1745150	1969	+	0
AT2G04970	2	1745972	1750207	4235	-	0
AT2G04980	2	1751963	1756568	4605	-	0
AT2G04990	2	1758935	1761353	2418	+	0
AT2G05000	2	1761803	1762378	575	-	0
AT2G05010	2	1763644	1765840	2196	-	0
AT2G05020	2	1769698	1772524	2826	+	0
AT2G05025	2	1773258	1774761	1503	+	0
AT2G05030	2	1781885	1782503	618	+	0
AT2G05040	2	1783118	1786463	3345	+	2
AT2G05050	2	1794034	1795084	1050	+	0
AT2G05060	2	1798154	1799102	948	+	0
AT2G05070	2	1799233	1800392	1159	-	54694
AT2G05080	2	1805750	1809975	4225	-	0
AT2G05082	2	1812133	1813300	1167	-	0
AT2G05084	2	1814326	1815487	1161	-	0
AT2G05087	2	1816325	1817535	1210	-	0
AT2G05090	2	1818141	1820701	2560	-	0
AT2G05100	2	1823239	1824425	1186	-	62973
AT2G05110	2	1828027	1833219	5192	-	0
AT2G05115	2	1834465	1835922	1457	-	0
AT2G05117	2	1838591	1839014	423	-	0
AT2G05120	2	1841886	1846912	5026	-	247
AT2G05130	2	1849016	1850496	1480	-	0
AT2G05133	2	1851691	1852328	637	-	1
AT2G05140	2	1853934	1854903	969	+	0
AT2G05150	2	1857569	1857927	358	+	0
AT2G05160	2	1858542	1861895	3353	-	285
AT2G05170	2	1869876	1873812	3936	+	979
AT2G05171	2	1874039	1874997	958	+	2
AT2G05180	2	1875389	1876794	1405	+	5
AT2G05185	2	1876937	1878219	1282	+	7
AT2G05190	2	1878724	1879018	294	+	0
AT2G05200	2	1883051	1887007	3956	+	0
AT2G05210	2	1890935	1894367	3432	+	446
AT2G05220	2	1894558	1896036	1478	-	1196
AT2G05230	2	1899506	1902802	3296	-	0
AT2G05240	2	1907461	1911569	4108	-	0
AT2G05250	2	1913337	1916623	3286	-	3
AT2G05260	2	1918288	1920042	1754	+	99
AT2G05270	2	1920701	1921116	415	-	3
AT2G05280	2	1921240	1925279	4039	-	5
AT2G05290	2	1924849	1926681	1832	-	2
AT2G05294	2	1928529	1928622	93	-	0
AT2G05300	2	1931241	1933010	1769	+	51
AT2G05310	2	1933271	1934212	941	-	3054
AT2G05320	2	1936015	1937464	1449	+	167
AT2G05330	2	1938617	1939470	853	-	0
AT2G05335	2	1942556	1943042	486	+	0
AT2G05340	2	1946842	1947592	750	+	0
AT2G05350	2	1949613	1954740	5127	+	0
AT2G05360	2	1956114	1959303	3189	-	0
AT2G05370	2	1960412	1961840	1428	-	0
AT2G05380	2	1966815	1968037	1222	+	797
AT2G05390	2	1970708	1974726	4018	+	0
AT2G05400	2	1974885	1976570	1685	+	0
AT2G05410	2	1976917	1978553	1636	+	0
AT2G05420	2	1983900	1985341	1441	+	0
AT2G05430	2	1985993	1987266	1273	+	0
AT2G05435	2	1989193	1989867	674	+	0
AT2G05440	2	1993081	1994166	1085	+	133
AT2G05441	2	1994361	1995546	1185	+	1
AT2G05450	2	1996201	2001144	4943	+	0
AT2G05460	2	2001505	2002195	690	+	0
AT2G05470	2	2002869	2003564	695	+	0
AT2G05475	2	2004333	2005026	693	+	0
AT2G05480	2	2005387	2006337	950	-	0
AT2G05490	2	2006872	2009701	2829	-	0
AT2G05500	2	2014367	2015406	1039	-	0
AT2G05510	2	2015705	2016749	1044	+	0
AT2G05518	2	2023294	2023995	701	+	13
AT2G05520	2	2026161	2027117	956	+	7806
AT2G05530	2	2029711	2030544	833	+	0
AT2G05540	2	2033155	2034217	1062	+	124
AT2G05550	2	2036683	2040701	4018	-	0
AT2G05560	2	2042470	2047377	4907	+	0
AT2G05562	2	2047633	2048428	795	+	0
AT2G05564	2	2049208	2049904	696	+	0
AT2G05567	2	2050348	2051038	690	+	0
AT2G05570	2	2051568	2053475	1907	-	0
AT2G05580	2	2055548	2056700	1152	+	0
AT2G05590	2	2067096	2069206	2110	+	313
AT2G05600	2	2072645	2073547	902	+	0
AT2G05610	2	2075671	2078500	2829	-	0
AT2G05620	2	2081008	2081858	850	-	5788
AT2G05630	2	2082985	2084882	1897	-	189
AT2G05632	2	2087144	2088130	986	-	196
AT2G05635	2	2089483	2090454	971	+	0
AT2G05640	2	2091128	2097116	5988	-	0
AT2G05642	2	2098086	2101167	3081	-	4
AT2G05645	2	2101496	2102111	615	-	0
AT2G05647	2	2104361	2104646	285	-	0
AT2G05660	2	2108120	2114699	6579	-	4
AT2G05670	2	2115723	2116777	1054	+	0
AT2G05680	2	2122962	2125485	2523	+	0
AT2G05690	2	2125592	2128107	2515	-	0
AT2G05700	2	2134583	2136771	2188	+	0
AT2G05710	2	2141398	2146678	5280	+	8091
AT2G05715	2	2146546	2147042	496	-	0
AT2G05720	2	2147191	2148215	1024	+	0
AT2G05730	2	2153049	2153413	364	-	0
AT2G05740	2	2158244	2158727	483	-	0
AT2G05750	2	2164356	2166858	2502	+	0
AT2G05752	2	2169304	2170528	1224	-	0
AT2G05753	2	2171389	2171936	547	-	1
AT2G05755	2	2170882	2173760	2878	+	201
AT2G05760	2	2180918	2183904	2986	+	123
AT2G05765	2	2184566	2184645	79	-	18
AT2G05770	2	2187279	2188403	1124	-	0
AT2G05780	2	2193599	2196125	2526	-	0
AT2G05786	2	2198270	2198405	135	-	0
AT2G05790	2	2199218	2201486	2268	+	2571
AT2G05800	2	2202627	2205721	3094	+	0
AT2G05801	2	2206723	2207100	377	-	0
AT2G05803	2	2208696	2208834	138	-	0
AT2G05810	2	2214011	2217159	3148	-	20
AT2G05812	2	2215235	2217150	1915	+	0
AT2G05820	2	2220294	2220915	621	-	0
AT2G05830	2	2229601	2232106	2505	+	1360
AT2G05840	2	2234091	2236294	2203	+	1303
AT2G05845	2	2236520	2238590	2070	-	0
AT2G05850	2	2242680	2244487	1807	-	1
AT2G05860	2	2246958	2248108	1150	-	0
AT2G05870	2	2249080	2249999	919	-	0
AT2G05880	2	2251715	2252970	1255	-	0
AT2G05890	2	2253934	2256078	2144	-	0
AT2G05900	2	2256969	2257908	939	+	1
AT2G05910	2	2258292	2259391	1099	-	13
AT2G05914	2	2263150	2264542	1392	-	7
AT2G05915	2	2263815	2264265	450	+	0
AT2G05920	2	2269514	2272229	2715	-	3413
AT2G05930	2	2274782	2277843	3061	+	2
AT2G05935	2	2278834	2282788	3954	+	7
AT2G05940	2	2287237	2289307	2070	-	699
AT2G05950	2	2297815	2298721	906	+	22
AT2G05960	2	2302802	2307974	5172	+	0
AT2G05970	2	2308650	2309784	1134	-	0
AT2G05980	2	2313802	2317933	4131	-	0
AT2G05985	2	2318271	2319705	1434	+	0
AT2G05990	2	2322221	2325146	2925	+	2926
AT2G05995	2	2325775	2326876	1101	+	13
AT2G06000	2	2327385	2329691	2306	-	256
AT2G06002	2	2330775	2331479	704	+	5
AT2G06005	2	2332546	2336156	3610	+	112
AT2G06010	2	2336813	2338902	2089	+	303
AT2G06020	2	2342534	2346207	3673	+	0
AT2G06025	2	2348135	2352157	4022	+	1123
AT2G06040	2	2352153	2355559	3406	-	147
AT2G06045	2	2358726	2359113	387	+	0
AT2G06050	2	2359113	2362302	3189	-	472
AT2G06060	2	2364270	2365961	1691	+	0
AT2G06070	2	2366145	2369342	3197	+	0
AT2G06080	2	2369629	2371361	1732	+	0
AT2G06090	2	2371606	2372014	408	-	0
AT2G06095	2	2373521	2374745	1224	+	0
AT2G06100	2	2375866	2378098	2232	+	0
AT2G06110	2	2378199	2381130	2931	-	0
AT2G06120	2	2383059	2384982	1923	+	0
AT2G06125	2	2385511	2386021	510	-	0
AT2G06130	2	2387604	2389725	2121	-	0
AT2G06140	2	2392859	2394904	2045	+	0
AT2G06150	2	2402283	2405055	2772	-	0
AT2G06160	2	2405455	2408255	2800	-	0
AT2G06165	2	2409741	2410485	744	-	0
AT2G06166	2	2411004	2411656	652	+	0
AT2G06170	2	2415159	2418279	3120	+	0
AT2G06180	2	2419318	2422450	3132	-	0
AT2G06190	2	2423151	2424091	940	+	0
AT2G06200	2	2426270	2427323	1053	+	19
AT2G06210	2	2428902	2436687	7785	-	1052
AT2G06220	2	2437306	2439691	2385	+	0
AT2G06230	2	2440436	2440733	297	-	0
AT2G06235	2	2441603	2442163	560	+	0
AT2G06240	2	2444403	2447594	3191	-	0
AT2G06245	2	2447769	2448513	744	+	0
AT2G06250	2	2449508	2450772	1264	+	0
AT2G06255	2	2457572	2459811	2239	+	22
AT2G06260	2	2463008	2465242	2234	+	0
AT2G06270	2	2468807	2470893	2086	+	0
AT2G06280	2	2471484	2472485	1001	+	0
AT2G06285	2	2474011	2474764	753	+	0
AT2G06290	2	2475751	2484523	8772	+	0
AT2G06296	2	2484909	2485731	822	+	0
AT2G06303	2	2487809	2488538	729	+	0
AT2G06310	2	2489660	2494283	4623	+	0
AT2G06330	2	2495460	2497284	1824	+	0
AT2G06335	2	2499008	2499980	972	+	0
AT2G06340	2	2502769	2504333	1564	-	0
AT2G06350	2	2505324	2510457	5133	-	0
AT2G06370	2	2512990	2513365	375	-	0
AT2G06380	2	2514939	2515351	412	-	0
AT2G06390	2	2516585	2516712	127	-	0
AT2G06400	2	2523644	2527757	4113	-	0
AT2G06410	2	2531434	2534389	2955	-	0
AT2G06420	2	2538742	2540365	1623	+	0
AT2G06430	2	2543160	2547826	4666	+	0
AT2G06440	2	2550124	2554730	4606	+	0
AT2G06450	2	2555553	2557522	1969	-	0
AT2G06460	2	2563266	2564309	1043	+	0
AT2G06470	2	2564452	2569288	4836	-	0
AT2G06480	2	2570236	2570643	407	+	0
AT2G06490	2	2572216	2574502	2286	-	0
AT2G06500	2	2580717	2583223	2506	-	0
AT2G06510	2	2585017	2587686	2669	+	105
AT2G06520	2	2587728	2588358	630	-	54027
AT2G06530	2	2588544	2590453	1909	-	880
AT2G06540	2	2592441	2597780	5339	-	1
AT2G06541	2	2598221	2600326	2105	-	0
AT2G06550	2	2602741	2603484	743	-	0
AT2G06555	2	2604147	2604927	780	-	0
AT2G06560	2	2611033	2616254	5221	+	9
AT2G06562	2	2617553	2619173	1620	+	0
AT2G06570	2	2622602	2624902	2300	-	0
AT2G06580	2	2625042	2628033	2991	+	0
AT2G06590	2	2633128	2635227	2099	+	0
AT2G06600	2	2639597	2642549	2952	+	0
AT2G06610	2	2642997	2643729	732	+	0
AT2G06620	2	2644420	2644906	486	-	0
AT2G06630	2	2645687	2646383	696	-	0
AT2G06640	2	2647082	2647769	687	-	0
AT2G06645	2	2647990	2649647	1657	-	0
AT2G06650	2	2649057	2652090	3033	+	0
AT2G06660	2	2656413	2657265	852	-	0
AT2G06667	2	2660526	2660715	189	-	0
AT2G06670	2	2661492	2663643	2151	+	0
AT2G06680	2	2667276	2669811	2535	+	0
AT2G06690	2	2670234	2671237	1003	+	0
AT2G06700	2	2671717	2672371	654	-	0
AT2G06710	2	2673154	2675230	2076	-	0
AT2G06715	2	2675489	2677993	2504	-	0
AT2G06720	2	2678826	2681289	2463	-	0
AT2G06740	2	2681658	2685131	3473	-	0
AT2G06750	2	2685969	2687731	1762	-	0
AT2G06760	2	2691302	2694916	3614	-	0
AT2G06770	2	2703901	2704988	1087	-	0
AT2G06775	2	2705825	2706212	387	-	0
AT2G06780	2	2709950	2712872	2922	-	0
AT2G06790	2	2713392	2716565	3173	+	0
AT2G06800	2	2717358	2719979	2621	+	0
AT2G06810	2	2720744	2723009	2265	-	0
AT2G06820	2	2726655	2727484	829	-	0
AT2G06822	2	2728707	2729075	368	-	0
AT2G06830	2	2739870	2743438	3568	-	0
AT2G06840	2	2747348	2752133	4785	+	0
AT2G06845	2	2754665	2756008	1343	+	0
AT2G06850	2	2763525	2765720	2195	+	2594
AT2G06860	2	2766355	2772445	6090	+	0
AT2G06870	2	2775702	2779187	3485	-	0
AT2G06875	2	2780107	2781442	1335	+	0
AT2G06880	2	2782434	2785689	3255	+	0
AT2G06885	2	2790226	2792797	2571	+	0
AT2G06890	2	2795096	2799273	4177	+	0
AT2G06900	2	2800667	2802977	2310	+	0
AT2G06902	2	2803447	2804634	1187	+	0
AT2G06904	2	2806624	2807368	744	+	0
AT2G06906	2	2807414	2807967	553	-	0
AT2G06908	2	2815397	2816349	952	+	0
AT2G06910	2	2818438	2821477	3039	+	1
AT2G06912	2	2826241	2826931	690	+	0
AT2G06914	2	2827623	2828100	477	+	0
AT2G06917	2	2829210	2829798	588	+	0
AT2G06920	2	2832082	2836514	4432	+	5
AT2G06922	2	2837026	2838337	1311	+	0
AT2G06925	2	2842352	2843301	949	-	203
AT2G06930	2	2845312	2849281	3969	-	0
AT2G06940	2	2854630	2855710	1080	+	0
AT2G06950	2	2859225	2863434	4209	-	700
AT2G06960	2	2867671	2870352	2681	-	0
AT2G06965	2	2875033	2876983	1950	-	0
AT2G06967	2	2877623	2880656	3033	-	0
AT2G06973	2	2882423	2882717	294	-	0
AT2G06980	2	2883424	2886166	2742	+	0
AT2G06983	2	2888950	2889382	432	+	0
AT2G06985	2	2893060	2893306	246	+	0
AT2G06990	2	2894939	2901078	6139	+	620
AT2G07000	2	2901869	2902290	421	-	4
AT2G07010	2	2902601	2906953	4352	+	0
AT2G07020	2	2908472	2911198	2726	-	0
AT2G07030	2	2913628	2914781	1153	+	0
AT2G07040	2	2916537	2918942	2405	+	0
AT2G07042	2	2919952	2922249	2297	-	103
AT2G07050	2	2924446	2930672	6226	+	2779
AT2G07070	2	2932227	2934314	2087	-	2
AT2G07080	2	2936238	2938827	2589	+	26
AT2G07090	2	2941432	2941984	552	+	0
AT2G07100	2	2942232	2945080	2848	-	0
AT2G07110	2	2952609	2953208	599	-	1
AT2G07120	2	2953604	2954722	1118	-	0
AT2G07130	2	2955676	2956900	1224	+	1
AT2G07140	2	2957560	2959851	2291	+	21
AT2G07150	2	2962952	2964182	1230	+	0
AT2G07155	2	2968104	2968617	513	+	0
AT2G07160	2	2969530	2974603	5073	+	0
AT2G07170	2	2975039	2978820	3781	+	156
AT2G07180	2	2980898	2983602	2704	-	716
AT2G07185	2	2986183	2987302	1119	+	0
AT2G07190	2	2987366	2988945	1579	+	0
AT2G07200	2	2989204	2989878	674	+	0
AT2G07210	2	2990397	2992102	1705	-	0
AT2G07212	2	2994237	2995474	1237	+	0
AT2G07213	2	2996581	2998054	1473	+	1
AT2G07215	2	2996775	2997889	1114	-	0
AT2G07220	2	3000895	3001685	790	+	0
AT2G07230	2	3002169	3004642	2473	+	0
AT2G07240	2	3007101	3012333	5232	-	0
AT2G07250	2	3015825	3018650	2825	+	0
AT2G07260	2	3019655	3021698	2043	-	0
AT2G07270	2	3024740	3025636	896	-	0
AT2G07280	2	3026397	3029353	2956	+	0
AT2G07290	2	3029560	3030035	475	+	0
AT2G07300	2	3030797	3031774	977	+	0
AT2G07310	2	3034796	3036387	1591	-	0
AT2G07320	2	3037412	3042860	5448	-	0
AT2G07330	2	3043126	3044779	1653	-	0
AT2G07340	2	3045558	3046744	1186	+	424
AT2G07360	2	3047251	3057196	9945	-	1634
AT2G07362	2	3058917	3059043	126	+	0
AT2G07363	2	3059156	3059306	150	-	0
AT2G07365	2	3060290	3060852	562	-	0
AT2G07380	2	3062344	3064837	2493	+	0
AT2G07390	2	3067147	3067740	593	+	0
AT2G07395	2	3068216	3073286	5070	-	0
AT2G07400	2	3073732	3078367	4635	-	0
AT2G07410	2	3079609	3083902	4293	-	0
AT2G07420	2	3084467	3088832	4365	-	0
AT2G07430	2	3089467	3090731	1264	-	0
AT2G07440	2	3093820	3094750	930	-	0
AT2G07450	2	3098330	3101095	2765	+	0
AT2G07455	2	3101926	3103849	1923	+	0
AT2G07460	2	3107211	3109250	2039	+	0
AT2G07470	2	3111538	3112023	485	-	1
AT2G07480	2	3113354	3114636	1282	-	0
AT2G07483	2	3115896	3116557	661	+	0
AT2G07486	2	3117079	3117673	594	-	0
AT2G07490	2	3120078	3121379	1301	+	0
AT2G07500	2	3122307	3125129	2822	+	0
AT2G07505	2	3125670	3126173	503	+	0
AT2G07510	2	3126521	3130605	4084	-	0
AT2G07520	2	3135111	3135780	669	+	0
AT2G07521	2	3136616	3136766	150	+	0
AT2G07530	2	3144614	3145727	1113	+	0
AT2G07540	2	3151867	3155956	4089	-	1
AT2G07550	2	3161438	3165509	4071	-	0
AT2G07560	2	3169971	3174012	4041	-	0
AT2G07570	2	3175493	3179517	4024	+	0
AT2G07580	2	3181873	3183672	1799	+	0
AT2G07590	2	3183810	3185597	1787	-	0
AT2G07599	2	3348795	3351212	2417	-	2
AT2G07600	2	3188395	3190016	1621	-	0
AT2G07620	2	3200465	3206975	6510	-	0
AT2G07630	2	3208709	3210809	2100	-	0
AT2G07635	2	3214011	3217563	3552	+	0
AT2G07640	2	3220738	3221422	684	+	0
AT2G07650	2	3222934	3225703	2769	-	0
AT2G07660	2	3227033	3231700	4667	-	0
AT2G07663	2	3403716	3404046	330	-	0
AT2G07664	2	3260446	3260769	323	+	0
AT2G07666	2	3505999	3506320	321	+	0
AT2G07667	2	3364416	3366557	2141	+	2
AT2G07669	2	3283223	3283553	330	+	0
AT2G07670	2	3506864	3507323	459	+	0
AT2G07671	2	3251664	3252113	449	-	0
AT2G07672	2	3257584	3258064	480	+	0
AT2G07673	2	3266577	3266898	321	+	0
AT2G07674	2	3269150	3269906	756	+	1
AT2G07675	2	3270409	3270787	378	+	0
AT2G07676	2	3272618	3272975	357	+	0
AT2G07677	2	3278375	3280384	2009	+	5
AT2G07678	2	3281096	3281834	738	+	0
AT2G07680	2	3514744	3522491	7747	+	780
AT2G07681	2	3287551	3292366	4815	+	0
AT2G07682	2	3292515	3297403	4888	-	0
AT2G07683	2	3301882	3303367	1485	+	1
AT2G07684	2	3262234	3262345	111	-	1
AT2G07685	2	3307941	3309231	1290	+	0
AT2G07686	2	3309361	3311374	2013	-	1
AT2G07687	2	3311653	3312651	998	-	5
AT2G07688	2	3331569	3332664	1095	-	0
AT2G07689	2	3336108	3336753	645	+	1
AT2G07690	2	3523162	3527460	4298	-	566
AT2G07691	2	3339906	3340317	411	-	0
AT2G07692	2	3340705	3341544	839	-	0
AT2G07693	2	3341391	3342812	1421	+	0
AT2G07694	2	3344337	3345303	966	-	0
AT2G07695	2	3346950	3347826	876	+	0
AT2G07696	2	3351049	3351881	832	-	1
AT2G07697	2	3354013	3357474	3461	-	1
AT2G07698	2	3361473	3364127	2654	+	3
AT2G07699	2	3368150	3369308	1158	+	0
AT2G07700	2	3536600	3537580	980	+	0
AT2G07701	2	3371831	3372152	321	+	0
AT2G07702	2	3372696	3373155	459	+	0
AT2G07703	2	3375515	3375878	363	+	0
AT2G07704	2	3379161	3379885	724	-	0
AT2G07705	2	3380743	3380944	201	+	0
AT2G07706	2	3381900	3386102	4202	-	1
AT2G07707	2	3386291	3386768	477	+	0
AT2G07708	2	3386850	3388493	1643	+	11
AT2G07709	2	3388453	3394516	6063	+	213
AT2G07710	2	3554679	3555132	453	+	0
AT2G07711	2	3397157	3399434	2277	-	55
AT2G07712	2	3400729	3402757	2028	-	0
AT2G07713	2	3407217	3407586	369	+	0
AT2G07714	2	3407670	3408506	836	-	0
AT2G07715	2	3410596	3413161	2565	+	38
AT2G07716	2	3413954	3414838	884	+	0
AT2G07717	2	3418228	3424177	5949	+	44
AT2G07718	2	3426262	3427204	942	+	0
AT2G07719	2	3432794	3433495	701	-	2
AT2G07720	2	3557474	3558188	714	+	0
AT2G07721	2	3434481	3434994	513	-	0
AT2G07722	2	3438741	3439161	420	+	0
AT2G07723	2	3441920	3444238	2318	-	20
AT2G07724	2	3446393	3446717	324	-	0
AT2G07725	2	3448313	3449059	746	+	3
AT2G07726	2	3448960	3449179	219	+	2
AT2G07727	2	3450577	3452044	1467	+	5
AT2G07728	2	3453685	3456127	2442	+	1
AT2G07729	2	3459264	3460129	865	-	0
AT2G07730	2	3566139	3569597	3458	-	0
AT2G07731	2	3467198	3468078	880	-	2
AT2G07732	2	3468167	3468774	607	-	0
AT2G07733	2	3470314	3471873	1559	-	2
AT2G07734	2	3472304	3473692	1388	-	0
AT2G07735	2	3479611	3480000	389	-	0
AT2G07736	2	3480150	3480633	483	-	0
AT2G07737	2	3481084	3482066	982	-	0
AT2G07738	2	3492338	3492786	448	-	0
AT2G07739	2	3495510	3496110	600	-	0
AT2G07740	2	3570260	3571573	1313	-	0
AT2G07741	2	3502318	3503476	1158	+	0
AT2G07742	2	3239656	3239728	72	-	0
AT2G07743	2	3255831	3255905	74	-	0
AT2G07744	2	3234484	3237358	2874	-	0
AT2G07745	2	3268806	3268886	80	+	0
AT2G07746	2	3276439	3276511	72	+	0
AT2G07747	2	3244556	3245159	603	-	0
AT2G07748	2	3280862	3280936	74	+	0
AT2G07749	2	3247233	3249357	2124	+	0
AT2G07750	2	3576464	3580525	4061	+	1
AT2G07751	2	3270007	3270364	357	+	0
AT2G07752	2	3303243	3303315	72	-	0
AT2G07753	2	3303353	3303428	75	-	0
AT2G07754	2	3303784	3303822	38	-	0
AT2G07755	2	3328669	3328742	73	-	0
AT2G07756	2	3444362	3444434	72	-	0
AT2G07757	2	3452976	3453063	87	+	0
AT2G07758	2	3462077	3462151	74	+	0
AT2G07759	2	3494381	3494419	38	+	0
AT2G07760	2	3584419	3586278	1859	-	0
AT2G07761	2	3494775	3494850	75	+	0
AT2G07762	2	3495011	3495086	75	+	0
AT2G07763	2	3495441	3495512	71	+	0
AT2G07764	2	3496439	3496511	72	+	0
AT2G07765	2	3497357	3497440	83	+	0
AT2G07766	2	3503521	3503608	87	+	0
AT2G07767	2	3272148	3272518	370	+	5
AT2G07768	2	3273583	3274154	571	+	0
AT2G07769	2	3275009	3275362	353	+	0
AT2G07770	2	3586862	3588942	2080	+	0
AT2G07771	2	3239692	3240463	771	-	0
AT2G07772	2	3300977	3301804	827	-	0
AT2G07773	2	3240837	3241659	822	-	0
AT2G07774	2	3303765	3304573	808	-	9
AT2G07775	2	3483317	3484062	745	+	0
AT2G07776	2	3246018	3246901	883	-	5
AT2G07777	2	3250756	3251545	789	-	0
AT2G07778	2	3290965	3291037	72	+	0
AT2G07779	2	3254776	3255370	594	-	0
AT2G07780	2	3590813	3593227	2414	-	0
AT2G07783	2	3297895	3300043	2148	+	5
AT2G07784	2	3317797	3318634	837	-	0
AT2G07785	2	3348002	3348904	902	+	0
AT2G07786	2	3399656	3399912	256	-	0
AT2G07787	2	3476927	3478704	1777	+	2
AT2G07788	2	3543195	3545673	2478	+	0
AT2G07789	2	3548049	3550854	2805	-	0
AT2G07790	2	3552886	3554494	1608	-	0
AT2G07791	2	3559148	3561620	2472	-	0
AT2G07792	2	3332677	3332759	82	+	0
AT2G07793	2	3369353	3369440	87	+	0
AT2G07794	2	3383403	3383477	74	-	0
AT2G07795	2	3493225	3494382	1157	+	0
AT2G07798	2	3357618	3361102	3484	+	0
AT2G07799	2	3466755	3467061	306	+	0
AT2G07806	2	3484746	3489421	4675	+	1
AT2G07807	2	3461921	3462035	114	+	0
AT2G07808	2	3336947	3337336	389	+	1
AT2G07809	2	3430671	3430992	321	+	0
AT2G07811	2	3313597	3314901	1304	-	15
AT2G07812	2	3249076	3249394	318	-	0
AT2G07813	2	3353250	3353862	612	+	0
AT2G07815	2	3443687	3445582	1895	-	1
AT2G07820	2	3457212	3457479	267	-	0
AT2G07825	2	3474400	3474598	198	-	0
AT2G07826	2	3361109	3361415	306	+	0
AT2G07827	2	3474995	3476845	1850	+	1
AT2G07830	2	3476155	3476278	123	-	0
AT2G07835	2	3501813	3502294	481	-	0
AT2G07880	2	3604527	3605049	522	+	0
AT2G07981	2	3614985	3617716	2731	+	0
AT2G08986	2	3618057	3626460	8403	+	0
AT2G09187	2	3639602	3646073	6471	-	0
AT2G09388	2	3651155	3652235	1080	+	0
AT2G09589	2	3654410	3656876	2466	-	0
AT2G09790	2	3658228	3659011	783	+	0
AT2G09795	2	3670908	3672729	1821	-	89
AT2G09800	2	3667252	3672394	5142	+	0
AT2G09810	2	3675908	3676326	418	-	0
AT2G09820	2	3681188	3685396	4208	-	0
AT2G09830	2	3687671	3691747	4076	-	0
AT2G09838	2	3703303	3703492	189	-	0
AT2G09840	2	3704576	3705594	1018	-	0
AT2G09850	2	3707757	3710964	3207	+	1
AT2G09860	2	3722448	3726114	3666	-	0
AT2G09862	2	3727287	3727797	510	+	0
AT2G09865	2	3729542	3731042	1500	-	0
AT2G09870	2	3733171	3738079	4908	+	0
AT2G09880	2	3739142	3739647	505	+	0
AT2G09890	2	3742433	3746263	3830	-	0
AT2G09900	2	3751341	3751937	596	-	0
AT2G09910	2	3753395	3757208	3813	+	1
AT2G09920	2	3758115	3762630	4515	-	0
AT2G09930	2	3764536	3766233	1697	-	0
AT2G09950	2	3767389	3771433	4044	-	0
AT2G09953	2	3772664	3773282	618	-	0
AT2G09956	2	3773823	3775059	1236	-	0
AT2G09960	2	3775765	3778960	3195	-	2
AT2G09970	2	3779991	3780691	700	-	1
AT2G09990	2	3781327	3782049	722	+	712
AT2G09992	2	3782608	3782840	232	+	0
AT2G09994	2	3782955	3784075	1120	+	0
AT2G10000	2	3786132	3788854	2722	-	0
AT2G10010	2	3789438	3792943	3505	-	0
AT2G10014	2	3794971	3795145	174	-	0
AT2G10020	2	3797229	3797430	201	+	0
AT2G10030	2	3804569	3807981	3412	-	0
AT2G10040	2	3809307	3811943	2636	-	0
AT2G10050	2	3813288	3813651	363	-	0
AT2G10070	2	3816493	3819701	3208	-	0
AT2G10080	2	3820973	3822999	2026	-	0
AT2G10090	2	3823529	3823889	360	-	0
AT2G10100	2	3826190	3828196	2006	+	0
AT2G10105	2	3828198	3828646	448	+	0
AT2G10110	2	3830550	3831060	510	+	0
AT2G10120	2	3834911	3835855	944	-	0
AT2G10130	2	3836125	3837892	1767	-	0
AT2G10140	2	3838421	3840953	2532	+	0
AT2G10150	2	3842807	3844396	1589	-	0
AT2G10160	2	3849327	3852601	3274	-	0
AT2G10165	2	3854085	3854814	729	-	0
AT2G10170	2	3858669	3861660	2991	-	0
AT2G10175	2	3862891	3863553	662	-	0
AT2G10180	2	3866572	3872675	6103	-	0
AT2G10190	2	3875424	3881998	6574	-	0
AT2G10200	2	3884129	3886618	2489	-	0
AT2G10205	2	3888545	3890441	1896	+	0
AT2G10210	2	3890743	3894739	3996	-	0
AT2G10220	2	3898009	3900223	2214	+	0
AT2G10223	2	3900487	3900973	486	-	0
AT2G10226	2	3902797	3903640	843	+	0
AT2G10230	2	3904097	3906674	2577	+	0
AT2G10232	2	3908588	3909740	1152	+	0
AT2G10234	2	3910472	3911711	1239	+	0
AT2G10237	2	3912437	3913631	1194	+	0
AT2G10240	2	3914734	3919618	4884	+	0
AT2G10250	2	3920935	3925848	4913	+	0
AT2G10253	2	3927979	3928813	834	+	0
AT2G10256	2	3933385	3935395	2010	-	0
AT2G10260	2	3938526	3941240	2714	+	0
AT2G10265	2	3941888	3942758	870	-	0
AT2G10270	2	3943495	3944667	1172	+	0
AT2G10280	2	3945968	3953199	7231	+	0
AT2G10285	2	3954997	3955674	677	+	0
AT2G10290	2	3956424	3957216	792	+	0
AT2G10300	2	3959413	3962068	2655	+	0
AT2G10310	2	3967932	3971356	3424	-	0
AT2G10320	2	3973248	3975866	2618	+	0
AT2G10330	2	3977960	3983783	5823	-	0
AT2G10340	2	3984030	3984288	258	-	0
AT2G10350	2	3988684	3993908	5224	+	0
AT2G10360	2	3995510	3996002	492	+	0
AT2G10370	2	3996635	3997650	1015	+	0
AT2G10380	2	3998538	3999488	950	+	0
AT2G10390	2	3999944	4000621	677	+	0
AT2G10400	2	4001685	4004495	2810	-	0
AT2G10405	2	4005578	4006116	538	+	0
AT2G10410	2	4005994	4007044	1050	-	1583
AT2G10420	2	4008077	4008743	666	+	1
AT2G10430	2	4008788	4011726	2938	-	1
AT2G10440	2	4013751	4018046	4295	-	0
AT2G10450	2	4020304	4020773	469	+	2
AT2G10460	2	4027965	4030285	2320	+	0
AT2G10465	2	4031239	4032488	1249	+	0
AT2G10470	2	4033918	4035011	1093	+	0
AT2G10480	2	4036276	4038845	2569	+	0
AT2G10490	2	4041163	4043622	2459	+	2
AT2G10500	2	4044726	4045747	1021	+	0
AT2G10510	2	4051548	4055823	4275	+	0
AT2G10520	2	4061565	4064886	3321	+	0
AT2G10530	2	4065707	4067263	1556	-	0
AT2G10535	2	4082850	4083168	318	+	0
AT2G10537	2	4083602	4083913	311	-	0
AT2G10540	2	4091076	4094102	3026	-	0
AT2G10550	2	4096000	4096920	920	-	0
AT2G10555	2	4101871	4102548	677	-	0
AT2G10557	2	4106182	4106356	174	-	0
AT2G10560	2	4109861	4110698	837	-	0
AT2G10570	2	4111239	4115041	3802	+	0
AT2G10589	2	4115710	4115994	284	-	0
AT2G10590	2	4121858	4124630	2772	-	0
AT2G10600	2	4127907	4131031	3124	-	1
AT2G10602	2	4134894	4135888	994	+	0
AT2G10605	2	4139727	4140985	1258	+	1
AT2G10606	2	4142322	4142473	151	-	1
AT2G10608	2	4145497	4146239	742	-	0
AT2G10610	2	4116391	4120429	4038	+	0
AT2G10611	2	4148723	4149032	309	+	0
AT2G10614	2	4153464	4154145	681	+	0
AT2G10617	2	4154974	4155602	628	+	0
AT2G10620	2	4157219	4159324	2105	+	0
AT2G10630	2	4162834	4165555	2721	+	0
AT2G10640	2	4166321	4168741	2420	+	0
AT2G10650	2	4169150	4172678	3528	-	0
AT2G10660	2	4177219	4182769	5550	+	0
AT2G10670	2	4190008	4192940	2932	-	0
AT2G10680	2	4200569	4202437	1868	-	2
AT2G10690	2	4204730	4208510	3780	-	0
AT2G10710	2	4213690	4214181	491	+	0
AT2G10720	2	4218313	4218787	474	-	0
AT2G10730	2	4219435	4219773	338	-	0
AT2G10735	2	4224084	4226506	2422	-	8
AT2G10740	2	4208577	4209411	834	-	0
AT2G10760	2	4231552	4235631	4079	+	0
AT2G10770	2	4236738	4237199	461	-	0
AT2G10780	2	4237679	4243055	5376	+	0
AT2G10790	2	4243131	4243592	461	-	0
AT2G10800	2	4246279	4249259	2980	-	0
AT2G10802	2	4251565	4252690	1125	+	0
AT2G10810	2	4252707	4254867	2160	-	0
AT2G10820	2	4256188	4261900	5712	+	0
AT2G10830	2	4265053	4266487	1434	+	0
AT2G10833	2	4267369	4268691	1322	+	0
AT2G10836	2	4269614	4271232	1618	+	0
AT2G10840	2	4272269	4273294	1025	+	0
AT2G10850	2	4276323	4277505	1182	-	0
AT2G10860	2	4278406	4281427	3021	-	0
AT2G10870	2	4283679	4283931	252	+	1
AT2G10880	2	4284910	4286083	1173	-	0
AT2G10890	2	4287910	4291049	3139	-	0
AT2G10895	2	4292184	4292868	684	-	0
AT2G10900	2	4293804	4295583	1779	+	0
AT2G10910	2	4296274	4300873	4599	+	0
AT2G10920	2	4301882	4302134	252	-	1
AT2G10921	2	4301931	4303080	1149	+	0
AT2G10930	2	4303280	4303967	687	-	5
AT2G10931	2	4304946	4305887	941	-	51
AT2G10940	2	4310411	4312103	1692	-	24986
AT2G10950	2	4315410	4317862	2452	-	329
AT2G10960	2	4319550	4321468	1918	-	0
AT2G10965	2	4323670	4324948	1278	+	0
AT2G10970	2	4332838	4333579	741	-	0
AT2G10975	2	4335136	4335909	773	+	0
AT2G10980	2	4336272	4337467	1195	+	4
AT2G10990	2	4339442	4340424	982	+	1
AT2G11000	2	4341122	4347856	6734	-	529
AT2G11005	2	4348510	4349577	1067	+	0
AT2G11010	2	4361868	4365919	4051	+	0
AT2G11015	2	4366199	4366640	441	+	0
AT2G11020	2	4366855	4370211	3356	-	0
AT2G11030	2	4370828	4374970	4142	-	0
AT2G11040	2	4375863	4379651	3788	-	0
AT2G11050	2	4379745	4385431	5686	+	0
AT2G11060	2	4386370	4389560	3190	-	0
AT2G11070	2	4389578	4393073	3495	-	0
AT2G11080	2	4397839	4398442	603	+	0
AT2G11090	2	4399433	4399960	527	-	0
AT2G11100	2	4400056	4402144	2088	+	0
AT2G11110	2	4404375	4406419	2044	-	0
AT2G11115	2	4408187	4408703	516	-	0
AT2G11120	2	4409344	4410577	1233	-	1
AT2G11130	2	4411206	4412490	1284	-	0
AT2G11135	2	4413198	4413707	509	-	0
AT2G11140	2	4416607	4418539	1932	-	63
AT2G11150	2	4419682	4422079	2397	-	6
AT2G11165	2	4424293	4428281	3988	-	0
AT2G11166	2	4430624	4431200	576	-	0
AT2G11168	2	4431970	4432881	911	-	0
AT2G11170	2	4433757	4438035	4278	-	0
AT2G11180	2	4442363	4445583	3220	+	0
AT2G11190	2	4446815	4448957	2142	-	0
AT2G11200	2	4451923	4452388	465	+	0
AT2G11210	2	4453640	4455494	1854	+	1
AT2G11220	2	4460459	4462103	1644	+	0
AT2G11230	2	4463179	4467589	4410	+	0
AT2G11235	2	4468249	4470655	2406	+	0
AT2G11240	2	4477685	4483748	6063	-	5521
AT2G11270	2	4484719	4485308	589	+	0
AT2G11271	2	4485413	4485539	126	-	1
AT2G11280	2	4486265	4487577	1312	+	0
AT2G11290	2	4489159	4490694	1535	+	0
AT2G11300	2	4491276	4493954	2678	+	2
AT2G11310	2	4494443	4500207	5764	-	1
AT2G11320	2	4500769	4507570	6801	+	1
AT2G11330	2	4509241	4512287	3046	+	2
AT2G11340	2	4514860	4520662	5802	-	0
AT2G11345	2	4522601	4523297	696	-	0
AT2G11350	2	4526979	4529724	2745	+	0
AT2G11360	2	4530892	4531503	611	-	0
AT2G11370	2	4531704	4532311	607	+	0
AT2G11380	2	4535096	4535853	757	+	0
AT2G11390	2	4536803	4537705	902	+	0
AT2G11400	2	4538803	4539422	619	-	0
AT2G11405	2	4543174	4543522	348	+	0
AT2G11410	2	4543931	4547916	3985	+	0
AT2G11420	2	4556994	4558533	1539	+	0
AT2G11430	2	4559902	4564733	4831	-	0
AT2G11440	2	4566606	4567777	1171	+	0
AT2G11450	2	4573615	4581219	7604	-	0
AT2G11460	2	4585884	4586249	365	-	0
AT2G11462	2	4589734	4590378	644	-	0
AT2G11465	2	4596447	4597861	1414	+	0
AT2G11480	2	4598894	4602284	3390	+	0
AT2G11485	2	4603181	4603562	381	+	0
AT2G11490	2	4604292	4604960	668	+	0
AT2G11500	2	4605503	4607971	2468	+	0
AT2G11502	2	4608074	4608311	237	+	0
AT2G11504	2	4609112	4609463	351	+	0
AT2G11507	2	4610149	4610989	840	+	0
AT2G11510	2	4611624	4613625	2001	-	0
AT2G11520	2	4618580	4621576	2996	+	468
AT2G11522	2	4622369	4622495	126	+	0
AT2G11530	2	4624738	4626409	1671	+	0
AT2G11550	2	4626901	4631904	5003	-	0
AT2G11570	2	4634250	4635203	953	-	0
AT2G11590	2	4635949	4641226	5277	-	0
AT2G11600	2	4643838	4645638	1800	-	0
AT2G11610	2	4656593	4657756	1163	+	0
AT2G11620	2	4658444	4660777	2333	+	0
AT2G11623	2	4660869	4661415	546	-	0
AT2G11626	2	4661457	4662451	994	+	0
AT2G11630	2	4665327	4666952	1625	+	0
AT2G11640	2	4669996	4671816	1820	+	0
AT2G11650	2	4676309	4677842	1533	-	0
AT2G11651	2	4677982	4678120	138	+	0
AT2G11660	2	4678819	4681848	3029	-	0
AT2G11670	2	4685013	4687082	2069	+	0
AT2G11680	2	4688369	4690847	2478	+	0
AT2G11690	2	4691737	4693050	1313	-	0
AT2G11700	2	4694284	4696325	2041	+	0
AT2G11720	2	4699171	4703974	4803	-	0
AT2G11730	2	4704284	4706507	2223	+	0
AT2G11740	2	4706900	4708590	1690	-	0
AT2G11750	2	4711128	4713879	2751	+	0
AT2G11770	2	4716554	4722974	6420	+	0
AT2G11773	2	4724035	4724143	108	-	0
AT2G11775	2	4724381	4725219	838	-	0
AT2G11778	2	4728071	4728239	168	+	0
AT2G11780	2	4729677	4732966	3289	+	0
AT2G11790	2	4734651	4736839	2188	-	0
AT2G11800	2	4737794	4742118	4324	-	0
AT2G11810	2	4743321	4746780	3459	+	30
AT2G11820	2	4752781	4756899	4118	-	0
AT2G11830	2	4771864	4773245	1381	-	0
AT2G11840	2	4776445	4779605	3160	-	0
AT2G11850	2	4786696	4787543	847	-	0
AT2G11851	2	4785981	4790030	4049	+	1
AT2G11852	2	4789636	4789849	213	-	0
AT2G11870	2	4791148	4791529	381	-	0
AT2G11880	2	4800142	4801963	1821	+	56
AT2G11890	2	4802782	4804375	1593	+	812
AT2G11891	2	4804390	4804558	168	+	1
AT2G11910	2	4805683	4807319	1636	-	1519
AT2G11930	2	4809840	4812236	2396	+	0
AT2G11940	2	4812742	4818142	5400	-	3
AT2G11950	2	4819267	4825847	6580	+	0
AT2G11970	2	4826745	4827503	758	-	0
AT2G11980	2	4827926	4829212	1286	+	0
AT2G11983	2	4830685	4831244	559	+	0
AT2G11990	2	4833235	4833625	390	+	0
AT2G12000	2	4834743	4835118	375	+	0
AT2G12010	2	4839746	4841689	1943	+	0
AT2G12020	2	4842127	4845947	3820	+	5
AT2G12025	2	4849945	4852150	2205	-	0
AT2G12040	2	4855656	4856532	876	+	0
AT2G12050	2	4857013	4858186	1173	-	0
AT2G12060	2	4861655	4864337	2682	+	0
AT2G12066	2	4864908	4865482	574	-	0
AT2G12083	2	4866439	4868715	2276	-	0
AT2G12100	2	4873586	4878566	4980	+	0
AT2G12110	2	4878935	4879631	696	+	0
AT2G12120	2	4880511	4881207	696	+	0
AT2G12130	2	4881879	4882509	630	+	0
AT2G12140	2	4882927	4883872	945	-	0
AT2G12150	2	4884406	4887236	2830	-	0
AT2G12160	2	4888067	4888932	865	-	0
AT2G12170	2	4890079	4891424	1345	-	34
AT2G12190	2	4891641	4893345	1704	-	29
AT2G12195	2	4894627	4898737	4110	-	0
AT2G12200	2	4900612	4900944	332	+	0
AT2G12210	2	4902162	4908827	6665	+	0
AT2G12230	2	4909260	4909488	228	+	0
AT2G12240	2	4911108	4912425	1317	-	0
AT2G12250	2	4913281	4914238	957	-	0
AT2G12260	2	4914734	4918581	3847	-	0
AT2G12270	2	4919061	4920410	1349	-	0
AT2G12280	2	4922281	4922679	398	+	0
AT2G12290	2	4924099	4924501	402	-	0
AT2G12300	2	4926145	4928532	2387	-	0
AT2G12305	2	4929611	4933406	3795	-	0
AT2G12320	2	4935625	4936286	661	+	0
AT2G12325	2	4946234	4946952	718	+	0
AT2G12330	2	4950516	4955797	5281	+	0
AT2G12340	2	4967127	4972105	4978	-	0
AT2G12345	2	4973324	4973834	510	-	0
AT2G12360	2	4974481	4977426	2945	-	0
AT2G12370	2	4978986	4985061	6075	+	0
AT2G12380	2	4986186	4989358	3172	-	1
AT2G12385	2	4991987	4995221	3234	-	0
AT2G12390	2	4997452	5001918	4466	+	0
AT2G12400	2	5004942	5008322	3380	-	346
AT2G12405	2	5010791	5011590	799	-	0
AT2G12407	2	5011952	5012751	799	+	0
AT2G12408	2	5017109	5017865	756	+	1
AT2G12410	2	5024029	5026208	2179	-	1
AT2G12420	2	5027375	5029321	1946	-	1
AT2G12430	2	5031468	5032435	967	-	4
AT2G12440	2	5033539	5040002	6463	+	56
AT2G12450	2	5041584	5044933	3349	+	33
AT2G12460	2	5045951	5047581	1630	-	62
AT2G12461	2	5049952	5050087	135	-	31
AT2G12462	2	5050433	5051613	1180	-	200
AT2G12465	2	5055524	5055872	348	-	1
AT2G12470	2	5062614	5067132	4518	-	0
AT2G12475	2	5068489	5068853	364	-	0
AT2G12480	2	5069589	5072533	2944	-	5
AT2G12490	2	5074383	5079646	5263	+	135
AT2G12500	2	5086783	5092433	5650	+	2
AT2G12505	2	5096037	5097359	1322	+	3
AT2G12510	2	5100104	5103592	3488	+	0
AT2G12520	2	5104417	5105816	1399	-	1
AT2G12530	2	5106677	5106974	297	-	0
AT2G12540	2	5108872	5110827	1955	-	3
AT2G12550	2	5114867	5118747	3880	+	125
AT2G12557	2	5121891	5122068	177	+	0
AT2G12560	2	5122719	5123487	768	+	0
AT2G12570	2	5127429	5130440	3011	-	0
AT2G12580	2	5132375	5133590	1215	+	0
AT2G12590	2	5135798	5138142	2344	+	0
AT2G12600	2	5139767	5140704	937	+	0
AT2G12610	2	5141836	5143529	1693	+	0
AT2G12620	2	5145948	5146475	527	+	0
AT2G12630	2	5148262	5148767	505	+	0
AT2G12640	2	5154644	5158744	4100	-	0
AT2G12646	2	5167041	5169185	2144	-	1
AT2G12650	2	5172043	5177532	5489	+	0
AT2G12660	2	5181464	5182059	595	-	0
AT2G12670	2	5182755	5185602	2847	+	0
AT2G12680	2	5191774	5195786	4012	+	0
AT2G12685	2	5196412	5196814	402	+	0
AT2G12690	2	5197315	5197850	535	-	0
AT2G12695	2	5206230	5206942	712	+	0
AT2G12700	2	5207251	5207801	550	-	0
AT2G12710	2	5208464	5209479	1015	+	0
AT2G12720	2	5210092	5212892	2800	-	0
AT2G12730	2	5218463	5220468	2005	-	0
AT2G12740	2	5221308	5225867	4559	-	0
AT2G12750	2	5228219	5230996	2777	-	0
AT2G12760	2	5233300	5238002	4702	-	0
AT2G12770	2	5239768	5245033	5265	-	0
AT2G12780	2	5249234	5252051	2817	+	0
AT2G12800	2	5252104	5257758	5654	+	0
AT2G12810	2	5258512	5259805	1293	+	0
AT2G12815	2	5260739	5261453	714	+	0
AT2G12820	2	5262413	5264456	2043	+	0
AT2G12830	2	5265283	5266740	1457	+	0
AT2G12832	2	5267411	5268167	756	+	0
AT2G12835	2	5269179	5271288	2109	+	0
AT2G12840	2	5272005	5273463	1458	+	0
AT2G12845	2	5274326	5274890	564	+	0
AT2G12850	2	5275902	5278679	2777	+	1
AT2G12855	2	5279890	5280526	636	+	0
AT2G12860	2	5280410	5282901	2491	-	0
AT2G12870	2	5286773	5288838	2065	-	0
AT2G12875	2	5289410	5291470	2060	-	0
AT2G12880	2	5291522	5291882	360	+	0
AT2G12890	2	5292663	5292917	254	-	0
AT2G12900	2	5293896	5295480	1584	+	0
AT2G12905	2	5296363	5296582	219	+	2
AT2G12910	2	5298298	5301076	2778	+	0
AT2G12920	2	5302106	5306293	4187	-	0
AT2G12930	2	5306621	5312751	6130	+	4
AT2G12935	2	5315037	5316041	1004	-	0
AT2G12940	2	5317474	5319090	1616	+	0
AT2G12945	2	5322902	5323624	722	-	0
AT2G12950	2	5325172	5327068	1896	-	0
AT2G12960	2	5328293	5329084	791	+	0
AT2G12970	2	5331909	5335773	3864	+	0
AT2G12977	2	5337864	5338029	165	+	0
AT2G12980	2	5338747	5340868	2121	-	0
AT2G12990	2	5341983	5342694	711	-	0
AT2G13000	2	5342939	5346917	3978	-	0
AT2G13010	2	5352837	5353735	898	-	0
AT2G13020	2	5356303	5362180	5877	-	0
AT2G13040	2	5365831	5367696	1865	+	1
AT2G13050	2	5368530	5371021	2491	+	0
AT2G13060	2	5371694	5377157	5463	-	0
AT2G13070	2	5377426	5378146	720	+	0
AT2G13080	2	5378466	5384531	6065	-	1
AT2G13090	2	5386716	5389422	2706	+	0
AT2G13100	2	5389771	5392029	2258	+	353
AT2G13110	2	5396052	5399160	3108	+	0
AT2G13115	2	5401087	5403027	1940	+	0
AT2G13116	2	5409924	5410530	606	-	0
AT2G13118	2	5412449	5413079	630	-	0
AT2G13120	2	5413236	5415106	1870	-	0
AT2G13125	2	5415890	5416317	427	+	0
AT2G13126	2	5416689	5416872	183	-	0
AT2G13128	2	5418239	5419103	864	-	9
AT2G13130	2	5419674	5420834	1160	-	67
AT2G13140	2	5423317	5425079	1762	+	0
AT2G13142	2	5425280	5425845	565	+	0
AT2G13143	2	5426960	5427593	633	+	0
AT2G13145	2	5428730	5430290	1560	+	0
AT2G13146	2	5431032	5431247	215	+	0
AT2G13150	2	5437055	5438459	1404	+	0
AT2G13160	2	5441879	5444055	2176	+	0
AT2G13170	2	5448715	5452999	4284	-	0
AT2G13175	2	5453855	5456495	2640	-	0
AT2G13180	2	5463577	5464637	1060	+	1
AT2G13190	2	5469692	5470750	1058	-	0
AT2G13200	2	5471588	5473914	2326	+	0
AT2G13230	2	5474164	5477905	3741	+	0
AT2G13240	2	5479271	5481200	1929	+	0
AT2G13250	2	5481568	5484372	2804	-	0
AT2G13260	2	5486414	5488852	2438	-	0
AT2G13270	2	5492652	5493855	1203	+	0
AT2G13272	2	5497131	5497389	258	+	0
AT2G13273	2	5498541	5498667	126	+	0
AT2G13274	2	5501009	5501774	765	+	0
AT2G13280	2	5509321	5511099	1778	-	0
AT2G13290	2	5511561	5513265	1704	+	297
AT2G13295	2	5514093	5514635	542	-	0
AT2G13300	2	5517588	5520081	2493	-	0
AT2G13310	2	5524128	5526270	2142	-	0
AT2G13320	2	5526468	5526858	390	+	0
AT2G13330	2	5528300	5531548	3248	-	0
AT2G13335	2	5532042	5533468	1426	-	0
AT2G13350	2	5536391	5537881	1490	-	0
AT2G13360	2	5539239	5541358	2119	-	56027
AT2G13363	2	5542339	5542483	144	+	0
AT2G13370	2	5544180	5556464	12284	-	1625
AT2G13380	2	5560012	5565080	5068	+	0
AT2G13390	2	5566997	5575786	8789	+	0
AT2G13400	2	5576996	5577824	828	+	0
AT2G13410	2	5579301	5583150	3849	-	8
AT2G13420	2	5586484	5587562	1078	-	34
AT2G13422	2	5588217	5588322	105	+	2
AT2G13430	2	5590051	5591422	1371	+	0
AT2G13431	2	5590719	5591414	695	-	1
AT2G13440	2	5593059	5598296	5237	-	1089
AT2G13450	2	5598420	5599923	1503	-	3
AT2G13460	2	5600305	5605593	5288	-	1
AT2G13463	2	5609986	5610172	186	-	1
AT2G13469	2	5616459	5617290	831	-	0
AT2G13470	2	5617570	5621243	3673	-	0
AT2G13480	2	5621670	5622400	730	-	0
AT2G13490	2	5623787	5627656	3869	+	0
AT2G13500	2	5627935	5629099	1164	+	0
AT2G13510	2	5630000	5631107	1107	-	0
AT2G13520	2	5631321	5635386	4065	-	0
AT2G13530	2	5635474	5636530	1056	-	0
AT2G13540	2	5636883	5642957	6074	+	1014
AT2G13542	2	5643168	5643615	447	-	0
AT2G13547	2	5647171	5647384	213	+	0
AT2G13550	2	5648541	5649797	1256	-	102
AT2G13560	2	5649963	5655320	5357	+	3457
AT2G13570	2	5655841	5656489	648	-	9
AT2G13580	2	5658455	5659763	1308	+	1
AT2G13590	2	5667077	5668393	1316	-	2
AT2G13600	2	5671492	5673586	2094	+	44
AT2G13610	2	5673687	5675831	2144	-	358
AT2G13620	2	5678005	5680621	2616	+	0
AT2G13623	2	5682061	5682304	243	-	0
AT2G13630	2	5684537	5685431	894	-	0
AT2G13640	2	5686135	5687290	1155	-	0
AT2G13650	2	5687377	5690795	3418	-	260
AT2G13660	2	5692096	5693016	920	-	0
AT2G13665	2	5692147	5693016	869	+	2
AT2G13680	2	5694397	5706134	11737	+	20
AT2G13690	2	5706506	5708957	2451	-	286
AT2G13700	2	5709856	5713067	3211	-	0
AT2G13705	2	5714373	5714766	393	-	0
AT2G13706	2	5717280	5717603	323	+	0
AT2G13710	2	5721706	5722629	923	-	0
AT2G13720	2	5724006	5725248	1242	+	0
AT2G13730	2	5725556	5726003	447	-	0
AT2G13740	2	5727829	5729269	1440	+	0
AT2G13750	2	5730066	5732214	2148	+	0
AT2G13760	2	5734954	5735644	690	-	0
AT2G13770	2	5736569	5737847	1278	+	0
AT2G13790	2	5741819	5746793	4974	+	469
AT2G13800	2	5753270	5757239	3969	+	123
AT2G13810	2	5768445	5772259	3814	+	15
AT2G13820	2	5774145	5776289	2144	-	259
AT2G13830	2	5782177	5786746	4569	-	0
AT2G13840	2	5788551	5791126	2575	-	153
AT2G13850	2	5792925	5797569	4644	-	0
AT2G13851	2	5798567	5799689	1122	-	0
AT2G13860	2	5809671	5813482	3811	-	0
AT2G13865	2	5817229	5818001	772	+	0
AT2G13870	2	5819375	5821584	2209	+	0
AT2G13890	2	5824323	5827812	3489	+	0
AT2G13895	2	5829484	5830283	799	+	0
AT2G13900	2	5833043	5835209	2166	+	0
AT2G13910	2	5837685	5839920	2235	+	0
AT2G13920	2	5844028	5845726	1698	+	0
AT2G13930	2	5846900	5850953	4053	-	0
AT2G13940	2	5852758	5857264	4506	+	0
AT2G13950	2	5857535	5859249	1714	+	0
AT2G13960	2	5859584	5861311	1727	+	8
AT2G13970	2	5862535	5864801	2266	+	481
AT2G13975	2	5864883	5865600	717	-	208
AT2G13980	2	5869852	5870368	516	-	0
AT2G13990	2	5876700	5881534	4834	-	0
AT2G14000	2	5884599	5885985	1386	-	0
AT2G14010	2	5888320	5893026	4706	+	0
AT2G14020	2	5893786	5894272	486	-	1
AT2G14030	2	5895267	5898637	3370	-	0
AT2G14040	2	5900981	5905041	4060	-	0
AT2G14045	2	5906549	5908374	1825	+	794
AT2G14050	2	5909177	5913817	4640	+	153
AT2G14060	2	5914444	5915767	1323	-	4
AT2G14070	2	5921880	5922990	1110	+	2
AT2G14080	2	5925185	5929600	4415	+	801
AT2G14090	2	5929999	5931585	1586	-	172
AT2G14095	2	5932382	5933791	1409	-	16
AT2G14100	2	5934555	5936371	1816	-	1
AT2G14110	2	5951886	5953155	1269	+	159
AT2G14115	2	5953195	5954039	844	+	67
AT2G14120	2	5953939	5960123	6184	-	833
AT2G14130	2	5960799	5965445	4646	+	0
AT2G14140	2	5967177	5971487	4310	+	0
AT2G14150	2	5972312	5974278	1966	-	0
AT2G14160	2	5976464	5976801	337	-	0
AT2G14170	2	5977355	5981899	4544	-	874
AT2G14180	2	5987051	5993186	6135	+	0
AT2G14190	2	5999322	6000791	1469	-	0
AT2G14200	2	6009936	6012698	2762	-	0
AT2G14206	2	6016714	6016810	96	+	0
AT2G14210	2	6018557	6023863	5306	+	2
AT2G14220	2	6024059	6027028	2969	-	162
AT2G14230	2	6027498	6029693	2195	-	6
AT2G14240	2	6029772	6030159	387	+	0
AT2G14245	2	6031150	6032502	1352	-	1
AT2G14247	2	6034347	6034835	488	+	6
AT2G14255	2	6036973	6040978	4005	+	631
AT2G14260	2	6041252	6043974	2722	-	1223
AT2G14270	2	6045578	6046045	467	+	0
AT2G14280	2	6048999	6049775	776	+	0
AT2G14282	2	6049927	6050393	466	-	0
AT2G14285	2	6052331	6053994	1663	-	327
AT2G14288	2	6056037	6056778	741	-	0
AT2G14289	2	6056912	6057020	108	-	0
AT2G14290	2	6057287	6058524	1237	-	2
AT2G14300	2	6060316	6065238	4922	-	0
AT2G14310	2	6067396	6069732	2336	-	0
AT2G14320	2	6071273	6073704	2431	+	0
AT2G14330	2	6074161	6075394	1233	+	2
AT2G14335	2	6077329	6077725	396	-	0
AT2G14340	2	6078120	6078961	841	+	0
AT2G14350	2	6079559	6082161	2602	-	0
AT2G14365	2	6088338	6088813	475	+	0
AT2G14370	2	6095105	6097130	2025	+	0
AT2G14378	2	6104868	6105231	363	-	0
AT2G14380	2	6105571	6109008	3437	-	0
AT2G14390	2	6110911	6111918	1007	+	0
AT2G14400	2	6113840	6119183	5343	+	0
AT2G14405	2	6120125	6120741	616	-	0
AT2G14410	2	6121371	6124329	2958	-	0
AT2G14415	2	6126672	6127692	1020	-	0
AT2G14420	2	6129676	6130479	803	+	1
AT2G14430	2	6134009	6139121	5112	+	0
AT2G14440	2	6143072	6147419	4347	+	0
AT2G14450	2	6149596	6152117	2521	+	0
AT2G14455	2	6152948	6154256	1308	+	0
AT2G14460	2	6154492	6155004	512	-	81
AT2G14470	2	6155775	6161811	6036	+	0
AT2G14475	2	6163927	6164963	1036	-	1
AT2G14490	2	6164998	6165986	988	-	1
AT2G14500	2	6166935	6167979	1044	+	0
AT2G14510	2	6171132	6175052	3920	-	0
AT2G14520	2	6182192	6184648	2456	-	232
AT2G14530	2	6187420	6190380	2960	+	289
AT2G14535	2	6193270	6194674	1404	+	0
AT2G14540	2	6197662	6199406	1744	-	0
AT2G14550	2	6202987	6204746	1759	+	0
AT2G14560	2	6213971	6215901	1930	+	748
AT2G14570	2	6221779	6223917	2138	-	0
AT2G14580	2	6225534	6226224	690	-	41
AT2G14590	2	6228836	6229808	972	+	0
AT2G14595	2	6230128	6232147	2019	+	0
AT2G14600	2	6232791	6233013	222	-	0
AT2G14605	2	6237863	6238511	648	+	0
AT2G14610	2	6241703	6242463	760	-	7
AT2G14620	2	6244780	6246233	1453	+	42
AT2G14630	2	6252491	6253411	920	-	0
AT2G14635	2	6254433	6254900	467	-	0
AT2G14640	2	6256778	6260582	3804	+	0
AT2G14650	2	6265312	6269688	4376	-	0
AT2G14660	2	6272490	6273083	593	+	168
AT2G14661	2	6273314	6274037	723	-	0
AT2G14670	2	6274605	6276317	1712	-	0
AT2G14680	2	6277801	6283940	6139	+	467
AT2G14690	2	6283800	6286055	2255	-	0
AT2G14692	2	6287639	6287771	132	+	0
AT2G14700	2	6292465	6295726	3261	+	0
AT2G14710	2	6298678	6300150	1472	+	0
AT2G14720	2	6300487	6304394	3907	-	1271
AT2G14730	2	6305548	6307309	1761	+	0
AT2G14740	2	6308894	6312589	3695	+	678
AT2G14750	2	6314031	6315766	1735	+	3102
AT2G14760	2	6321586	6323397	1811	-	0
AT2G14770	2	6330141	6334932	4791	+	0
AT2G14772	2	6335391	6336075	684	+	0
AT2G14774	2	6337065	6337758	693	+	0
AT2G14777	2	6338512	6339189	677	+	0
AT2G14780	2	6339748	6340697	949	-	0
AT2G14790	2	6341267	6344219	2952	-	0
AT2G14793	2	6349065	6349638	573	-	0
AT2G14796	2	6351158	6353252	2094	-	0
AT2G14800	2	6355181	6357375	2194	+	17
AT2G14810	2	6357464	6358470	1006	-	0
AT2G14820	2	6358863	6361300	2437	+	2
AT2G14830	2	6362480	6365818	3338	+	96
AT2G14835	2	6366887	6371034	4147	+	610
AT2G14840	2	6371901	6373082	1181	+	0
AT2G14843	2	6378875	6380933	2058	-	0
AT2G14846	2	6382367	6382747	380	+	0
AT2G14850	2	6385871	6387570	1699	+	158
AT2G14860	2	6387623	6389628	2005	-	128
AT2G14870	2	6391171	6391477	306	+	0
AT2G14878	2	6392166	6393042	876	+	447
AT2G14880	2	6393331	6394938	1607	-	1334
AT2G14890	2	6399620	6401059	1439	+	2052
AT2G14900	2	6404174	6405330	1156	+	64
AT2G14910	2	6406475	6409152	2677	-	3974
AT2G14920	2	6418198	6419236	1038	+	0
AT2G14930	2	6422633	6426899	4266	-	0
AT2G14935	2	6431470	6431826	356	+	0
AT2G14940	2	6435724	6438806	3082	+	0
AT2G14950	2	6447380	6449633	2253	+	0
AT2G14960	2	6451371	6453670	2299	-	0
AT2G14970	2	6457720	6461341	3621	-	0
AT2G14980	2	6461671	6465118	3447	-	0
AT2G14990	2	6475057	6480183	5126	+	0
AT2G15000	2	6480916	6482420	1504	-	167
AT2G15010	2	6484378	6485154	776	+	1
AT2G15012	2	6486430	6486617	187	+	0
AT2G15013	2	6486902	6487110	208	+	0
AT2G15014	2	6487417	6487602	185	+	0
AT2G15015	2	6487909	6488094	185	+	0
AT2G15016	2	6488399	6488584	185	+	0
AT2G15017	2	6488872	6489077	205	+	0
AT2G15020	2	6491433	6493352	1919	-	3323
AT2G15025	2	6501125	6501704	579	-	0
AT2G15029	2	6504069	6504171	102	-	2
AT2G15030	2	6504366	6506172	1806	+	25
AT2G15040	2	6507522	6508565	1043	+	115
AT2G15042	2	6510164	6512637	2473	+	238
AT2G15045	2	6513693	6514467	774	-	0
AT2G15050	2	6518839	6520160	1321	+	1557
AT2G15060	2	6524753	6528513	3760	-	16
AT2G15070	2	6528824	6532381	3557	-	10
AT2G15080	2	6533686	6536995	3309	+	721
AT2G15090	2	6542255	6543947	1692	+	590
AT2G15100	2	6549380	6554330	4950	+	0
AT2G15110	2	6554846	6557168	2322	-	0
AT2G15120	2	6557366	6558936	1570	+	1
AT2G15128	2	6564103	6564316	213	+	23
AT2G15130	2	6564807	6566006	1199	+	21
AT2G15140	2	6566708	6571383	4675	+	0
AT2G15145	2	6572574	6573471	897	+	0
AT2G15150	2	6574272	6576991	2719	-	0
AT2G15160	2	6579902	6581815	1913	-	2
AT2G15170	2	6587569	6588235	666	+	0
AT2G15180	2	6588742	6590167	1425	-	0
AT2G15185	2	6590875	6591544	669	-	0
AT2G15190	2	6592907	6597558	4651	+	0
AT2G15200	2	6599309	6603242	3933	+	0
AT2G15210	2	6604064	6606755	2691	-	0
AT2G15220	2	6608658	6609506	848	+	2
AT2G15230	2	6612580	6615395	2815	+	344
AT2G15240	2	6615524	6618974	3450	-	440
AT2G15250	2	6619687	6624973	5286	-	0
AT2G15260	2	6630527	6634008	3481	+	0
AT2G15270	2	6637877	6639419	1542	+	229
AT2G15271	2	6639456	6639868	412	-	1
AT2G15280	2	6640153	6642350	2197	+	299
AT2G15290	2	6642299	6644037	1738	-	2253
AT2G15292	2	6644280	6645533	1253	-	607
AT2G15300	2	6649629	6652010	2381	+	68
AT2G15310	2	6653790	6655501	1711	+	84
AT2G15318	2	6664759	6665029	270	+	3
AT2G15320	2	6666315	6667704	1389	-	370
AT2G15325	2	6669653	6670381	728	-	0
AT2G15327	2	6671894	6672731	837	-	0
AT2G15330	2	6672891	6673989	1098	-	0
AT2G15340	2	6677286	6677819	533	+	0
AT2G15345	2	6684410	6685069	659	-	0
AT2G15350	2	6688139	6689462	1323	-	0
AT2G15360	2	6694786	6695180	394	-	0
AT2G15370	2	6698099	6699783	1684	-	0
AT2G15380	2	6700880	6706706	5826	+	0
AT2G15390	2	6709259	6711156	1897	-	25
AT2G15400	2	6712935	6714586	1651	+	30
AT2G15410	2	6717777	6723519	5742	+	0
AT2G15420	2	6723947	6728183	4236	-	0
AT2G15430	2	6733565	6735675	2110	+	251
AT2G15440	2	6743612	6744830	1218	-	87
AT2G15450	2	6747535	6749256	1721	+	0
AT2G15460	2	6750933	6752647	1714	+	0
AT2G15470	2	6754329	6756051	1722	+	0
AT2G15480	2	6758680	6763501	4821	+	54
AT2G15490	2	6761634	6763500	1866	+	1
AT2G15500	2	6763706	6764751	1045	+	0
AT2G15510	2	6766621	6770676	4055	-	0
AT2G15520	2	6770783	6772235	1452	-	0
AT2G15530	2	6772888	6777985	5097	+	676
AT2G15535	2	6778194	6778853	659	+	0
AT2G15540	2	6778956	6783018	4062	-	0
AT2G15550	2	6783185	6785180	1995	-	0
AT2G15555	2	6785903	6786976	1073	-	6
AT2G15560	2	6787868	6790101	2233	-	448
AT2G15570	2	6791289	6792933	1644	-	197
AT2G15580	2	6797559	6798939	1380	+	716
AT2G15590	2	6801942	6802618	676	+	0
AT2G15600	2	6805185	6805458	273	-	0
AT2G15610	2	6806032	6806764	732	+	0
AT2G15620	2	6810475	6812939	2464	+	7420
AT2G15630	2	6814520	6816404	1884	+	13
AT2G15640	2	6816791	6818205	1414	-	0
AT2G15650	2	6819378	6823451	4073	+	0
AT2G15660	2	6824241	6825576	1335	-	0
AT2G15670	2	6828132	6829621	1489	+	0
AT2G15680	2	6830994	6831641	647	+	0
AT2G15690	2	6830994	6833777	2783	-	349
AT2G15695	2	6833879	6836434	2555	-	702
AT2G15700	2	6837822	6841844	4022	+	0
AT2G15710	2	6842647	6845103	2456	+	0
AT2G15720	2	6845384	6848332	2948	-	0
AT2G15730	2	6849554	6852143	2589	+	107
AT2G15740	2	6856745	6857735	990	-	0
AT2G15750	2	6862921	6864116	1195	+	2
AT2G15760	2	6865609	6866877	1268	-	12
AT2G15765	2	6869557	6869895	338	-	0
AT2G15770	2	6871256	6872245	989	-	0
AT2G15780	2	6873544	6874741	1197	-	0
AT2G15790	2	6877773	6880898	3125	-	230
AT2G15800	2	6880824	6882741	1917	+	18
AT2G15810	2	6882820	6886775	3955	+	21
AT2G15815	2	6887047	6887542	495	-	0
AT2G15820	2	6888539	6891360	2821	-	413
AT2G15830	2	6894117	6894551	434	+	19
AT2G15840	2	6897745	6900002	2257	-	9
AT2G15850	2	6902858	6903669	811	-	0
AT2G15860	2	6905387	6909429	4042	-	717
AT2G15870	2	6909932	6914312	4380	-	0
AT2G15880	2	6918038	6920319	2281	-	28
AT2G15890	2	6920368	6922025	1657	-	444
AT2G15900	2	6927389	6932791	5402	+	491
AT2G15910	2	6932405	6935424	3019	-	301
AT2G15920	2	6935938	6940405	4467	+	0
AT2G15930	2	6941589	6941978	389	-	0
AT2G15940	2	6942913	6944794	1881	+	1
AT2G15950	2	6946842	6946879	37	-	0
AT2G15960	2	6947308	6947688	380	+	175
AT2G15970	2	6950040	6951192	1152	+	3660
AT2G15980	2	6951348	6952845	1497	-	118
AT2G15990	2	6953191	6953594	403	+	0
AT2G16000	2	6954283	6958648	4365	+	0
AT2G16005	2	6959149	6960197	1048	-	1
AT2G16010	2	6965609	6965999	390	+	0
AT2G16015	2	6970351	6970851	500	+	0
AT2G16016	2	6971139	6971268	129	-	0
AT2G16018	2	6972221	6973705	1484	-	0
AT2G16019	2	6973171	6973282	111	+	0
AT2G16020	2	6973355	6973586	231	+	0
AT2G16030	2	6973672	6974899	1227	-	0
AT2G16040	2	6976016	6977594	1578	+	0
AT2G16050	2	6980449	6982101	1652	+	132
AT2G16060	2	6982530	6983631	1101	-	45
AT2G16070	2	6983891	6985462	1571	-	1008
AT2G16080	2	6986131	6986640	509	-	0
AT2G16090	2	6986833	6990051	3218	-	291
AT2G16100	2	6990162	6990923	761	-	0
AT2G16110	2	6990978	6991950	972	+	0
AT2G16120	2	6996726	6998441	1715	-	0
AT2G16130	2	7002321	7004043	1722	+	0
AT2G16140	2	7005822	7008272	2450	+	3
AT2G16145	2	7008519	7008599	80	+	0
AT2G16150	2	7009204	7011913	2709	+	0
AT2G16160	2	7012569	7013466	897	+	0
AT2G16170	2	7013671	7014097	426	-	0
AT2G16180	2	7014472	7019440	4968	-	0
AT2G16190	2	7020485	7021601	1116	-	0
AT2G16200	2	7024606	7025231	625	+	0
AT2G16210	2	7026762	7029054	2292	-	3
AT2G16220	2	7030154	7031378	1224	-	0
AT2G16225	2	7033939	7034317	378	-	0
AT2G16230	2	7035462	7038326	2864	-	0
AT2G16240	2	7039093	7039165	72	+	0
AT2G16245	2	7039676	7040592	916	+	1
AT2G16250	2	7039681	7042933	3252	-	177
AT2G16260	2	7044814	7045502	688	+	0
AT2G16270	2	7045537	7048326	2789	-	184
AT2G16280	2	7050943	7052897	1954	+	2350
AT2G16290	2	7058929	7060573	1644	-	0
AT2G16300	2	7061628	7063367	1739	-	0
AT2G16310	2	7065215	7066190	975	-	0
AT2G16320	2	7067495	7068347	852	+	0
AT2G16330	2	7068683	7069613	930	+	1
AT2G16340	2	7073133	7073484	351	+	0
AT2G16360	2	7076712	7077366	654	-	0
AT2G16365	2	7074361	7079519	5158	+	1119
AT2G16367	2	7079795	7080248	453	-	14
AT2G16370	2	7081782	7084557	2775	-	620
AT2G16380	2	7085783	7089157	3374	+	338
AT2G16385	2	7094798	7095759	961	+	3
AT2G16390	2	7097279	7101261	3982	+	258
AT2G16400	2	7101329	7103921	2592	-	585
AT2G16405	2	7105751	7108972	3221	-	407
AT2G16410	2	7113644	7114259	615	+	0
AT2G16420	2	7116051	7119987	3936	+	0
AT2G16430	2	7120418	7122832	2414	-	2005
AT2G16440	2	7126356	7130685	4329	-	553
AT2G16450	2	7131519	7132803	1284	-	1
AT2G16460	2	7133389	7135652	2263	-	309
AT2G16485	2	7136943	7145222	8279	-	1146
AT2G16490	2	7145999	7147981	1982	-	0
AT2G16500	2	7150621	7153339	2718	-	4507
AT2G16505	2	7157087	7157759	672	-	0
AT2G16510	2	7159628	7160892	1264	-	1244
AT2G16520	2	7161921	7162580	659	-	0
AT2G16530	2	7162975	7165323	2348	-	110
AT2G16535	2	7166106	7166440	334	-	0
AT2G16540	2	7170931	7171404	473	-	0
AT2G16550	2	7172252	7172561	309	+	0
AT2G16560	2	7173002	7176689	3687	+	0
AT2G16570	2	7180144	7182193	2049	-	20
AT2G16575	2	7184651	7185245	594	+	0
AT2G16580	2	7184421	7186968	2547	-	33
AT2G16586	2	7190936	7191938	1002	+	382
AT2G16592	2	7196175	7196721	546	+	0
AT2G16594	2	7197773	7198082	309	+	0
AT2G16595	2	7198126	7200297	2171	+	71
AT2G16600	2	7200806	7201574	768	+	7230
AT2G16610	2	7202412	7203876	1464	-	0
AT2G16620	2	7205390	7205918	528	-	0
AT2G16630	2	7209238	7211037	1799	+	233
AT2G16640	2	7211111	7215553	4442	-	1037
AT2G16650	2	7215818	7218395	2577	-	124
AT2G16660	2	7218705	7221625	2920	-	339
AT2G16668	2	7223895	7224048	153	-	0
AT2G16670	2	7224340	7228819	4479	-	0
AT2G16676	2	7230345	7232223	1878	-	0
AT2G16680	2	7232291	7236283	3992	-	0
AT2G16690	2	7236877	7237600	723	-	0
AT2G16700	2	7244607	7245741	1134	+	218
AT2G16710	2	7248137	7250291	2154	+	186
AT2G16720	2	7255528	7256580	1052	-	26
AT2G16730	2	7261829	7266167	4338	-	0
AT2G16740	2	7267721	7268942	1221	+	417
AT2G16750	2	7271011	7274693	3682	+	215
AT2G16760	2	7275699	7277233	1534	+	5
AT2G16770	2	7279430	7281157	1727	+	156
AT2G16780	2	7281461	7283646	2185	-	360
AT2G16790	2	7283956	7285237	1281	-	59
AT2G16800	2	7285735	7287365	1630	+	642
AT2G16810	2	7287411	7288945	1534	-	0
AT2G16820	2	7290103	7290952	849	-	0
AT2G16830	2	7291905	7292982	1077	+	0
AT2G16832	2	7293622	7294681	1059	+	0
AT2G16835	2	7295850	7296318	468	+	0
AT2G16840	2	7296978	7297863	885	+	0
AT2G16850	2	7301580	7303437	1857	+	431
AT2G16860	2	7303918	7306671	2753	-	962
AT2G16870	2	7308076	7311686	3610	-	63
AT2G16880	2	7312145	7314533	2388	-	266
AT2G16881	2	7314578	7314713	135	-	0
AT2G16890	2	7316888	7319181	2293	+	74
AT2G16895	2	7319677	7321867	2190	+	2
AT2G16900	2	7323614	7326221	2607	-	334
AT2G16905	2	7327322	7328985	1663	-	0
AT2G16910	2	7331720	7334254	2534	+	6
AT2G16920	2	7334225	7339167	4942	-	589
AT2G16930	2	7341119	7342302	1183	+	409
AT2G16940	2	7342606	7347408	4802	-	2183
AT2G16950	2	7353846	7361202	7356	+	1603
AT2G16955	2	7363120	7363312	192	-	0
AT2G16960	2	7364682	7368963	4281	+	0
AT2G16970	2	7369548	7375528	5980	+	0
AT2G16980	2	7376348	7381103	4755	+	5
AT2G16990	2	7383034	7387854	4820	+	161
AT2G17000	2	7388892	7392105	3213	-	0
AT2G17010	2	7392849	7395970	3121	-	6
AT2G17020	2	7396336	7398838	2502	-	536
AT2G17030	2	7399102	7400932	1830	+	162
AT2G17033	2	7401137	7403646	2509	+	989
AT2G17036	2	7403855	7405219	1364	+	67
AT2G17040	2	7407122	7408270	1148	+	198
AT2G17043	2	7409062	7409582	520	+	0
AT2G17050	2	7410834	7415610	4776	-	2
AT2G17055	2	7418051	7418462	411	-	1
AT2G17060	2	7422410	7426877	4467	+	3
AT2G17064	2	7428622	7429916	1294	+	0
AT2G17070	2	7430862	7431654	792	-	0
AT2G17080	2	7433325	7434117	792	-	0
AT2G17090	2	7435087	7437298	2211	-	0
AT2G17110	2	7442979	7446065	3086	-	289
AT2G17115	2	7448944	7453891	4947	-	0
AT2G17120	2	7459046	7460819	1773	+	459
AT2G17130	2	7460813	7462554	1741	-	549
AT2G17140	2	7462810	7466626	3816	+	52
AT2G17150	2	7466840	7471262	4422	-	352
AT2G17160	2	7472753	7474012	1259	+	0
AT2G17170	2	7474735	7476438	1703	+	0
AT2G17180	2	7476834	7477647	813	-	0
AT2G17190	2	7477844	7481606	3762	-	1610
AT2G17200	2	7481880	7485240	3360	-	1559
AT2G17210	2	7485397	7487602	2205	-	20
AT2G17220	2	7487653	7490176	2523	-	679
AT2G17230	2	7494535	7496016	1481	-	406
AT2G17240	2	7498129	7499206	1077	+	1072
AT2G17250	2	7499476	7503125	3649	+	369
AT2G17260	2	7504755	7508394	3639	+	146
AT2G17265	2	7508587	7509755	1168	+	989
AT2G17270	2	7510099	7512387	2288	+	81
AT2G17280	2	7513127	7515048	1921	+	32
AT2G17290	2	7516414	7519633	3219	+	285
AT2G17295	2	7520941	7521021	80	+	0
AT2G17300	2	7522400	7523033	633	-	180
AT2G17305	2	7527675	7529210	1535	+	0
AT2G17310	2	7531193	7532412	1219	+	0
AT2G17320	2	7533479	7535942	2463	-	521
AT2G17330	2	7537336	7539422	2086	-	2
AT2G17340	2	7541405	7544128	2723	-	1898
AT2G17350	2	7545537	7546374	837	-	327
AT2G17360	2	7546479	7548313	1834	+	3185
AT2G17370	2	7549774	7552201	2427	+	184
AT2G17380	2	7553001	7555045	2044	+	487
AT2G17390	2	7555629	7558038	2409	+	2495
AT2G17410	2	7558976	7563752	4776	+	970
AT2G17420	2	7564344	7566539	2195	+	1504
AT2G17430	2	7568017	7570840	2823	+	37
AT2G17440	2	7571139	7573799	2660	+	296
AT2G17442	2	7573834	7575939	2105	-	69
AT2G17450	2	7576473	7577300	827	-	285
AT2G17460	2	7582173	7583230	1057	+	0
AT2G17470	2	7584504	7588008	3504	-	25
AT2G17477	2	7589807	7590264	457	+	0
AT2G17480	2	7590294	7594090	3796	-	415
AT2G17490	2	7598984	7602121	3137	-	16
AT2G17500	2	7606756	7609278	2522	+	210
AT2G17510	2	7609235	7616342	7107	-	770
AT2G17520	2	7617209	7621109	3900	+	597
AT2G17525	2	7623825	7626186	2361	+	144
AT2G17530	2	7626357	7629149	2792	+	362
AT2G17540	2	7630419	7631912	1493	-	483
AT2G17550	2	7634273	7637832	3559	-	282
AT2G17556	2	7640672	7640771	99	-	0
AT2G17560	2	7642164	7643667	1503	-	899
AT2G17570	2	7644052	7646254	2202	+	79
AT2G17580	2	7646462	7650320	3858	+	240
AT2G17590	2	7651129	7653180	2051	-	0
AT2G17600	2	7654476	7656219	1743	-	0
AT2G17610	2	7657603	7660014	2411	-	0
AT2G17620	2	7664102	7666522	2420	+	28
AT2G17630	2	7666584	7668065	1481	+	289
AT2G17640	2	7668077	7670495	2418	-	340
AT2G17650	2	7671015	7673036	2021	+	209
AT2G17660	2	7673281	7673712	431	+	4
AT2G17670	2	7674350	7676157	1807	+	107
AT2G17680	2	7679007	7680378	1371	+	0
AT2G17690	2	7682382	7684083	1701	+	6
AT2G17695	2	7684111	7685187	1076	-	1726
AT2G17700	2	7685387	7689436	4049	-	551
AT2G17705	2	7692443	7693253	810	+	112
AT2G17710	2	7693595	7694746	1151	+	159
AT2G17720	2	7697335	7699568	2233	+	425
AT2G17723	2	7700133	7700675	542	+	0
AT2G17730	2	7703855	7705750	1895	+	182
AT2G17740	2	7706895	7707861	966	-	4
AT2G17750	2	7709191	7711151	1960	-	0
AT2G17760	2	7713313	7716464	3151	+	490
AT2G17770	2	7723102	7724323	1221	+	9
AT2G17780	2	7724884	7727404	2520	-	371
AT2G17785	2	7728185	7728927	742	-	0
AT2G17787	2	7731074	7733019	1945	+	147
AT2G17790	2	7733634	7739673	6039	+	742
AT2G17800	2	7739855	7742156	2301	+	905
AT2G17810	2	7742711	7742785	74	+	0
AT2G17820	2	7742923	7748220	5297	-	984
AT2G17830	2	7754209	7755604	1395	+	35
AT2G17840	2	7755604	7757852	2248	-	612
AT2G17845	2	7758845	7759881	1036	+	1
AT2G17850	2	7760004	7760822	818	-	2
AT2G17860	2	7762256	7763018	762	-	0
AT2G17870	2	7763974	7765230	1256	-	612
AT2G17880	2	7766961	7767931	970	-	114
AT2G17890	2	7769884	7772627	2743	-	0
AT2G17900	2	7773327	7776683	3356	-	114
AT2G17910	2	7778494	7782529	4035	+	0
AT2G17920	2	7782711	7784287	1576	+	0
AT2G17930	2	7784287	7802230	17943	-	2633
AT2G17940	2	7802824	7803947	1123	+	1
AT2G17950	2	7808870	7810795	1925	-	0
AT2G17960	2	7812379	7813129	750	-	0
AT2G17970	2	7818817	7821379	2562	-	238
AT2G17972	2	7821584	7822330	746	+	846
AT2G17975	2	7822073	7824005	1932	-	145
AT2G17980	2	7824165	7826597	2432	+	846
AT2G17990	2	7826816	7828754	1938	+	716
AT2G18000	2	7829034	7830580	1546	+	17
AT2G18010	2	7833901	7834240	339	+	9
AT2G18020	2	7837101	7838304	1203	+	6654
AT2G18030	2	7840066	7841823	1757	+	276
AT2G18040	2	7842163	7843870	1707	+	1634
AT2G18042	2	7844446	7844815	369	+	0
AT2G18050	2	7845922	7846884	962	+	110
AT2G18060	2	7848398	7850303	1905	-	26
AT2G18070	2	7852528	7853666	1138	+	0
AT2G18080	2	7857197	7859715	2518	+	0
AT2G18090	2	7864313	7867766	3453	+	489
AT2G18100	2	7867827	7871642	3815	+	45
AT2G18110	2	7872250	7873912	1662	+	947
AT2G18115	2	7874136	7875027	891	+	1
AT2G18120	2	7876614	7877681	1067	-	65
AT2G18130	2	7879307	7883935	4628	-	0
AT2G18140	2	7887583	7888878	1295	-	0
AT2G18150	2	7892132	7893653	1521	-	25
AT2G18160	2	7898011	7899242	1231	-	0
AT2G18162	2	7898011	7899242	1231	-	0
AT2G18170	2	7907803	7909923	2120	-	231
AT2G18180	2	7911053	7913695	2642	-	10
AT2G18190	2	7914304	7915872	1568	-	0
AT2G18193	2	7917504	7919277	1773	-	19
AT2G18196	2	7920507	7922326	1819	-	11
AT2G18200	2	7924266	7924659	393	-	0
AT2G18210	2	7924957	7925875	918	-	14
AT2G18220	2	7928023	7931851	3828	+	301
AT2G18230	2	7931922	7934329	2407	-	1437
AT2G18240	2	7935284	7936721	1437	+	220
AT2G18245	2	7937281	7939600	2319	+	237
AT2G18250	2	7939906	7941678	1772	+	316
AT2G18260	2	7942152	7943388	1236	+	64
AT2G18270	2	7946157	7946406	249	-	0
AT2G18280	2	7945997	7948468	2471	+	1456
AT2G18290	2	7948305	7950329	2024	-	328
AT2G18300	2	7952441	7954739	2298	-	2370
AT2G18310	2	7955676	7955750	74	-	0
AT2G18320	2	7956219	7957531	1312	+	1
AT2G18323	2	7960351	7960564	213	+	0
AT2G18328	2	7964392	7964909	517	+	1150
AT2G18330	2	7965634	7969105	3471	+	249
AT2G18340	2	7969319	7971114	1795	+	1
AT2G18350	2	7971016	7972081	1065	-	105
AT2G18360	2	7976711	7979377	2666	-	21
AT2G18370	2	7980624	7981758	1134	+	15
AT2G18380	2	7982867	7984096	1229	-	46
AT2G18390	2	7988164	7989525	1361	+	272
AT2G18400	2	7989475	7990586	1111	-	247
AT2G18410	2	7990745	7992774	2029	+	181
AT2G18420	2	7993800	7994554	754	+	0
AT2G18440	2	7994940	7997239	2299	-	3604
AT2G18450	2	7997391	8000804	3413	-	1
AT2G18460	2	8001319	8002998	1679	+	0
AT2G18465	2	8002890	8004844	1954	-	184
AT2G18470	2	8005284	8008052	2768	-	28
AT2G18480	2	8009322	8011255	1933	-	31
AT2G18490	2	8020667	8021423	756	+	0
AT2G18500	2	8027033	8028251	1218	+	30
AT2G18510	2	8031181	8033619	2438	-	437
AT2G18520	2	8033881	8035363	1482	-	42
AT2G18530	2	8039669	8040780	1111	+	0
AT2G18540	2	8042381	8045008	2627	-	0
AT2G18550	2	8049662	8051213	1551	-	0
AT2G18560	2	8059287	8061056	1769	+	442
AT2G18570	2	8063319	8065008	1689	+	240
AT2G18580	2	8065892	8067109	1217	-	0
AT2G18590	2	8069944	8072866	2922	+	0
AT2G18600	2	8073199	8074982	1783	-	42
AT2G18610	2	8076347	8077314	967	-	0
AT2G18620	2	8078287	8079360	1073	+	3
AT2G18630	2	8080502	8082698	2196	+	533
AT2G18640	2	8083739	8084888	1149	-	0
AT2G18650	2	8086859	8088131	1272	-	12
AT2G18660	2	8090657	8091656	999	-	112
AT2G18670	2	8093219	8095729	2510	+	122
AT2G18680	2	8094779	8095779	1000	+	0
AT2G18690	2	8097419	8098827	1408	+	43
AT2G18700	2	8109042	8112010	2968	+	1139
AT2G18710	2	8112083	8114485	2402	-	2660
AT2G18720	2	8114919	8116811	1892	-	7
AT2G18721	2	8116998	8117106	108	+	0
AT2G18730	2	8118829	8121925	3096	+	942
AT2G18735	2	8122118	8123076	958	+	87
AT2G18740	2	8123194	8125004	1810	+	522
AT2G18750	2	8125472	8128673	3201	+	1319
AT2G18760	2	8129153	8133502	4349	+	303
AT2G18770	2	8134638	8136560	1922	+	301
AT2G18780	2	8136757	8138118	1361	-	24
AT2G18790	2	8139880	8144430	4550	+	1855
AT2G18800	2	8144911	8146265	1354	+	0
AT2G18810	2	8147938	8149469	1531	-	0
AT2G18820	2	8150994	8156099	5105	+	0
AT2G18830	2	8156203	8156401	198	-	0
AT2G18840	2	8158197	8160091	1894	+	211
AT2G18850	2	8160702	8163750	3048	+	259
AT2G18860	2	8164240	8165974	1734	+	486
AT2G18870	2	8167470	8168668	1198	+	0
AT2G18876	2	8169545	8172523	2978	+	234
AT2G18880	2	8172188	8178995	6807	+	0
AT2G18890	2	8183889	8186796	2907	+	399
AT2G18900	2	8188256	8192489	4233	-	300
AT2G18910	2	8192707	8194338	1631	-	447
AT2G18915	2	8194571	8197483	2912	-	357
AT2G18917	2	8197113	8198103	990	+	2
AT2G18920	2	8197752	8198160	408	-	0
AT2G18930	2	8198777	8199072	295	+	0
AT2G18938	2	8202215	8202690	475	+	3
AT2G18940	2	8203729	8206395	2666	-	709
AT2G18950	2	8207341	8210463	3122	+	604
AT2G18960	2	8221630	8227622	5992	+	10734
AT2G18969	2	8229046	8229574	528	-	5
AT2G18970	2	8229115	8229755	640	+	1
AT2G18980	2	8233334	8235316	1982	-	11
AT2G18990	2	8238690	8240002	1312	-	340
AT2G19000	2	8241103	8241784	681	+	0
AT2G19010	2	8243088	8245378	2290	+	0
AT2G19020	2	8246219	8246441	222	+	0
AT2G19030	2	8247782	8248001	219	+	0
AT2G19040	2	8249922	8250141	219	+	0
AT2G19045	2	8251673	8251892	219	+	0
AT2G19050	2	8253415	8255534	2119	+	0
AT2G19060	2	8256999	8260545	3546	+	0
AT2G19070	2	8260037	8261985	1948	-	0
AT2G19080	2	8262749	8264964	2215	+	415
AT2G19090	2	8265177	8267879	2702	-	156
AT2G19100	2	8269780	8274895	5115	-	0
AT2G19110	2	8278880	8286445	7565	+	635
AT2G19120	2	8287035	8292498	5463	-	78
AT2G19130	2	8293681	8296275	2594	+	196
AT2G19140	2	8297916	8301717	3801	-	1
AT2G19146	2	8304028	8304455	427	+	0
AT2G19150	2	8305099	8307444	2345	+	0
AT2G19160	2	8309815	8314008	4193	+	305
AT2G19170	2	8314004	8318596	4592	-	330
AT2G19180	2	8324715	8325965	1250	+	399
AT2G19190	2	8326048	8329944	3896	-	9
AT2G19200	2	8333199	8334730	1531	+	0
AT2G19210	2	8335638	8339307	3669	-	0
AT2G19220	2	8340677	8342161	1484	-	0
AT2G19230	2	8343451	8348431	4980	-	0
AT2G19240	2	8349047	8352562	3515	-	16
AT2G19250	2	8352685	8355700	3015	+	158
AT2G19260	2	8356140	8360169	4029	+	205
AT2G19270	2	8360188	8361924	1736	-	462
AT2G19280	2	8362434	8366144	3710	+	288
AT2G19290	2	8365918	8367022	1104	-	0
AT2G19300	2	8368039	8368219	180	-	0
AT2G19310	2	8369793	8370406	613	-	763
AT2G19320	2	8370690	8371108	418	-	0
AT2G19330	2	8372946	8374453	1507	+	7
AT2G19340	2	8373765	8375939	2174	-	130
AT2G19350	2	8376201	8377343	1142	+	101
AT2G19360	2	8378663	8383374	4711	+	0
AT2G19380	2	8383855	8386604	2749	+	56
AT2G19385	2	8387034	8388712	1678	+	150
AT2G19390	2	8389799	8397862	8063	-	419
AT2G19400	2	8399156	8402601	3445	-	229
AT2G19410	2	8404900	8409012	4112	-	0
AT2G19420	2	8411700	8413883	2183	+	0
AT2G19425	2	8412515	8412618	103	-	0
AT2G19430	2	8415158	8417960	2802	+	311
AT2G19440	2	8418163	8419806	1643	-	5
AT2G19450	2	8426205	8429736	3531	+	20
AT2G19460	2	8431481	8432105	624	+	87
AT2G19470	2	8433610	8436553	2943	-	592
AT2G19480	2	8438392	8441384	2992	+	2190
AT2G19490	2	8441526	8444170	2644	+	84
AT2G19500	2	8444203	8447355	3152	-	1
AT2G19510	2	8453218	8453682	464	+	0
AT2G19520	2	8455935	8459525	3590	+	1417
AT2G19530	2	8459946	8461715	1769	+	25
AT2G19540	2	8461756	8464534	2778	+	977
AT2G19550	2	8464532	8465531	999	-	4
AT2G19560	2	8465767	8469116	3349	-	269
AT2G19570	2	8470373	8471644	1271	-	6
AT2G19572	2	8470619	8471735	1116	+	0
AT2G19580	2	8472133	8475153	3020	-	65
AT2G19582	2	8474445	8475221	776	+	0
AT2G19590	2	8475965	8477502	1537	-	73
AT2G19600	2	8479197	8483830	4633	+	470
AT2G19610	2	8483939	8486086	2147	+	0
AT2G19620	2	8485990	8488720	2730	-	256
AT2G19630	2	8490180	8491110	930	-	3
AT2G19640	2	8491387	8492920	1533	+	126
AT2G19650	2	8493474	8495823	2349	-	640
AT2G19660	2	8496719	8498708	1989	-	6
AT2G19670	2	8499085	8501181	2096	-	147
AT2G19680	2	8501324	8502831	1507	+	693
AT2G19690	2	8503216	8504821	1605	+	103
AT2G19700	2	8504966	8505639	673	-	0
AT2G19710	2	8506129	8510081	3952	+	253
AT2G19720	2	8510019	8511339	1320	-	99
AT2G19730	2	8511506	8513221	1715	+	3931
AT2G19740	2	8513512	8514519	1007	+	722
AT2G19750	2	8514953	8516138	1185	+	927
AT2G19755	2	8516187	8516559	372	-	0
AT2G19760	2	8516786	8518167	1381	-	1440
AT2G19770	2	8519637	8521192	1555	-	0
AT2G19780	2	8522677	8525093	2416	-	267
AT2G19790	2	8527230	8528533	1303	+	830
AT2G19796	2	8529915	8530187	272	-	0
AT2G19800	2	8530895	8533508	2613	-	7
AT2G19802	2	8538775	8539217	442	-	0
AT2G19803	2	8540456	8540990	534	+	0
AT2G19806	2	8545633	8547002	1369	+	0
AT2G19810	2	8550312	8551858	1546	+	327
AT2G19820	2	8553542	8554040	498	-	0
AT2G19825	2	8554953	8555559	606	+	0
AT2G19830	2	8557728	8559741	2013	-	2036
AT2G19840	2	8562494	8566522	4028	-	0
AT2G19850	2	8568568	8569890	1322	+	0
AT2G19860	2	8570749	8574000	3251	+	1080
AT2G19870	2	8575877	8577947	2070	+	609
AT2G19880	2	8581357	8585478	4121	+	666
AT2G19890	2	8587243	8589637	2394	+	0
AT2G19893	2	8589952	8590324	372	+	0
AT2G19900	2	8591898	8595478	3580	-	4
AT2G19910	2	8595819	8600757	4938	-	99
AT2G19920	2	8602221	8606887	4666	-	75
AT2G19930	2	8607339	8612441	5102	-	184
AT2G19940	2	8612925	8616018	3093	+	1562
AT2G19950	2	8616072	8621435	5363	-	700
AT2G19960	2	8622214	8622736	522	+	0
AT2G19970	2	8623729	8624476	747	-	17
AT2G19980	2	8627698	8628220	522	-	4
AT2G19990	2	8629983	8630688	705	-	11
AT2G20000	2	8632077	8637300	5223	-	646
AT2G20010	2	8637746	8641556	3810	-	429
AT2G20020	2	8644385	8647191	2806	+	923
AT2G20030	2	8647812	8648985	1173	+	0
AT2G20050	2	8649433	8654450	5017	-	1672
AT2G20060	2	8659042	8661489	2447	+	464
AT2G20070	2	8662037	8662614	577	+	0
AT2G20080	2	8662929	8665026	2097	-	0
AT2G20100	2	8678049	8682112	4063	+	243
AT2G20110	2	8684495	8687218	2723	+	58
AT2G20120	2	8687353	8689476	2123	-	394
AT2G20130	2	8690367	8692420	2053	-	228
AT2G20140	2	8692699	8695084	2385	+	986
AT2G20142	2	8695373	8696643	1270	+	47
AT2G20150	2	8697299	8699299	2000	+	1
AT2G20160	2	8699671	8700124	453	-	0
AT2G20170	2	8701012	8704357	3345	+	0
AT2G20180	2	8704023	8706900	2877	-	624
AT2G20190	2	8711595	8719018	7423	-	2336
AT2G20208	2	8720789	8721423	634	+	0
AT2G20210	2	8721436	8725127	3691	-	181
AT2G20230	2	8725540	8727742	2202	+	1696
AT2G20240	2	8727625	8730500	2875	-	341
AT2G20250	2	8733749	8736577	2828	-	189
AT2G20260	2	8736733	8737767	1034	+	12707
AT2G20270	2	8737704	8739677	1973	-	940
AT2G20280	2	8739910	8742349	2439	-	936
AT2G20290	2	8743274	8751878	8604	-	636
AT2G20298	2	8754482	8754907	425	-	0
AT2G20300	2	8755924	8760222	4298	-	683
AT2G20310	2	8761179	8763152	1973	-	162
AT2G20320	2	8766738	8772591	5853	+	240
AT2G20330	2	8772686	8775614	2928	-	596
AT2G20340	2	8779734	8782772	3038	+	971
AT2G20350	2	8784768	8785396	628	+	0
AT2G20360	2	8785987	8789473	3486	+	3240
AT2G20362	2	8789739	8790358	619	+	28
AT2G20370	2	8791985	8794401	2416	+	526
AT2G20380	2	8794817	8795980	1163	-	0
AT2G20390	2	8796282	8798218	1936	-	174
AT2G20400	2	8799186	8801973	2787	+	120
AT2G20410	2	8802343	8804373	2030	+	155
AT2G20420	2	8805452	8808120	2668	+	3095
AT2G20430	2	8808666	8810200	1534	-	0
AT2G20440	2	8810738	8813644	2906	-	229
AT2G20450	2	8813861	8815253	1392	+	1066
AT2G20453	2	8815589	8815793	204	+	0
AT2G20460	2	8816236	8820622	4386	-	1
AT2G20463	2	8823732	8824122	390	-	0
AT2G20465	2	8825052	8825544	492	-	0
AT2G20470	2	8826276	8829497	3221	-	5
AT2G20480	2	8830564	8831533	969	-	22
AT2G20490	2	8831715	8832916	1201	+	318
AT2G20495	2	8833164	8835263	2099	+	201
AT2G20500	2	8835119	8836044	925	-	69
AT2G20510	2	8836017	8838598	2581	-	0
AT2G20515	2	8838853	8839700	847	-	62
AT2G20520	2	8840662	8841461	799	+	0
AT2G20530	2	8841971	8844000	2029	+	628
AT2G20540	2	8844159	8845764	1605	+	26
AT2G20550	2	8845801	8847311	1510	-	107
AT2G20555	2	8847444	8848168	724	+	3
AT2G20560	2	8848129	8850010	1881	-	147
AT2G20562	2	8850206	8850929	723	-	28
AT2G20570	2	8855357	8857756	2399	+	6588
AT2G20580	2	8858987	8864865	5878	+	3192
AT2G20585	2	8865097	8866769	1672	+	125
AT2G20590	2	8867116	8869256	2140	-	128
AT2G20595	2	8871550	8872061	511	-	0
AT2G20597	2	8873059	8873484	425	+	0
AT2G20600	2	8875007	8875242	235	-	0
AT2G20605	2	8876489	8876732	243	+	2
AT2G20610	2	8877959	8880388	2429	-	3005
AT2G20613	2	8886036	8886444	408	-	0
AT2G20616	2	8887115	8888305	1190	-	0
AT2G20618	2	8888932	8889178	246	+	0
AT2G20619	2	8891190	8891391	201	+	0
AT2G20620	2	8891928	8893244	1316	-	1
AT2G20625	2	8896153	8897218	1065	-	0
AT2G20630	2	8896911	8899898	2987	-	2088
AT2G20635	2	8900409	8903384	2975	+	161
AT2G20650	2	8903636	8907339	3703	-	179
AT2G20660	2	8909466	8909772	306	+	0
AT2G20670	2	8911859	8913534	1675	-	942
AT2G20680	2	8920466	8923173	2707	+	175
AT2G20690	2	8923304	8924974	1670	+	1036
AT2G20700	2	8924893	8925804	911	-	22
AT2G20710	2	8926005	8927844	1839	+	57
AT2G20720	2	8927821	8930112	2291	-	116
AT2G20721	2	8931564	8931655	91	-	17
AT2G20722	2	8931707	8931782	75	-	15
AT2G20723	2	8931848	8931922	74	-	11
AT2G20724	2	8932715	8933262	547	-	462
AT2G20725	2	8933570	8935496	1926	-	945
AT2G20740	2	8935606	8937512	1906	+	486
AT2G20750	2	8941118	8942689	1571	+	654
AT2G20760	2	8942762	8945244	2482	-	1501
AT2G20770	2	8945317	8947310	1993	+	91
AT2G20780	2	8947241	8949413	2172	-	244
AT2G20784	2	8949620	8949776	156	+	2
AT2G20790	2	8949927	8952744	2817	-	563
AT2G20800	2	8953251	8955761	2510	-	0
AT2G20805	2	8956168	8956737	569	+	1
AT2G20810	2	8957792	8959780	1988	+	416
AT2G20815	2	8959254	8962001	2747	+	116
AT2G20816	2	8962762	8963527	765	+	0
AT2G20818	2	8963651	8964024	373	-	0
AT2G20820	2	8964348	8965430	1082	+	1981
AT2G20825	2	8965755	8966867	1112	-	0
AT2G20830	2	8968208	8970727	2519	-	739
AT2G20835	2	8970885	8971303	418	-	12
AT2G20840	2	8971711	8974485	2774	-	229
AT2G20850	2	8975347	8979379	4032	-	463
AT2G20860	2	8979578	8981226	1648	+	2783
AT2G20870	2	8981987	8982712	725	-	24
AT2G20875	2	8983073	8983612	539	-	48
AT2G20880	2	8985972	8987263	1291	+	23
AT2G20890	2	8987665	8989416	1751	+	15013
AT2G20900	2	8989274	8993114	3840	-	567
AT2G20910	2	8994147	8996804	2657	-	1
AT2G20920	2	8998685	8999932	1247	+	1950
AT2G20921	2	9000024	9000228	204	-	0
AT2G20930	2	9000615	9001737	1122	-	473
AT2G20940	2	9002031	9002701	670	-	80
AT2G20950	2	9003134	9005938	2804	+	674
AT2G20960	2	9006647	9009763	3116	+	807
AT2G20970	2	9009866	9011067	1201	+	0
AT2G20980	2	9011388	9013931	2543	-	118
AT2G20990	2	9014551	9018097	3546	+	5132
AT2G20993	2	9018577	9019036	459	+	0
AT2G21000	2	9019505	9020219	714	+	0
AT2G21010	2	9020943	9021870	927	+	0
AT2G21020	2	9022777	9024211	1434	-	1
AT2G21030	2	9024535	9025578	1043	-	0
AT2G21040	2	9026156	9027310	1154	+	0
AT2G21045	2	9027851	9029020	1169	+	1
AT2G21050	2	9034089	9036636	2547	+	569
AT2G21060	2	9036792	9037650	858	-	475
AT2G21070	2	9040851	9043626	2775	+	121
AT2G21080	2	9043698	9045389	1691	+	208
AT2G21090	2	9045515	9047579	2064	-	104
AT2G21100	2	9048130	9049404	1274	-	4
AT2G21110	2	9050289	9050850	561	-	0
AT2G21120	2	9051747	9054613	2866	-	627
AT2G21130	2	9055397	9056232	835	-	22
AT2G21140	2	9060624	9062091	1467	-	922
AT2G21150	2	9065337	9068093	2756	+	441
AT2G21160	2	9068317	9070431	2114	+	2006
AT2G21170	2	9070753	9073233	2480	-	13337
AT2G21172	2	9073534	9073752	218	-	0
AT2G21180	2	9074659	9075380	721	-	89
AT2G21185	2	9076436	9077048	612	-	0
AT2G21187	2	9076291	9077468	1177	+	4
AT2G21188	2	9079041	9079538	497	-	38
AT2G21190	2	9080864	9082904	2040	+	591
AT2G21195	2	9083164	9083909	745	+	260
AT2G21200	2	9083905	9084375	470	-	20
AT2G21210	2	9085209	9085909	700	-	730
AT2G21220	2	9089325	9089813	488	+	5
AT2G21230	2	9093623	9096347	2724	-	559
AT2G21235	2	9096591	9098767	2176	-	0
AT2G21237	2	9100535	9101215	680	-	0
AT2G21240	2	9101312	9103050	1738	-	680
AT2G21250	2	9103180	9105187	2007	-	1685
AT2G21260	2	9105582	9107380	1798	-	12
AT2G21270	2	9107545	9110261	2716	+	1176
AT2G21280	2	9110312	9112707	2395	-	2545
AT2G21290	2	9112855	9113330	475	+	584
AT2G21300	2	9114153	9119946	5793	-	1229
AT2G21310	2	9122621	9125212	2591	+	0
AT2G21320	2	9126262	9127843	1581	+	830
AT2G21330	2	9128146	9130240	2094	-	64884
AT2G21340	2	9132554	9136459	3905	+	2037
AT2G21350	2	9136450	9137267	817	-	7
AT2G21360	2	9137355	9137427	72	+	0
AT2G21370	2	9137453	9140081	2628	-	1757
AT2G21380	2	9141630	9149309	7679	+	1877
AT2G21385	2	9149638	9151913	2275	+	2705
AT2G21390	2	9152005	9156878	4873	+	2996
AT2G21400	2	9158389	9159701	1312	+	0
AT2G21410	2	9162619	9168452	5833	+	1561
AT2G21420	2	9169712	9171746	2034	+	1
AT2G21430	2	9171884	9173339	1455	-	25
AT2G21440	2	9173559	9179166	5607	-	737
AT2G21450	2	9179409	9182356	2947	-	9
AT2G21460	2	9188337	9194491	6154	-	14
AT2G21465	2	9195595	9195926	331	-	0
AT2G21470	2	9198568	9202487	3919	+	773
AT2G21480	2	9202752	9205368	2616	-	0
AT2G21490	2	9206015	9207125	1110	-	0
AT2G21500	2	9207548	9210231	2683	-	157
AT2G21510	2	9210654	9213058	2404	-	18
AT2G21520	2	9215518	9219208	3690	+	1319
AT2G21530	2	9219323	9220590	1267	+	3199
AT2G21540	2	9220548	9224496	3948	-	298
AT2G21550	2	9227208	9230189	2981	+	46
AT2G21560	2	9230267	9231508	1241	-	498
AT2G21570	2	9234239	9234276	37	-	0
AT2G21580	2	9236522	9237811	1289	+	2181
AT2G21590	2	9238481	9242440	3959	+	254
AT2G21600	2	9242800	9244833	2033	+	935
AT2G21610	2	9245160	9247025	1865	-	0
AT2G21620	2	9248572	9250256	1684	+	910
AT2G21630	2	9250322	9253915	3593	+	173
AT2G21640	2	9254458	9255625	1167	+	56
AT2G21650	2	9259582	9260656	1074	+	1906
AT2G21655	2	9263536	9264098	562	+	0
AT2G21660	2	9265248	9266393	1145	-	565
AT2G21670	2	9266808	9266889	81	-	0
AT2G21680	2	9267729	9269019	1290	+	0
AT2G21690	2	9270113	9270597	484	-	0
AT2G21700	2	9270662	9270734	72	-	0
AT2G21710	2	9270885	9273418	2533	+	172
AT2G21720	2	9273695	9276802	3107	+	0
AT2G21725	2	9277658	9278072	414	+	0
AT2G21727	2	9278596	9279052	456	-	0
AT2G21730	2	9280043	9281623	1580	+	9
AT2G21740	2	9281985	9282363	378	-	0
AT2G21750	2	9283366	9283744	378	-	0
AT2G21760	2	9284033	9284105	72	+	0
AT2G21770	2	9284836	9289536	4700	+	45
AT2G21780	2	9291035	9291669	634	+	0
AT2G21790	2	9293269	9297842	4573	+	1346
AT2G21800	2	9298153	9301926	3773	+	47
AT2G21810	2	9302253	9302640	387	+	0
AT2G21820	2	9302884	9303247	363	-	4
AT2G21830	2	9303712	9305897	2185	+	311
AT2G21840	2	9307059	9310058	2999	-	11
AT2G21850	2	9315217	9318238	3021	+	40
AT2G21860	2	9318257	9320002	1745	-	1610
AT2G21870	2	9320194	9322734	2540	-	6597
AT2G21880	2	9324632	9326321	1689	-	68
AT2G21890	2	9331088	9332646	1558	+	12
AT2G21895	2	9333001	9333336	335	-	1
AT2G21900	2	9334148	9336222	2074	-	0
AT2G21905	2	9339166	9339477	311	+	0
AT2G21910	2	9341497	9343030	1533	+	1
AT2G21920	2	9343409	9347159	3750	-	0
AT2G21930	2	9347640	9349128	1488	-	0
AT2G21940	2	9350542	9353231	2689	+	286
AT2G21950	2	9353173	9354645	1472	-	427
AT2G21960	2	9354841	9357091	2250	+	3582
AT2G21970	2	9356982	9357916	934	-	3684
AT2G21980	2	9358881	9359061	180	-	0
AT2G21990	2	9359355	9360664	1309	-	21
AT2G22000	2	9362311	9363203	892	+	68
AT2G22010	2	9363108	9369461	6353	-	1191
AT2G22030	2	9372529	9373681	1152	+	0
AT2G22040	2	9374437	9376260	1823	-	0
AT2G22050	2	9376683	9377862	1179	+	0
AT2G22055	2	9379577	9379817	240	+	0
AT2G22060	2	9380991	9382145	1154	+	0
AT2G22070	2	9383601	9386064	2463	+	20
AT2G22080	2	9386515	9388183	1668	+	935
AT2G22088	2	9388383	9389049	666	+	4
AT2G22090	2	9388259	9390507	2248	-	323
AT2G22100	2	9392209	9393562	1353	-	145
AT2G22110	2	9393669	9393743	74	+	0
AT2G22120	2	9393822	9397022	3200	+	236
AT2G22121	2	9397863	9398259	396	+	0
AT2G22122	2	9403263	9403808	545	+	43
AT2G22125	2	9406262	9414518	8256	+	3680
AT2G22140	2	9414838	9418668	3830	-	49
AT2G22145	2	9420319	9420589	270	+	0
AT2G22150	2	9421682	9422858	1176	-	0
AT2G22155	2	9423868	9424174	306	+	0
AT2G22160	2	9425142	9425460	318	-	0
AT2G22170	2	9426848	9427817	969	-	664
AT2G22180	2	9428742	9429844	1102	+	0
AT2G22190	2	9433764	9436544	2780	-	558
AT2G22200	2	9443127	9444423	1296	-	71
AT2G22201	2	9444536	9444719	183	+	0
AT2G22210	2	9446288	9449356	3068	+	0
AT2G22220	2	9449808	9449882	74	-	0
AT2G22230	2	9449983	9451622	1639	+	1074
AT2G22240	2	9451604	9454094	2490	-	1886
AT2G22241	2	9454243	9454399	156	+	0
AT2G22250	2	9457809	9460919	3110	-	610
AT2G22260	2	9461124	9463192	2068	+	108
AT2G22270	2	9463693	9465467	1774	+	135
AT2G22280	2	9465580	9465653	73	-	0
AT2G22290	2	9466443	9467688	1245	+	0
AT2G22300	2	9471324	9476646	5322	+	1001
AT2G22310	2	9476577	9478959	2382	-	176
AT2G22320	2	9480104	9480440	336	+	0
AT2G22330	2	9488553	9491187	2634	+	1332
AT2G22335	2	9491686	9492453	767	+	0
AT2G22340	2	9492878	9493955	1077	-	1
AT2G22345	2	9495456	9495848	392	+	0
AT2G22350	2	9496075	9497041	966	+	0
AT2G22360	2	9497594	9500615	3021	+	1446
AT2G22370	2	9500814	9502190	1376	-	212
AT2G22380	2	9502279	9502353	74	+	0
AT2G22390	2	9503363	9504587	1224	+	68
AT2G22400	2	9504658	9508875	4217	-	639
AT2G22410	2	9509016	9511231	2215	+	41
AT2G22420	2	9513218	9514535	1317	+	106
AT2G22425	2	9514935	9515535	600	+	574
AT2G22426	2	9517016	9517229	213	+	0
AT2G22430	2	9526094	9527830	1736	-	4370
AT2G22440	2	9528909	9529917	1008	+	0
AT2G22450	2	9530546	9532914	2368	+	89
AT2G22460	2	9533093	9534119	1026	-	0
AT2G22470	2	9538196	9538879	683	-	122
AT2G22475	2	9541400	9545010	3610	+	232
AT2G22480	2	9545546	9548566	3020	+	700
AT2G22482	2	9549648	9550084	436	-	47
AT2G22490	2	9553802	9556145	2343	-	352
AT2G22496	2	9560760	9560923	163	+	0
AT2G22500	2	9563223	9564751	1528	-	315
AT2G22510	2	9569025	9569758	733	-	28
AT2G22520	2	9572065	9572791	726	+	0
AT2G22530	2	9572795	9577441	4646	-	329
AT2G22540	2	9579873	9583893	4020	+	3180
AT2G22560	2	9585882	9588838	2956	+	64
AT2G22570	2	9589434	9590879	1445	-	100
AT2G22580	2	9591026	9591099	73	+	0
AT2G22590	2	9592995	9594535	1540	+	10
AT2G22600	2	9596616	9599050	2434	+	14
AT2G22610	2	9599549	9604776	5227	+	278
AT2G22620	2	9604771	9610595	5824	-	49
AT2G22630	2	9618371	9621957	3586	+	0
AT2G22640	2	9623067	9624218	1151	+	272
AT2G22650	2	9624585	9626969	2384	-	255
AT2G22660	2	9627407	9631081	3674	+	1082
AT2G22668	2	9634956	9635113	157	-	0
AT2G22670	2	9636379	9638745	2366	+	5425
AT2G22680	2	9645312	9647613	2301	+	71
AT2G22690	2	9649689	9651439	1750	-	194
AT2G22710	2	9651718	9654532	2814	+	0
AT2G22720	2	9657343	9660776	3433	+	1092
AT2G22730	2	9660963	9664133	3170	+	114
AT2G22740	2	9662637	9666981	4344	-	488
AT2G22750	2	9672143	9673928	1785	+	0
AT2G22760	2	9677879	9679364	1485	+	0
AT2G22770	2	9684724	9686595	1871	+	50
AT2G22780	2	9689414	9692154	2740	-	1394
AT2G22790	2	9695931	9696909	978	+	33
AT2G22795	2	9697232	9699897	2665	-	1896
AT2G22800	2	9704705	9706150	1445	-	140
AT2G22802	2	9708749	9708848	99	-	0
AT2G22805	2	9712290	9713001	711	+	0
AT2G22807	2	9715084	9715983	899	+	0
AT2G22810	2	9717790	9719472	1682	-	55
AT2G22820	2	9721230	9721425	195	-	0
AT2G22821	2	9721235	9721937	702	+	4
AT2G22830	2	9723679	9726270	2591	-	244
AT2G22840	2	9728755	9731301	2546	+	264
AT2G22850	2	9731278	9733400	2122	-	22
AT2G22860	2	9737606	9738298	692	+	2
AT2G22870	2	9739456	9741104	1648	+	277
AT2G22880	2	9741118	9741463	345	-	1
AT2G22890	2	9742392	9743347	955	-	49
AT2G22900	2	9744224	9746292	2068	-	283
AT2G22905	2	9748770	9749542	772	+	28
AT2G22910	2	9749868	9752863	2995	+	516
AT2G22920	2	9753630	9757600	3970	+	34
AT2G22930	2	9759672	9761163	1491	+	10
AT2G22940	2	9761654	9763462	1808	-	0
AT2G22941	2	9762104	9762443	339	+	0
AT2G22942	2	9763813	9764563	750	-	0
AT2G22950	2	9766126	9769766	3640	+	0
AT2G22955	2	9770699	9771553	854	-	0
AT2G22960	2	9770893	9772932	2039	+	0
AT2G22970	2	9774852	9778528	3676	+	485
AT2G22980	2	9778876	9783251	4375	+	1203
AT2G22990	2	9786315	9790179	3864	+	9411
AT2G23000	2	9792211	9795863	3652	+	1279
AT2G23010	2	9798842	9802674	3832	+	47
AT2G23020	2	9803216	9803288	72	-	0
AT2G23030	2	9803491	9806700	3209	-	1
AT2G23040	2	9807892	9809209	1317	-	5
AT2G23050	2	9810656	9812660	2004	+	10
AT2G23060	2	9812770	9814724	1954	-	7
AT2G23067	2	9822004	9822148	144	+	0
AT2G23070	2	9823964	9826898	2934	-	1754
AT2G23080	2	9827112	9829537	2425	+	454
AT2G23090	2	9829449	9830410	961	-	3364
AT2G23093	2	9832122	9834739	2617	+	114
AT2G23096	2	9834765	9836235	1470	-	2
AT2G23100	2	9837119	9839736	2617	-	44
AT2G23110	2	9840455	9841366	911	+	0
AT2G23118	2	9841881	9842025	144	-	3
AT2G23120	2	9842042	9842634	592	+	2153
AT2G23130	2	9844298	9845385	1087	+	910
AT2G23140	2	9845485	9849264	3779	-	559
AT2G23142	2	9850175	9850619	444	+	0
AT2G23148	2	9853617	9854156	539	+	0
AT2G23149	2	9855856	9855964	108	+	0
AT2G23150	2	9856191	9858574	2383	-	156
AT2G23160	2	9862469	9863744	1275	+	0
AT2G23170	2	9863854	9866562	2708	-	105
AT2G23171	2	9866618	9866792	174	-	0
AT2G23180	2	9874906	9876594	1688	+	192
AT2G23190	2	9877057	9879007	1950	+	0
AT2G23200	2	9879275	9881908	2633	+	752
AT2G23210	2	9882006	9883397	1391	-	1
AT2G23220	2	9884549	9886752	2203	+	2
AT2G23230	2	9892715	9895400	2685	+	0
AT2G23240	2	9895854	9896325	471	-	1
AT2G23250	2	9897808	9899125	1317	-	0
AT2G23260	2	9899926	9901439	1513	-	0
AT2G23270	2	9903214	9903845	631	+	0
AT2G23290	2	9904786	9905920	1134	-	120
AT2G23300	2	9914607	9917130	2523	+	55
AT2G23310	2	9917519	9919258	1739	+	404
AT2G23320	2	9924932	9926372	1440	+	225
AT2G23321	2	9926377	9926518	141	+	0
AT2G23330	2	9927825	9932319	4494	-	127
AT2G23340	2	9937997	9938875	878	+	188
AT2G23347	2	9942192	9942293	101	-	1
AT2G23348	2	9941188	9942814	1626	-	20
AT2G23350	2	9943052	9946269	3217	+	3418
AT2G23360	2	9948902	9952845	3943	+	366
AT2G23370	2	9952866	9955091	2225	-	225
AT2G23380	2	9955552	9960359	4807	+	348
AT2G23390	2	9960371	9963623	3252	-	2682
AT2G23400	2	9963977	9965229	1252	-	0
AT2G23410	2	9966129	9967772	1643	-	0
AT2G23420	2	9971700	9975192	3492	+	1348
AT2G23430	2	9976745	9978021	1276	-	550
AT2G23440	2	9979404	9979819	415	+	0
AT2G23450	2	9988753	9991695	2942	-	380
AT2G23460	2	9995477	9999122	3645	+	925
AT2G23470	2	9998981	10001509	2528	-	164
AT2G23480	2	10001892	10004688	2796	+	0
AT2G23490	2	10005108	10005684	576	-	0
AT2G23500	2	10006559	10008914	2355	-	0
AT2G23510	2	10011516	10013533	2017	-	0
AT2G23520	2	10013990	10016943	2953	-	381
AT2G23530	2	10020651	10022864	2213	-	19
AT2G23540	2	10024345	10026233	1888	+	16
AT2G23550	2	10027585	10028777	1192	-	23
AT2G23560	2	10029274	10030382	1108	-	88
AT2G23570	2	10031712	10032753	1041	-	1
AT2G23580	2	10033042	10034327	1285	-	0
AT2G23590	2	10034606	10036000	1394	-	75
AT2G23600	2	10042198	10043673	1475	-	3549
AT2G23610	2	10044178	10046532	2354	-	1090
AT2G23620	2	10047378	10049291	1913	-	3
AT2G23630	2	10052565	10055317	2752	-	0
AT2G23640	2	10057553	10059108	1555	+	0
AT2G23650	2	10059445	10059517	72	-	0
AT2G23660	2	10060129	10061822	1693	-	0
AT2G23670	2	10063154	10063863	709	-	54
AT2G23672	2	10063244	10064004	760	+	14
AT2G23673	2	10064204	10065748	1544	+	39
AT2G23680	2	10066162	10067455	1293	+	47
AT2G23690	2	10072232	10073126	894	+	50
AT2G23700	2	10076368	10080232	3864	-	191
AT2G23710	2	10085906	10088039	2133	+	0
AT2G23720	2	10088773	10092878	4105	-	0
AT2G23740	2	10097558	10103398	5840	+	576
AT2G23755	2	10102786	10104029	1243	-	79
AT2G23760	2	10107708	10113213	5505	-	1057
AT2G23770	2	10120241	10122080	1839	-	106
AT2G23780	2	10123305	10124636	1331	-	619
AT2G23790	2	10125367	10127521	2154	-	473
AT2G23800	2	10131488	10132779	1291	-	0
AT2G23808	2	10135174	10135465	291	+	0
AT2G23810	2	10135604	10137561	1957	-	721
AT2G23820	2	10140526	10142899	2373	+	674
AT2G23830	2	10143645	10144511	866	+	2
AT2G23834	2	10148665	10149134	469	+	0
AT2G23840	2	10153796	10155647	1851	-	1246
AT2G23850	2	10156200	10156896	696	-	0
AT2G23860	2	10157004	10157669	665	+	0
AT2G23870	2	10163416	10164000	584	+	0
AT2G23880	2	10165991	10170262	4271	-	2
AT2G23890	2	10170600	10173927	3327	+	218
AT2G23900	2	10174514	10176626	2112	+	1
AT2G23910	2	10177833	10180064	2231	+	3
AT2G23920	2	10180997	10181211	214	+	0
AT2G23930	2	10182250	10183240	990	+	1027
AT2G23940	2	10183965	10185331	1366	+	329
AT2G23945	2	10185228	10186605	1377	-	1
AT2G23950	2	10187042	10190412	3370	-	689
AT2G23960	2	10196058	10197610	1552	+	13
AT2G23970	2	10199697	10201081	1384	+	0
AT2G23980	2	10201103	10204467	3364	-	776
AT2G23985	2	10204991	10206407	1416	+	165
AT2G23990	2	10206834	10207911	1077	-	0
AT2G24000	2	10209474	10214042	4568	+	0
AT2G24010	2	10214713	10217542	2829	+	36
AT2G24020	2	10217640	10219396	1756	-	2950
AT2G24030	2	10220060	10222024	1964	-	16
AT2G24040	2	10223944	10224630	686	+	138
AT2G24050	2	10225224	10228638	3414	-	861
AT2G24060	2	10229384	10231563	2179	+	2154
AT2G24070	2	10231681	10235476	3795	-	14
AT2G24080	2	10237603	10238779	1176	-	0
AT2G24090	2	10241963	10243614	1651	+	6854
AT2G24100	2	10244885	10246919	2034	+	329
AT2G24103	2	10247205	10247462	257	+	0
AT2G24110	2	10247816	10248834	1018	-	16
AT2G24120	2	10248910	10254641	5731	-	758
AT2G24130	2	10258147	10261220	3073	+	0
AT2G24140	2	10262553	10264033	1480	-	22
AT2G24150	2	10265483	10267405	1922	-	1310
AT2G24160	2	10268007	10270612	2605	-	476
AT2G24165	2	10272671	10273595	924	-	7
AT2G24170	2	10274143	10277266	3123	-	163
AT2G24180	2	10281846	10283735	1889	+	917
AT2G24190	2	10283620	10285000	1380	-	145
AT2G24200	2	10286805	10289620	2815	-	5496
AT2G24205	2	10291417	10291762	345	+	0
AT2G24210	2	10294329	10297530	3201	+	1
AT2G24220	2	10300114	10301787	1673	+	151
AT2G24230	2	10301816	10304812	2996	-	319
AT2G24240	2	10310647	10312328	1681	+	71
AT2G24250	2	10313285	10314920	1635	-	63
AT2G24255	2	10315514	10317353	1839	-	0
AT2G24260	2	10319333	10322222	2889	-	83
AT2G24270	2	10327034	10329941	2907	-	11964
AT2G24280	2	10333283	10337128	3845	+	3333
AT2G24285	2	10337253	10337707	454	-	0
AT2G24290	2	10338678	10340121	1443	+	295
AT2G24300	2	10340815	10343736	2921	+	90
AT2G24310	2	10344357	10345510	1153	+	9
AT2G24320	2	10345420	10346829	1409	-	1
AT2G24330	2	10347159	10349825	2666	-	345
AT2G24340	2	10355429	10359546	4117	-	0
AT2G24350	2	10361125	10364492	3367	+	107
AT2G24360	2	10364450	10366902	2452	-	1533
AT2G24370	2	10369978	10373063	3085	-	3
AT2G24380	2	10373575	10373648	73	+	0
AT2G24390	2	10373569	10375011	1442	+	414
AT2G24395	2	10375469	10376265	796	+	374
AT2G24400	2	10377790	10378586	796	-	6
AT2G24410	2	10379158	10379407	249	-	0
AT2G24420	2	10380025	10383405	3380	+	3048
AT2G24430	2	10383516	10386625	3109	-	2
AT2G24440	2	10391088	10392828	1740	+	98
AT2G24450	2	10392786	10393976	1190	-	0
AT2G24460	2	10394328	10395390	1062	+	0
AT2G24470	2	10395827	10396622	795	-	0
AT2G24480	2	10397587	10398184	597	+	0
AT2G24490	2	10397376	10400498	3122	-	260
AT2G24500	2	10401034	10402934	1900	-	690
AT2G24510	2	10404372	10405650	1278	+	0
AT2G24513	2	10408886	10409015	129	+	0
AT2G24520	2	10415431	10419783	4352	+	440
AT2G24530	2	10421840	10424113	2273	+	114
AT2G24540	2	10426341	10427594	1253	+	5
AT2G24545	2	10425817	10427513	1696	-	7
AT2G24550	2	10427855	10429222	1367	-	315
AT2G24560	2	10431536	10432933	1397	+	9
AT2G24570	2	10437397	10439298	1901	-	390
AT2G24580	2	10444789	10446242	1453	-	495
AT2G24590	2	10449630	10451184	1554	+	569
AT2G24592	2	10451418	10451511	93	+	54
AT2G24600	2	10452115	10454524	2409	-	125
AT2G24610	2	10457044	10460508	3464	+	9
AT2G24615	2	10461198	10462818	1620	+	0
AT2G24617	2	10462909	10463224	315	+	0
AT2G24620	2	10463075	10463549	474	-	0
AT2G24625	2	10468339	10469286	947	+	0
AT2G24630	2	10471302	10474503	3201	-	314
AT2G24640	2	10475209	10479454	4245	-	321
AT2G24645	2	10480531	10482795	2264	-	119
AT2G24650	2	10483489	10487571	4082	-	468
AT2G24660	2	10488139	10492243	4104	-	10
AT2G24670	2	10492668	10493567	899	+	0
AT2G24680	2	10493262	10496878	3616	-	25
AT2G24681	2	10497146	10498331	1185	-	1
AT2G24683	2	10498726	10498861	135	+	0
AT2G24690	2	10499550	10503140	3590	-	505
AT2G24692	2	10503603	10503974	371	+	9
AT2G24693	2	10506057	10506825	768	+	0
AT2G24696	2	10509067	10510902	1835	-	3
AT2G24700	2	10513015	10515411	2396	-	65
AT2G24710	2	10516879	10520549	3670	-	0
AT2G24720	2	10522782	10525840	3058	-	0
AT2G24730	2	10526348	10527025	677	-	0
AT2G24735	2	10528063	10533887	5824	+	0
AT2G24740	2	10529689	10531957	2268	-	0
AT2G24748	2	10536844	10537829	985	+	0
AT2G24750	2	10539000	10545985	6985	+	54
AT2G24755	2	10541737	10549434	7697	-	0
AT2G24760	2	10547025	10549520	2495	+	12
AT2G24761	2	10549773	10550230	457	+	0
AT2G24762	2	10559383	10560175	792	+	286
AT2G24765	2	10562725	10565198	2473	+	763
AT2G24780	2	10565621	10565946	325	-	0
AT2G24790	2	10566897	10568145	1248	+	3969
AT2G24791	2	10568246	10568579	333	-	0
AT2G24800	2	10571254	10572570	1316	-	0
AT2G24810	2	10573861	10574699	838	+	0
AT2G24820	2	10574978	10576938	1960	+	3609
AT2G24830	2	10576855	10579230	2375	-	231
AT2G24834	2	10580134	10580311	177	+	0
AT2G24840	2	10581081	10582015	934	+	0
AT2G24850	2	10582829	10585216	2387	-	59
AT2G24860	2	10586774	10588329	1555	-	1003
AT2G24870	2	10588659	10589016	357	-	2
AT2G24880	2	10590553	10590862	309	-	0
AT2G24890	2	10593170	10595906	2736	+	0
AT2G24900	2	10596298	10597315	1017	-	0
AT2G24910	2	10598130	10598673	543	+	0
AT2G24915	2	10599226	10599766	540	-	0
AT2G24920	2	10601859	10602450	591	+	0
AT2G24930	2	10603973	10608030	4057	-	0
AT2G24940	2	10609393	10612232	2839	+	1
AT2G24945	2	10609412	10612232	2820	+	0
AT2G24950	2	10613104	10615563	2459	+	0
AT2G24960	2	10617262	10620034	2772	+	157
AT2G24970	2	10620117	10621307	1190	-	53
AT2G24980	2	10622452	10624132	1680	+	0
AT2G24990	2	10625213	10628299	3086	+	200
AT2G25000	2	10629736	10631413	1677	+	57
AT2G25010	2	10631530	10633663	2133	+	481
AT2G25011	2	10634279	10634616	337	-	0
AT2G25015	2	10634414	10636130	1716	+	0
AT2G25020	2	10639088	10642250	3162	+	0
AT2G25025	2	10644560	10644989	429	+	0
AT2G25030	2	10648662	10650450	1788	+	0
AT2G25040	2	10651598	10651901	303	+	0
AT2G25050	2	10653708	10660226	6518	-	418
AT2G25052	2	10660073	10660226	153	-	0
AT2G25060	2	10662240	10663103	863	+	548
AT2G25070	2	10663239	10665964	2725	-	894
AT2G25080	2	10668048	10670019	1971	+	13363
AT2G25090	2	10670466	10672653	2187	-	5
AT2G25095	2	10676471	10676553	82	-	0
AT2G25100	2	10679523	10681998	2475	-	294
AT2G25110	2	10684134	10686085	1951	+	770
AT2G25120	2	10689933	10691569	1636	+	0
AT2G25130	2	10695181	10697000	1819	-	5
AT2G25140	2	10697702	10702152	4450	-	492
AT2G25150	2	10702362	10704294	1932	-	28
AT2G25160	2	10709063	10711240	2177	-	0
AT2G25169	2	10712605	10714014	1409	-	7
AT2G25170	2	10713806	10723986	10180	+	2170
AT2G25171	2	10718095	10718198	103	+	0
AT2G25180	2	10724300	10726961	2661	-	695
AT2G25185	2	10731621	10732024	403	+	0
AT2G25190	2	10733945	10735699	1754	+	288
AT2G25200	2	10736482	10737654	1172	-	101
AT2G25210	2	10739854	10740552	698	+	911
AT2G25220	2	10742712	10745594	2882	-	101
AT2G25230	2	10747210	10748467	1257	-	3
AT2G25240	2	10751767	10753134	1367	-	0
AT2G25250	2	10753834	10754713	879	+	382
AT2G25255	2	10755066	10755327	261	-	0
AT2G25260	2	10755523	10757772	2249	-	14
AT2G25270	2	10759723	10762568	2845	+	199
AT2G25280	2	10762354	10764810	2456	-	570
AT2G25290	2	10765701	10768665	2964	-	258
AT2G25295	2	10769932	10770421	489	+	0
AT2G25300	2	10771693	10774294	2601	-	110
AT2G25305	2	10774620	10774976	356	-	0
AT2G25310	2	10777100	10779226	2126	-	614
AT2G25312	2	10780073	10780409	336	-	1
AT2G25320	2	10781850	10788065	6215	-	847
AT2G25330	2	10788945	10791331	2386	-	0
AT2G25340	2	10792663	10793832	1169	-	0
AT2G25344	2	10795134	10796039	905	+	0
AT2G25350	2	10797598	10800756	3158	+	238
AT2G25355	2	10801277	10803722	2445	+	75
AT2G25360	2	10804248	10805761	1513	+	0
AT2G25370	2	10806679	10809945	3266	+	0
AT2G25380	2	10810361	10812243	1882	+	0
AT2G25390	2	10812614	10813217	603	-	0
AT2G25400	2	10813838	10813911	73	+	0
AT2G25409	2	10815361	10815995	634	-	0
AT2G25410	2	10814469	10815994	1525	+	0
AT2G25420	2	10816748	10821053	4305	+	227
AT2G25430	2	10822369	10824916	2547	+	1739
AT2G25440	2	10826734	10829402	2668	+	0
AT2G25450	2	10829915	10831655	1740	-	6318
AT2G25460	2	10832753	10835483	2730	-	15
AT2G25470	2	10838419	10841881	3462	+	5
AT2G25480	2	10842862	10845698	2836	+	513
AT2G25482	2	10845883	10846348	465	-	0
AT2G25490	2	10847374	10850532	3158	-	2555
AT2G25500	2	10854651	10854948	297	-	0
AT2G25510	2	10856371	10857156	785	+	9408
AT2G25520	2	10860827	10862357	1530	+	1628
AT2G25530	2	10863058	10866757	3699	+	170
AT2G25540	2	10866821	10872077	5256	-	7
AT2G25550	2	10874912	10880212	5300	+	0
AT2G25560	2	10880670	10883868	3198	+	195
AT2G25565	2	10884061	10885295	1234	-	0
AT2G25570	2	10884965	10887921	2956	-	224
AT2G25580	2	10888013	10890367	2354	+	143
AT2G25590	2	10890902	10893772	2870	+	314
AT2G25600	2	10894485	10898642	4157	+	3
AT2G25605	2	10899442	10901041	1599	+	683
AT2G25610	2	10901290	10902531	1241	-	722
AT2G25620	2	10902942	10905245	2303	-	279
AT2G25625	2	10906427	10907288	861	+	370
AT2G25630	2	10908359	10909880	1521	+	0
AT2G25640	2	10910497	10913969	3472	+	263
AT2G25650	2	10914585	10916216	1631	+	269
AT2G25660	2	10916202	10927390	11188	-	1576
AT2G25670	2	10928663	10931062	2399	-	1790
AT2G25680	2	10933060	10934551	1491	-	199
AT2G25685	2	10937677	10938081	404	-	0
AT2G25687	2	10939036	10939418	382	+	0
AT2G25690	2	10940095	10942255	2160	-	168
AT2G25697	2	10947095	10947245	150	+	0
AT2G25700	2	10948746	10949626	880	-	1
AT2G25710	2	10952560	10955377	2817	+	460
AT2G25720	2	10955518	10956052	534	-	154
AT2G25730	2	10956300	10972927	16627	-	619
AT2G25735	2	10975059	10975759	700	-	9
AT2G25737	2	10976935	10979900	2965	+	296
AT2G25740	2	10980121	10983945	3824	+	274
AT2G25760	2	10984807	10988924	4117	-	1002
AT2G25770	2	10992807	10993652	845	+	0
AT2G25780	2	10995140	10996024	884	+	1
AT2G25790	2	11000598	11004235	3637	+	207
AT2G25800	2	11005923	11009739	3816	-	880
AT2G25810	2	11012505	11014170	1665	+	11
AT2G25820	2	11014889	11015800	911	+	14
AT2G25830	2	11018715	11021699	2984	-	1518
AT2G25840	2	11021847	11025370	3523	+	1233
AT2G25850	2	11025419	11030776	5357	-	515
AT2G25870	2	11031114	11034454	3340	+	1581
AT2G25880	2	11034651	11036910	2259	-	152
AT2G25890	2	11037379	11038126	747	+	0
AT2G25900	2	11041330	11043209	1879	+	1936
AT2G25910	2	11049054	11052066	3012	-	845
AT2G25920	2	11054290	11056042	1752	-	315
AT2G25930	2	11059034	11063324	4290	+	194
AT2G25940	2	11063300	11066028	2728	-	20
AT2G25950	2	11068643	11070661	2018	+	343
AT2G25964	2	11070638	11071287	649	-	117
AT2G25970	2	11071650	11075669	4019	-	1813
AT2G25975	2	11076816	11077185	369	+	0
AT2G25980	2	11077487	11079918	2431	-	1
AT2G25990	2	11080585	11080706	121	+	0
AT2G26000	2	11081301	11085350	4049	+	169
AT2G26010	2	11087347	11087944	597	+	5
AT2G26020	2	11089249	11089597	348	+	0
AT2G26030	2	11091333	11093168	1835	-	374
AT2G26040	2	11094831	11095404	573	-	60
AT2G26050	2	11098651	11099380	729	-	0
AT2G26060	2	11102300	11105355	3055	+	553
AT2G26070	2	11105671	11107188	1517	-	179
AT2G26080	2	11109002	11113828	4826	-	28020
AT2G26090	2	11115678	11115759	81	-	0
AT2G26100	2	11115904	11118208	2304	-	352
AT2G26110	2	11120868	11122059	1191	+	576
AT2G26120	2	11123429	11123817	388	+	1
AT2G26130	2	11127133	11128476	1343	+	0
AT2G26135	2	11130118	11131514	1396	+	0
AT2G26140	2	11131577	11135345	3768	-	2646
AT2G26150	2	11135681	11137396	1715	+	27
AT2G26160	2	11137977	11139451	1474	-	1
AT2G26170	2	11140808	11143360	2552	+	597
AT2G26180	2	11143289	11145103	1814	-	190
AT2G26190	2	11147638	11150510	2872	-	619
AT2G26200	2	11152725	11156466	3741	+	293
AT2G26210	2	11157117	11159292	2175	+	694
AT2G26211	2	11159701	11159803	102	+	26
AT2G26215	2	11160062	11161443	1381	-	174
AT2G26220	2	11161665	11162465	800	+	60
AT2G26230	2	11164574	11167195	2621	+	633
AT2G26240	2	11167256	11168473	1217	-	344
AT2G26250	2	11170417	11173142	2725	-	4746
AT2G26260	2	11178099	11182976	4877	+	478
AT2G26267	2	11184212	11184419	207	+	5
AT2G26270	2	11184738	11187775	3037	+	94
AT2G26280	2	11187732	11191337	3605	-	2078
AT2G26290	2	11192136	11194259	2123	-	7
AT2G26300	2	11196995	11201102	4107	+	659
AT2G26310	2	11201302	11204153	2851	+	38
AT2G26320	2	11205388	11206287	899	-	0
AT2G26330	2	11208182	11213971	5789	-	3020
AT2G26340	2	11215251	11217033	1782	+	1980
AT2G26350	2	11217438	11220507	3069	-	263
AT2G26355	2	11220707	11221535	828	+	149
AT2G26360	2	11221515	11223213	1698	-	63
AT2G26370	2	11224564	11226214	1650	+	0
AT2G26380	2	11226614	11228057	1443	-	0
AT2G26390	2	11229086	11230491	1405	-	2
AT2G26400	2	11231799	11233295	1496	-	35
AT2G26410	2	11234650	11236936	2286	-	1
AT2G26420	2	11239433	11242239	2806	-	0
AT2G26430	2	11243218	11246035	2817	-	574
AT2G26440	2	11247382	11249493	2111	+	130
AT2G26450	2	11251119	11253612	2493	+	0
AT2G26455	2	11253699	11254930	1231	-	0
AT2G26460	2	11254931	11258973	4042	-	422
AT2G26470	2	11259152	11262494	3342	-	204
AT2G26480	2	11263962	11265684	1722	+	2
AT2G26490	2	11267941	11269623	1682	+	0
AT2G26500	2	11270088	11270953	865	+	20961
AT2G26510	2	11273910	11277630	3720	+	462
AT2G26511	2	11277788	11277890	102	+	0
AT2G26520	2	11280024	11280940	916	+	16
AT2G26530	2	11282774	11284229	1455	-	77
AT2G26540	2	11287364	11290360	2996	-	1093
AT2G26550	2	11291217	11293445	2228	-	724
AT2G26560	2	11293768	11295806	2038	-	42
AT2G26570	2	11299143	11302191	3048	+	1457
AT2G26580	2	11303589	11306953	3364	-	327
AT2G26590	2	11311003	11315096	4093	-	619
AT2G26600	2	11316411	11318483	2072	+	482
AT2G26610	2	11318770	11324174	5404	+	1
AT2G26620	2	11325162	11326835	1673	-	0
AT2G26630	2	11327492	11328727	1235	+	1
AT2G26640	2	11329869	11331858	1989	+	499
AT2G26650	2	11331849	11336607	4758	-	119
AT2G26660	2	11338931	11340950	2019	+	359
AT2G26670	2	11341683	11343572	1889	+	2975
AT2G26680	2	11343800	11345402	1602	-	483
AT2G26690	2	11347146	11350993	3847	-	2941
AT2G26692	2	11350718	11351293	575	+	3
AT2G26695	2	11365097	11365965	868	+	1061
AT2G26700	2	11368595	11371099	2504	+	22
AT2G26710	2	11380491	11383612	3121	+	195
AT2G26720	2	11384781	11385402	621	+	0
AT2G26730	2	11388406	11391641	3235	+	1370
AT2G26740	2	11392964	11394279	1315	-	607
AT2G26750	2	11395895	11397092	1197	-	5
AT2G26760	2	11401328	11403427	2099	+	185
AT2G26770	2	11404065	11408326	4261	-	1101
AT2G26780	2	11410075	11423776	13701	+	1310
AT2G26790	2	11425269	11427669	2400	-	31
AT2G26800	2	11429021	11432732	3711	-	1354
AT2G26810	2	11433732	11436277	2545	-	140
AT2G26820	2	11437807	11442199	4392	+	0
AT2G26830	2	11443560	11447171	3611	+	370
AT2G26840	2	11447196	11448949	1753	-	295
AT2G26850	2	11449268	11451239	1971	-	1
AT2G26860	2	11451972	11453843	1871	-	222
AT2G26865	2	11455612	11455849	237	-	0
AT2G26870	2	11457007	11459365	2358	-	103
AT2G26880	2	11459905	11461099	1194	-	0
AT2G26882	2	11460218	11461021	803	+	0
AT2G26890	2	11462066	11474325	12259	-	2297
AT2G26900	2	11474951	11477944	2993	-	4996
AT2G26910	2	11481622	11488186	6564	+	3109
AT2G26920	2	11489003	11491751	2748	+	419
AT2G26930	2	11491706	11494266	2560	-	1292
AT2G26940	2	11496517	11497378	861	-	0
AT2G26950	2	11500720	11502136	1416	-	0
AT2G26960	2	11506064	11507426	1362	-	1
AT2G26970	2	11509720	11511914	2194	-	226
AT2G26975	2	11512860	11513553	693	+	571
AT2G26980	2	11514702	11518734	4032	-	625
AT2G26990	2	11519506	11522587	3081	-	852
AT2G27000	2	11523303	11525095	1792	-	1
AT2G27010	2	11526167	11527854	1687	-	0
AT2G27020	2	11528347	11530976	2629	-	1763
AT2G27030	2	11532003	11534333	2330	+	2187
AT2G27035	2	11535649	11536485	836	+	26
AT2G27040	2	11536533	11542357	5824	-	1237
AT2G27050	2	11545752	11548293	2541	+	1145
AT2G27060	2	11551040	11554775	3735	+	498
AT2G27070	2	11555780	11560215	4435	-	0
AT2G27080	2	11563932	11567504	3572	+	34
AT2G27090	2	11567435	11571856	4421	-	556
AT2G27100	2	11572549	11576658	4109	+	974
AT2G27110	2	11576668	11580794	4126	-	576
AT2G27120	2	11581222	11594346	13124	+	3
AT2G27130	2	11595291	11596542	1251	+	191
AT2G27140	2	11598378	11599322	944	-	150
AT2G27145	2	11600192	11600700	508	-	0
AT2G27150	2	11601753	11608450	6697	+	692
AT2G27160	2	11607431	11608416	985	-	0
AT2G27170	2	11609121	11617434	8313	-	1054
AT2G27180	2	11620232	11621174	942	+	16
AT2G27190	2	11621221	11623618	2397	-	528
AT2G27200	2	11625416	11628189	2773	+	72
AT2G27210	2	11629776	11636795	7019	+	683
AT2G27220	2	11637163	11639537	2374	-	3
AT2G27228	2	11650357	11654143	3786	+	0
AT2G27229	2	11649153	11649998	845	+	0
AT2G27230	2	11650357	11654143	3786	+	0
AT2G27240	2	11659578	11662408	2830	+	0
AT2G27250	2	11664985	11665769	784	-	0
AT2G27260	2	11669654	11670644	990	+	242
AT2G27270	2	11672270	11673208	938	+	0
AT2G27280	2	11673825	11675613	1788	-	5
AT2G27285	2	11675959	11678118	2159	-	517
AT2G27290	2	11678399	11679797	1398	-	2933
AT2G27300	2	11680416	11681955	1539	-	14
AT2G27310	2	11683861	11684967	1106	-	74
AT2G27315	2	11689590	11689953	363	-	2
AT2G27320	2	11692883	11694916	2033	+	0
AT2G27330	2	11695031	11696630	1599	-	152
AT2G27340	2	11696736	11699224	2488	+	191
AT2G27350	2	11699548	11704272	4724	-	1120
AT2G27360	2	11706197	11708065	1868	+	302
AT2G27370	2	11708449	11710004	1555	-	1
AT2G27375	2	11710673	11711324	651	+	0
AT2G27380	2	11713410	11715696	2286	+	1
AT2G27385	2	11716000	11717432	1432	-	2900
AT2G27389	2	11720293	11721081	788	+	0
AT2G27390	2	11720483	11720888	405	-	0
AT2G27395	2	11721050	11721324	274	-	0
AT2G27400	2	11721538	11722468	930	-	159
AT2G27402	2	11723524	11724362	838	+	688
AT2G27410	2	11724426	11725419	993	-	0
AT2G27420	2	11726143	11727614	1471	-	1183
AT2G27430	2	11729825	11733210	3385	-	5
AT2G27440	2	11734802	11737335	2533	+	5
AT2G27450	2	11737431	11739690	2259	-	1328
AT2G27460	2	11740633	11745011	4378	+	501
AT2G27470	2	11744980	11746411	1431	-	222
AT2G27480	2	11746719	11748051	1332	+	76
AT2G27490	2	11748014	11750182	2168	-	198
AT2G27500	2	11752169	11754028	1859	-	295
AT2G27505	2	11756565	11757829	1264	+	2
AT2G27510	2	11758078	11759476	1398	-	364
AT2G27520	2	11762060	11763104	1044	+	0
AT2G27530	2	11763216	11764845	1629	-	4563
AT2G27535	2	11765322	11766144	822	-	0
AT2G27540	2	11768950	11769100	150	+	0
AT2G27550	2	11773250	11774681	1431	+	2
AT2G27560	2	11774851	11774923	72	-	0
AT2G27570	2	11775328	11776305	977	+	0
AT2G27580	2	11776410	11777529	1119	-	484
AT2G27590	2	11777553	11779851	2298	-	164
AT2G27600	2	11781037	11783992	2955	+	2192
AT2G27610	2	11783926	11786533	2607	-	18
AT2G27630	2	11787397	11792604	5207	-	4
AT2G27650	2	11792824	11797712	4888	-	0
AT2G27660	2	11798536	11800850	2314	-	14
AT2G27670	2	11801567	11802891	1324	-	0
AT2G27680	2	11803810	11806013	2203	-	5098
AT2G27690	2	11809305	11811215	1910	+	14
AT2G27700	2	11813948	11816002	2054	-	0
AT2G27710	2	11816633	11817867	1234	+	3245
AT2G27720	2	11818490	11819578	1088	+	3430
AT2G27730	2	11819828	11821878	2050	-	1954
AT2G27740	2	11822731	11823732	1001	+	64
AT2G27750	2	11823915	11824461	546	-	0
AT2G27760	2	11824797	11827591	2794	+	165
AT2G27770	2	11832808	11834369	1561	-	243
AT2G27775	2	11842266	11843293	1027	-	111
AT2G27780	2	11845471	11846578	1107	-	0
AT2G27790	2	11847108	11849559	2451	-	61
AT2G27800	2	11849788	11851363	1575	-	116
AT2G27810	2	11852079	11856291	4212	+	986
AT2G27820	2	11856767	11858288	1521	+	994
AT2G27830	2	11860217	11861475	1258	+	121
AT2G27840	2	11861993	11863886	1893	+	330
AT2G27850	2	11864153	11864225	72	-	0
AT2G27860	2	11864392	11866907	2515	-	3197
AT2G27870	2	11867250	11868195	945	-	0
AT2G27880	2	11871487	11876894	5407	+	3
AT2G27900	2	11877429	11886013	8584	+	1256
AT2G27920	2	11885570	11889176	3606	-	347
AT2G27930	2	11892368	11893488	1120	+	13
AT2G27935	2	11894591	11895549	958	+	0
AT2G27936	2	11896127	11896590	463	+	0
AT2G27940	2	11897941	11898867	926	+	0
AT2G27950	2	11899204	11904007	4803	-	1203
AT2G27960	2	11910722	11911685	963	-	512
AT2G27970	2	11912211	11913297	1086	-	268
AT2G27980	2	11913628	11919741	6113	-	931
AT2G27990	2	11921432	11924698	3266	-	76
AT2G28000	2	11926448	11929389	2941	+	15129
AT2G28010	2	11930578	11931769	1191	-	0
AT2G28020	2	11933701	11934060	359	+	0
AT2G28030	2	11934207	11935386	1179	-	0
AT2G28040	2	11936053	11937401	1348	-	10
AT2G28050	2	11938264	11939653	1389	-	46
AT2G28053	2	11939852	11940239	387	-	0
AT2G28056	2	11941660	11943604	1944	-	2
AT2G28060	2	11949985	11952204	2219	-	226
AT2G28070	2	11956431	11959782	3351	+	546
AT2G28080	2	11960570	11963293	2723	-	291
AT2G28085	2	11968119	11968620	501	-	0
AT2G28090	2	11972139	11974007	1868	-	0
AT2G28100	2	11974662	11976600	1938	+	466
AT2G28105	2	11976302	11977913	1611	+	40
AT2G28110	2	11977943	11979837	1894	-	30
AT2G28120	2	11985686	11987738	2052	+	31
AT2G28130	2	11988675	11991617	2942	+	176
AT2G28140	2	11994965	11996002	1037	+	43
AT2G28150	2	11999835	12002499	2664	+	831
AT2G28160	2	12004707	12006122	1415	+	68
AT2G28170	2	12006370	12009956	3586	-	0
AT2G28180	2	12010993	12013890	2897	-	0
AT2G28190	2	12014497	12016569	2072	+	1127
AT2G28200	2	12024148	12025306	1158	+	146
AT2G28210	2	12029996	12032420	2424	+	93
AT2G28220	2	12033952	12037527	3575	+	0
AT2G28230	2	12037676	12039046	1370	-	216
AT2G28240	2	12039211	12042143	2932	+	152
AT2G28250	2	12043481	12046537	3056	+	179
AT2G28260	2	12049988	12052453	2465	+	110
AT2G28270	2	12053541	12054398	857	+	0
AT2G28280	2	12054735	12056452	1717	-	0
AT2G28290	2	12056212	12073083	16871	+	3319
AT2G28305	2	12081112	12084664	3552	+	576
AT2G28310	2	12085376	12088060	2684	+	734
AT2G28315	2	12088876	12090701	1825	+	66
AT2G28320	2	12094745	12099644	4899	+	762
AT2G28330	2	12099889	12100757	868	-	50
AT2G28340	2	12103671	12106172	2501	+	5
AT2G28350	2	12114330	12116848	2518	+	640
AT2G28355	2	12119319	12120279	960	+	0
AT2G28360	2	12124414	12130069	5655	-	346
AT2G28370	2	12131553	12133704	2151	+	569
AT2G28380	2	12133810	12136180	2370	-	646
AT2G28390	2	12139579	12143465	3886	-	764
AT2G28400	2	12148303	12149052	749	-	30
AT2G28401	2	12150379	12150502	123	+	0
AT2G28405	2	12153293	12154092	799	-	0
AT2G28410	2	12156129	12156934	805	+	322
AT2G28420	2	12157922	12158791	869	+	10
AT2G28426	2	12159275	12159407	132	-	3
AT2G28430	2	12159561	12160451	890	-	461
AT2G28440	2	12161225	12162032	807	+	23
AT2G28450	2	12162050	12166039	3989	-	339
AT2G28460	2	12166572	12168874	2302	+	25
AT2G28470	2	12168839	12173679	4840	-	4129
AT2G28480	2	12176483	12178422	1939	-	176
AT2G28490	2	12178596	12181012	2416	-	0
AT2G28500	2	12186568	12188142	1574	-	19
AT2G28507	2	12196405	12196552	147	+	0
AT2G28510	2	12199097	12200765	1668	-	211
AT2G28520	2	12209895	12215895	6000	+	773
AT2G28540	2	12218044	12223828	5784	+	860
AT2G28550	2	12225841	12228543	2702	-	2716
AT2G28560	2	12236614	12239124	2510	-	39
AT2G28570	2	12241769	12242729	960	+	70
AT2G28580	2	12244858	12248450	3592	+	49
AT2G28590	2	12249678	12251668	1990	+	47
AT2G28600	2	12251783	12254823	3040	+	319
AT2G28605	2	12254887	12255837	950	+	1082
AT2G28610	2	12262012	12263415	1403	+	2
AT2G28620	2	12265166	12270020	4854	-	414
AT2G28625	2	12272280	12273027	747	+	0
AT2G28630	2	12275318	12277245	1927	-	189
AT2G28640	2	12284624	12286645	2021	-	0
AT2G28650	2	12289151	12291045	1894	-	40
AT2G28660	2	12295326	12297117	1791	+	91
AT2G28670	2	12300258	12302358	2100	-	5
AT2G28671	2	12300202	12302036	1834	+	2
AT2G28680	2	12302962	12304799	1837	-	0
AT2G28690	2	12306889	12308628	1739	-	7
AT2G28700	2	12317165	12318746	1581	-	0
AT2G28710	2	12322385	12323584	1199	+	11
AT2G28720	2	12326977	12327678	701	+	1333
AT2G28725	2	12328604	12328943	339	+	1
AT2G28730	2	12329002	12329074	72	+	0
AT2G28740	2	12329487	12329995	508	-	1046
AT2G28750	2	12331626	12332774	1148	+	0
AT2G28755	2	12334171	12334459	288	-	0
AT2G28760	2	12336187	12339027	2840	-	237
AT2G28770	2	12339750	12339822	72	+	0
AT2G28780	2	12340033	12343421	3388	-	55
AT2G28790	2	12354429	12355431	1002	-	476
AT2G28800	2	12356363	12359252	2889	-	13224
AT2G28810	2	12363425	12365377	1952	+	692
AT2G28830	2	12366747	12370684	3937	-	141
AT2G28840	2	12378336	12380742	2406	+	1389
AT2G28850	2	12383479	12384961	1482	-	0
AT2G28860	2	12388200	12389872	1672	-	0
AT2G28870	2	12394255	12394915	660	-	65
AT2G28880	2	12398744	12403528	4784	-	396
AT2G28890	2	12405595	12408235	2640	-	410
AT2G28900	2	12414113	12415578	1465	-	607
AT2G28910	2	12415779	12417385	1606	-	3175
AT2G28920	2	12418016	12418454	438	+	0
AT2G28930	2	12424302	12426674	2372	+	279
AT2G28940	2	12426709	12428730	2021	-	249
AT2G28950	2	12431340	12433595	2255	-	3654
AT2G28960	2	12437913	12442347	4434	-	0
AT2G28970	2	12443918	12448163	4245	+	2
AT2G28980	2	12449335	12454356	5021	-	0
AT2G28990	2	12455054	12459541	4487	+	0
AT2G29000	2	12460780	12465037	4257	+	0
AT2G29010	2	12465763	12469464	3701	+	0
AT2G29020	2	12469723	12471700	1977	+	431
AT2G29030	2	12471772	12471844	72	-	0
AT2G29040	2	12472424	12474962	2538	-	0
AT2G29045	2	12476371	12477107	736	+	0
AT2G29050	2	12478145	12480372	2227	+	262
AT2G29060	2	12481743	12484087	2344	+	2
AT2G29065	2	12484842	12486983	2141	+	65
AT2G29070	2	12487273	12489518	2245	+	108
AT2G29080	2	12489626	12493285	3659	-	1944
AT2G29090	2	12494850	12499723	4873	-	185
AT2G29100	2	12501091	12504912	3821	-	0
AT2G29110	2	12506879	12510552	3673	-	0
AT2G29120	2	12511291	12515895	4604	-	386
AT2G29125	2	12523341	12524109	768	+	51
AT2G29130	2	12524888	12527747	2859	-	18
AT2G29140	2	12530837	12535399	4562	+	612
AT2G29150	2	12535714	12536964	1250	-	0
AT2G29160	2	12537250	12539334	2084	-	14
AT2G29165	2	12539811	12541464	1653	-	12
AT2G29170	2	12541863	12542282	419	-	152
AT2G29180	2	12543022	12543835	813	+	1153
AT2G29190	2	12543811	12548563	4752	-	1023
AT2G29200	2	12548930	12553433	4503	-	292
AT2G29210	2	12558050	12562348	4298	+	1141
AT2G29220	2	12562780	12564664	1884	-	0
AT2G29230	2	12568017	12571481	3464	+	0
AT2G29240	2	12573370	12577812	4442	-	0
AT2G29250	2	12578908	12580780	1872	-	0
AT2G29260	2	12582518	12584101	1583	+	12
AT2G29263	2	12584242	12584428	186	-	0
AT2G29270	2	12584501	12585096	595	+	2
AT2G29280	2	12585888	12586330	442	+	1
AT2G29290	2	12585855	12587742	1887	+	2174
AT2G29300	2	12588190	12589759	1569	+	271
AT2G29310	2	12590057	12591363	1306	+	946
AT2G29320	2	12592147	12593686	1539	+	1016
AT2G29330	2	12594589	12596330	1741	+	1
AT2G29340	2	12597114	12599203	2089	+	1174
AT2G29350	2	12600913	12602556	1643	+	41
AT2G29360	2	12603802	12605271	1469	+	2363
AT2G29370	2	12606058	12607618	1560	+	15
AT2G29380	2	12608701	12610167	1466	+	1
AT2G29390	2	12610542	12612894	2352	-	599
AT2G29400	2	12613080	12615399	2319	-	1021
AT2G29410	2	12616563	12617987	1424	+	40
AT2G29420	2	12617935	12618899	964	-	221
AT2G29430	2	12619553	12620027	474	+	0
AT2G29440	2	12620059	12621148	1089	-	31
AT2G29450	2	12624585	12625637	1052	-	2815
AT2G29452	2	12625853	12625985	132	-	1
AT2G29460	2	12626535	12627678	1143	-	8
AT2G29470	2	12628540	12629543	1003	-	0
AT2G29480	2	12630197	12631321	1124	-	3
AT2G29490	2	12631377	12632473	1096	-	24
AT2G29500	2	12633090	12633805	715	-	29
AT2G29510	2	12634513	12638018	3505	+	1083
AT2G29520	2	12638155	12638228	73	-	0
AT2G29525	2	12638333	12640820	2487	+	251
AT2G29530	2	12640799	12642387	1588	-	465
AT2G29540	2	12642520	12643944	1424	+	76
AT2G29550	2	12644046	12646037	1991	-	2175
AT2G29560	2	12646559	12649906	3347	+	567
AT2G29570	2	12649905	12651703	1798	-	549
AT2G29580	2	12651922	12654336	2414	+	222
AT2G29590	2	12654455	12655457	1002	-	138
AT2G29600	2	12655150	12657296	2146	+	0
AT2G29605	2	12657908	12660087	2179	-	0
AT2G29610	2	12661311	12662417	1106	+	0
AT2G29620	2	12662740	12665803	3063	-	5
AT2G29628	2	12666831	12666957	126	-	0
AT2G29630	2	12666934	12670311	3377	+	7438
AT2G29640	2	12671205	12673300	2095	+	99
AT2G29650	2	12673382	12676049	2667	-	7092
AT2G29654	2	12677278	12677461	183	-	0
AT2G29660	2	12678889	12680667	1778	+	166
AT2G29670	2	12681957	12685087	3130	-	2358
AT2G29679	2	12689275	12689398	123	-	0
AT2G29680	2	12689548	12693024	3476	+	82
AT2G29690	2	12693870	12696975	3105	+	589
AT2G29700	2	12697419	12698167	748	+	632
AT2G29710	2	12698672	12700343	1671	+	19
AT2G29720	2	12700400	12702341	1941	-	54
AT2G29730	2	12703536	12705181	1645	+	159
AT2G29740	2	12706709	12708367	1658	+	4
AT2G29750	2	12709726	12711696	1970	+	13
AT2G29760	2	12712883	12715852	2969	+	69
AT2G29770	2	12715410	12716875	1465	-	0
AT2G29780	2	12717785	12719328	1543	-	0
AT2G29790	2	12720883	12722455	1572	-	0
AT2G29800	2	12722938	12724602	1664	-	0
AT2G29810	2	12726101	12727253	1152	-	0
AT2G29820	2	12728361	12729528	1167	-	0
AT2G29830	2	12730410	12731599	1189	-	0
AT2G29840	2	12732386	12733983	1597	-	0
AT2G29850	2	12734724	12736394	1670	+	0
AT2G29860	2	12737665	12738388	723	-	0
AT2G29870	2	12741191	12741791	600	+	0
AT2G29880	2	12742535	12743749	1214	+	0
AT2G29890	2	12744149	12749596	5447	+	481
AT2G29900	2	12749745	12751125	1380	+	274
AT2G29910	2	12751146	12753117	1971	-	453
AT2G29920	2	12754493	12755384	891	+	2
AT2G29930	2	12756355	12758558	2203	-	0
AT2G29940	2	12760138	12766623	6485	+	134
AT2G29950	2	12767584	12768435	851	+	31
AT2G29960	2	12769032	12770579	1547	-	903
AT2G29970	2	12776385	12779938	3553	+	2344
AT2G29980	2	12781590	12785053	3463	-	2035
AT2G29990	2	12793339	12795913	2574	-	207
AT2G29995	2	12796906	12799419	2513	-	81
AT2G30000	2	12803852	12804977	1125	-	82
AT2G30010	2	12805723	12809386	3663	+	720
AT2G30020	2	12814409	12816088	1679	+	149
AT2G30032	2	12819528	12819654	126	-	0
AT2G30040	2	12821709	12823169	1460	+	163
AT2G30050	2	12824450	12826684	2234	+	580
AT2G30060	2	12826914	12828919	2005	+	1009
AT2G30070	2	12834992	12838626	3634	+	472
AT2G30080	2	12838729	12840112	1383	-	79
AT2G30090	2	12843582	12845597	2015	-	0
AT2G30100	2	12847827	12849669	1842	+	704
AT2G30105	2	12849765	12852092	2327	+	532
AT2G30110	2	12852371	12857617	5246	-	3743
AT2G30115	2	12858461	12860142	1681	+	0
AT2G30120	2	12860540	12861910	1370	-	168
AT2G30130	2	12868629	12869724	1095	+	0
AT2G30140	2	12872133	12873820	1687	+	482
AT2G30150	2	12874705	12876122	1417	+	618
AT2G30160	2	12877837	12879649	1812	+	204
AT2G30170	2	12879674	12881503	1829	-	1468
AT2G30180	2	12881590	12881661	71	+	0
AT2G30190	2	12882733	12882804	71	+	0
AT2G30200	2	12882954	12885768	2814	-	1578
AT2G30210	2	12887445	12889874	2429	-	42
AT2G30220	2	12891265	12892537	1272	-	0
AT2G30230	2	12897070	12897885	815	+	47
AT2G30240	2	12899906	12902779	2873	-	0
AT2G30250	2	12903235	12905198	1963	-	141
AT2G30260	2	12905401	12907509	2108	-	574
AT2G30270	2	12907840	12909261	1421	-	343
AT2G30280	2	12909592	12912340	2748	-	232
AT2G30290	2	12912518	12915912	3394	-	0
AT2G30300	2	12919400	12921222	1822	+	23
AT2G30310	2	12923054	12924380	1326	+	2
AT2G30320	2	12925727	12927896	2169	-	381
AT2G30330	2	12928766	12929737	971	-	165
AT2G30340	2	12931218	12932582	1364	-	0
AT2G30350	2	12934149	12935773	1624	-	202
AT2G30360	2	12936978	12938834	1856	-	7
AT2G30362	2	12937350	12939638	2288	+	0
AT2G30370	2	12940454	12942409	1955	-	22
AT2G30380	2	12948283	12950573	2290	+	5
AT2G30390	2	12951026	12954114	3088	-	4036
AT2G30395	2	12954173	12955089	916	-	14
AT2G30400	2	12956560	12957554	994	+	7
AT2G30410	2	12959198	12960810	1612	+	712
AT2G30420	2	12960826	12962162	1336	-	137
AT2G30424	2	12964505	12965468	963	-	145
AT2G30430	2	12968175	12968412	237	+	0
AT2G30432	2	12968614	12970209	1595	-	81
AT2G30440	2	12972876	12975497	2621	+	1754
AT2G30450	2	12975947	12976018	71	-	0
AT2G30460	2	12976145	12978868	2723	-	514
AT2G30470	2	12980506	12985043	4537	-	637
AT2G30480	2	12987095	12993403	6308	-	136
AT2G30490	2	12993662	12995770	2108	-	3067
AT2G30500	2	12998158	13000464	2306	-	661
AT2G30505	2	13000972	13002563	1591	-	42
AT2G30520	2	13002741	13005600	2859	-	8914
AT2G30530	2	13008915	13011063	2148	+	437
AT2G30540	2	13011104	13011784	680	-	19
AT2G30550	2	13014847	13017153	2306	+	434
AT2G30560	2	13017346	13018857	1511	+	0
AT2G30570	2	13019027	13020194	1167	-	65827
AT2G30575	2	13020396	13024208	3812	-	275
AT2G30580	2	13025999	13030661	4662	+	197
AT2G30590	2	13033475	13035593	2118	+	437
AT2G30600	2	13036875	13041684	4809	+	868
AT2G30615	2	13041084	13042586	1502	-	1
AT2G30620	2	13044930	13046663	1733	+	3449
AT2G30630	2	13046671	13049219	2548	-	5
AT2G30640	2	13049508	13051773	2265	-	37
AT2G30650	2	13053776	13056380	2604	-	0
AT2G30660	2	13058249	13061673	3424	-	10
AT2G30670	2	13069312	13070904	1592	-	2
AT2G30680	2	13073647	13075396	1749	+	0
AT2G30690	2	13076228	13078595	2367	+	8
AT2G30695	2	13079089	13081399	2310	-	872
AT2G30700	2	13081846	13085281	3435	-	868
AT2G30710	2	13085885	13089261	3376	-	469
AT2G30720	2	13089368	13091687	2319	-	357
AT2G30730	2	13093144	13094677	1533	+	1
AT2G30740	2	13095975	13098594	2619	+	575
AT2G30750	2	13099335	13101413	2078	-	7
AT2G30760	2	13105769	13108221	2452	-	1
AT2G30766	2	13107908	13108863	955	+	59
AT2G30770	2	13109793	13112011	2218	-	61
AT2G30780	2	13116473	13118808	2335	+	219
AT2G30790	2	13118936	13120090	1154	-	315
AT2G30800	2	13120352	13126770	6418	-	550
AT2G30810	2	13127825	13128666	841	-	0
AT2G30820	2	13129576	13132945	3369	+	106
AT2G30830	2	13132706	13134284	1578	-	10
AT2G30840	2	13135429	13136849	1420	-	2
AT2G30850	2	13137235	13137308	73	-	0
AT2G30860	2	13138996	13140245	1249	+	14639
AT2G30870	2	13141356	13142613	1257	+	2658
AT2G30880	2	13142664	13145916	3252	-	539
AT2G30890	2	13147620	13149819	2199	+	93
AT2G30900	2	13149413	13152542	3129	+	10
AT2G30910	2	13152788	13157107	4319	+	224
AT2G30920	2	13157132	13159932	2800	-	276
AT2G30925	2	13161814	13161943	129	+	0
AT2G30930	2	13162368	13163398	1030	+	236
AT2G30933	2	13164058	13166726	2668	-	20
AT2G30940	2	13168532	13170285	1753	+	0
AT2G30942	2	13170870	13172021	1151	+	15
AT2G30945	2	13172360	13173966	1606	+	7
AT2G30950	2	13174320	13177223	2903	+	30317
AT2G30960	2	13177178	13178328	1150	-	159
AT2G30970	2	13178839	13181931	3092	+	1844
AT2G30980	2	13182068	13185949	3881	-	1611
AT2G30984	2	13186543	13187253	710	-	1
AT2G30985	2	13186715	13187200	485	+	0
AT2G30990	2	13187582	13190419	2837	-	528
AT2G31005	2	13193503	13193797	294	+	0
AT2G31010	2	13194184	13200128	5944	+	254
AT2G31018	2	13201431	13201551	120	-	0
AT2G31020	2	13201667	13204821	3154	+	5
AT2G31030	2	13206003	13207815	1812	+	0
AT2G31035	2	13208666	13208918	252	+	0
AT2G31040	2	13208905	13211085	2180	-	4184
AT2G31050	2	13212149	13212752	603	+	0
AT2G31060	2	13213099	13218724	5625	-	400
AT2G31070	2	13220477	13222609	2132	-	1286
AT2G31080	2	13223058	13227048	3990	-	0
AT2G31081	2	13238046	13238600	554	+	0
AT2G31082	2	13241439	13241700	261	+	0
AT2G31083	2	13252218	13252765	547	+	0
AT2G31085	2	13254177	13254706	529	+	1
AT2G31090	2	13256137	13256711	574	+	243
AT2G31100	2	13256737	13258176	1439	-	1
AT2G31110	2	13258328	13262099	3771	-	197
AT2G31130	2	13263578	13266560	2982	-	195
AT2G31140	2	13269925	13271811	1886	+	369
AT2G31141	2	13271725	13272534	809	-	71
AT2G31150	2	13272374	13274578	2204	+	604
AT2G31160	2	13277810	13278745	935	+	78
AT2G31170	2	13282354	13285666	3312	-	693
AT2G31180	2	13286720	13288176	1456	-	0
AT2G31190	2	13291196	13293794	2598	-	428
AT2G31200	2	13293985	13295410	1425	+	997
AT2G31210	2	13296142	13298277	2135	+	4
AT2G31215	2	13299806	13300302	496	+	0
AT2G31218	2	13302038	13302170	132	-	0
AT2G31220	2	13302680	13304869	2189	+	26
AT2G31230	2	13306592	13307475	883	-	333
AT2G31240	2	13317414	13319560	2146	-	196
AT2G31250	2	13319620	13321526	1906	-	17
AT2G31260	2	13322020	13327400	5380	-	560
AT2G31270	2	13329008	13331830	2822	+	291
AT2G31271	2	13332223	13332391	168	-	0
AT2G31280	2	13339086	13343666	4580	+	760
AT2G31290	2	13343813	13346070	2257	+	149
AT2G31300	2	13346121	13349980	3859	-	144
AT2G31305	2	13350421	13351464	1043	+	168
AT2G31310	2	13352916	13353672	756	+	0
AT2G31320	2	13353820	13359728	5908	-	318
AT2G31335	2	13360882	13361167	285	+	0
AT2G31340	2	13361505	13365200	3695	+	141
AT2G31345	2	13365231	13365800	569	-	0
AT2G31350	2	13368291	13371057	2766	+	557
AT2G31360	2	13371657	13373606	1949	-	1208
AT2G31370	2	13378943	13381544	2601	+	1014
AT2G31380	2	13381909	13383470	1561	+	1764
AT2G31390	2	13383422	13386209	2787	-	710
AT2G31400	2	13387003	13390706	3703	-	8393
AT2G31410	2	13392021	13392851	830	-	862
AT2G31420	2	13393363	13394001	638	-	0
AT2G31425	2	13394720	13395720	1000	+	0
AT2G31430	2	13396191	13397162	971	+	0
AT2G31432	2	13397596	13398839	1243	+	0
AT2G31440	2	13399127	13401206	2079	-	528
AT2G31450	2	13401131	13404222	3091	-	423
AT2G31460	2	13404775	13405510	735	+	0
AT2G31470	2	13407491	13408655	1164	-	0
AT2G31480	2	13408977	13410999	2022	-	0
AT2G31490	2	13411982	13413246	1264	+	1363
AT2G31500	2	13413763	13416536	2773	+	0
AT2G31510	2	13416645	13421170	4525	-	1073
AT2G31520	2	13421939	13427089	5150	-	0
AT2G31530	2	13427010	13430465	3455	+	493
AT2G31540	2	13430636	13432065	1429	-	1
AT2G31550	2	13433805	13435207	1402	-	0
AT2G31560	2	13436556	13438011	1455	+	1029
AT2G31570	2	13437973	13439881	1908	-	2684
AT2G31580	2	13440908	13445851	4943	-	296
AT2G31585	2	13446001	13446729	728	+	71
AT2G31590	2	13446828	13448133	1305	-	1
AT2G31600	2	13448189	13450095	1906	-	76
AT2G31610	2	13450301	13451923	1622	+	3284
AT2G31620	2	13451990	13452908	918	-	0
AT2G31625	2	13453330	13455235	1905	-	0
AT2G31650	2	13455271	13462181	6910	-	238
AT2G31660	2	13464297	13471821	7524	+	1284
AT2G31670	2	13472536	13473504	968	-	1563
AT2G31680	2	13473593	13475052	1459	-	246
AT2G31690	2	13476092	13477547	1455	-	0
AT2G31700	2	13480509	13481568	1059	+	0
AT2G31710	2	13481792	13483124	1332	-	172
AT2G31720	2	13485033	13485975	942	-	0
AT2G31725	2	13486316	13487445	1129	-	79
AT2G31730	2	13487567	13489679	2112	-	132
AT2G31740	2	13490907	13495110	4203	-	427
AT2G31750	2	13497232	13500023	2791	+	928
AT2G31751	2	13499340	13502114	2774	-	45
AT2G31760	2	13508492	13510390	1898	+	0
AT2G31770	2	13511578	13513550	1972	+	0
AT2G31780	2	13515198	13517413	2215	+	0
AT2G31790	2	13518210	13520364	2154	+	3623
AT2G31800	2	13520324	13523708	3384	-	886
AT2G31810	2	13524220	13528557	4337	+	1065
AT2G31820	2	13530349	13532562	2213	+	856
AT2G31830	2	13532679	13537741	5062	-	57
AT2G31840	2	13537911	13539758	1847	-	701
AT2G31850	2	13540198	13540540	342	+	0
AT2G31860	2	13542482	13545266	2784	-	0
AT2G31862	2	13545548	13546464	916	+	0
AT2G31865	2	13546595	13549536	2941	-	58
AT2G31870	2	13549860	13553844	3984	-	91
AT2G31880	2	13554893	13556977	2084	+	666
AT2G31890	2	13556499	13559767	3268	-	840
AT2G31900	2	13560759	13569623	8864	-	113
AT2G31902	2	13560806	13568489	7683	+	11
AT2G31910	2	13571043	13574019	2976	+	9
AT2G31920	2	13574031	13576367	2336	-	9
AT2G31930	2	13577554	13578248	694	+	0
AT2G31940	2	13580599	13581112	513	+	21
AT2G31945	2	13581580	13582126	546	+	5
AT2G31953	2	13583429	13584020	591	+	0
AT2G31955	2	13584138	13586700	2562	-	390
AT2G31957	2	13587708	13588252	544	+	3
AT2G31960	2	13588886	13600229	11343	+	2592
AT2G31970	2	13600490	13609069	8579	+	576
AT2G31980	2	13609092	13609902	810	-	18
AT2G31981	2	13609980	13610094	114	+	0
AT2G31985	2	13613927	13615692	1765	-	1
AT2G31990	2	13611350	13613573	2223	-	46
AT2G32000	2	13615899	13621641	5742	-	477
AT2G32010	2	13624791	13629146	4355	+	800
AT2G32020	2	13631061	13631768	707	-	3
AT2G32030	2	13632467	13633335	868	-	10
AT2G32040	2	13635105	13637836	2731	+	891
AT2G32050	2	13637878	13638643	765	-	0
AT2G32060	2	13639015	13640370	1355	-	2277
AT2G32070	2	13640667	13641953	1286	-	532
AT2G32080	2	13642236	13644166	1930	-	1963
AT2G32090	2	13644394	13645829	1435	+	837
AT2G32100	2	13647851	13648785	934	+	403
AT2G32110	2	13651273	13651348	75	+	0
AT2G32120	2	13651509	13653921	2412	-	97
AT2G32130	2	13654885	13655525	640	-	1
AT2G32140	2	13655626	13657175	1549	-	30
AT2G32150	2	13659005	13660764	1759	+	822
AT2G32160	2	13662212	13666269	4057	+	1692
AT2G32170	2	13666455	13671754	5299	+	662
AT2G32179	2	13671840	13673376	1536	+	11
AT2G32180	2	13672249	13673256	1007	-	47
AT2G32190	2	13674497	13675286	789	+	19
AT2G32200	2	13676487	13677231	744	+	3
AT2G32210	2	13677985	13678830	845	+	17
AT2G32220	2	13678918	13679523	605	+	70
AT2G32230	2	13679528	13682236	2708	-	2050
AT2G32235	2	13682556	13685500	2944	-	20
AT2G32240	2	13684298	13691155	6857	-	1537
AT2G32250	2	13693104	13697154	4050	+	212
AT2G32260	2	13697515	13700641	3126	+	798
AT2G32270	2	13704220	13706860	2640	+	1
AT2G32273	2	13708747	13708864	117	-	0
AT2G32275	2	13709603	13710356	753	+	0
AT2G32280	2	13713035	13714211	1176	+	42
AT2G32290	2	13714546	13716929	2383	-	861
AT2G32291	2	13717188	13717655	467	-	0
AT2G32295	2	13719297	13722179	2882	+	393
AT2G32300	2	13722426	13723590	1164	+	0
AT2G32310	2	13724393	13726374	1981	+	0
AT2G32315	2	13726298	13726700	402	-	0
AT2G32320	2	13726818	13731767	4949	+	407
AT2G32340	2	13732246	13734534	2288	+	160
AT2G32350	2	13734944	13735788	844	+	2
AT2G32360	2	13737018	13737546	528	-	0
AT2G32370	2	13740877	13746286	5409	+	0
AT2G32380	2	13746610	13747791	1181	-	172
AT2G32390	2	13748440	13751933	3493	-	283
AT2G32400	2	13752583	13756853	4270	-	483
AT2G32410	2	13757592	13761077	3485	+	237
AT2G32415	2	13761136	13765456	4320	-	348
AT2G32430	2	13771295	13774502	3207	+	160
AT2G32440	2	13774587	13778026	3439	+	858
AT2G32450	2	13778448	13781258	2810	+	543
AT2G32460	2	13782207	13784471	2264	-	0
AT2G32470	2	13787171	13788894	1723	+	2
AT2G32480	2	13788516	13790073	1557	-	2605
AT2G32487	2	13791886	13793177	1291	+	26
AT2G32490	2	13794632	13795213	581	+	0
AT2G32500	2	13794425	13797227	2802	-	1859
AT2G32510	2	13798820	13799939	1119	-	22
AT2G32520	2	13805518	13807536	2018	-	1124
AT2G32530	2	13809215	13813570	4355	+	958
AT2G32540	2	13814685	13818289	3604	+	1575
AT2G32550	2	13819378	13822839	3461	+	125
AT2G32560	2	13824793	13826986	2193	+	1814
AT2G32580	2	13827435	13829317	1882	+	810
AT2G32590	2	13829419	13833209	3790	-	154
AT2G32600	2	13833544	13835663	2119	-	381
AT2G32610	2	13836233	13839513	3280	+	0
AT2G32620	2	13840743	13844324	3581	+	0
AT2G32630	2	13844833	13846708	1875	+	43
AT2G32640	2	13846918	13850909	3991	-	1544
AT2G32645	2	13851666	13853343	1677	-	0
AT2G32650	2	13851061	13852080	1019	+	140
AT2G32660	2	13853757	13856112	2355	-	0
AT2G32670	2	13857876	13859774	1898	+	16
AT2G32680	2	13859768	13862614	2846	-	94
AT2G32690	2	13863716	13864596	880	-	4985
AT2G32698	2	13866204	13866467	263	+	0
AT2G32700	2	13866771	13872157	5386	+	2048
AT2G32710	2	13873435	13875831	2396	+	292
AT2G32720	2	13876773	13878531	1758	-	647
AT2G32730	2	13880045	13885736	5691	+	2661
AT2G32740	2	13886825	13888232	1407	+	1
AT2G32750	2	13889640	13891170	1530	+	4
AT2G32760	2	13891790	13894724	2934	+	320
AT2G32765	2	13894861	13895582	721	+	78
AT2G32770	2	13895824	13898277	2453	+	46
AT2G32780	2	13898430	13901870	3440	-	0
AT2G32785	2	13903271	13903487	216	+	0
AT2G32788	2	13904915	13905110	195	+	0
AT2G32790	2	13905487	13906326	839	-	2
AT2G32795	2	13909422	13910910	1488	+	71
AT2G32800	2	13916451	13919179	2728	+	422
AT2G32810	2	13919126	13925351	6225	-	1189
AT2G32820	2	13925816	13926979	1163	+	0
AT2G32830	2	13927698	13929713	2015	-	3
AT2G32835	2	13931165	13931453	288	-	0
AT2G32840	2	13932903	13934949	2046	-	170
AT2G32850	2	13935185	13938845	3660	-	775
AT2G32860	2	13940186	13943804	3618	+	2364
AT2G32870	2	13944610	13946790	2180	-	2897
AT2G32880	2	13948749	13950556	1807	-	1080
AT2G32885	2	13951685	13953478	1793	+	0
AT2G32890	2	13952715	13954115	1400	-	0
AT2G32900	2	13953730	13957748	4018	+	433
AT2G32905	2	13958448	13959066	618	+	0
AT2G32910	2	13959035	13962118	3083	+	725
AT2G32920	2	13962317	13965472	3155	-	1095
AT2G32930	2	13965757	13968957	3200	-	189
AT2G32940	2	13971996	13977476	5480	-	97
AT2G32950	2	13977932	13983535	5603	+	1133
AT2G32960	2	13987766	13990976	3210	+	239
AT2G32970	2	13991447	13995749	4302	-	695
AT2G32980	2	13997381	13999828	2447	-	254
AT2G32990	2	14003249	14006017	2768	+	593
AT2G33000	2	14006134	14008535	2401	+	5
AT2G33006	2	14010012	14010201	189	-	0
AT2G33010	2	14010837	14013246	2409	+	0
AT2G33020	2	14013873	14016516	2643	-	2
AT2G33030	2	14017683	14018340	657	-	0
AT2G33040	2	14018689	14021183	2494	-	5901
AT2G33050	2	14021869	14024398	2529	+	123
AT2G33051	2	14022036	14025085	3049	-	7
AT2G33060	2	14025482	14028196	2714	+	197
AT2G33070	2	14028281	14031164	2883	-	1
AT2G33080	2	14032014	14034237	2223	+	0
AT2G33090	2	14035214	14035961	747	-	0
AT2G33100	2	14036318	14040044	3726	-	3
AT2G33110	2	14041037	14043358	2321	-	83
AT2G33120	2	14043458	14045544	2086	-	1157
AT2G33130	2	14046520	14046832	312	-	0
AT2G33140	2	14047388	14047426	38	-	0
AT2G33150	2	14047477	14051140	3663	-	3876
AT2G33160	2	14053403	14056246	2843	+	0
AT2G33170	2	14056249	14060641	4392	-	443
AT2G33175	2	14062753	14063275	522	-	3
AT2G33180	2	14066462	14067467	1005	+	853
AT2G33190	2	14067971	14069111	1140	+	0
AT2G33200	2	14069540	14070671	1131	+	0
AT2G33205	2	14070986	14073211	2225	-	22
AT2G33210	2	14074869	14078744	3875	-	754
AT2G33220	2	14078850	14080157	1307	+	1562
AT2G33230	2	14080410	14081971	1561	-	1
AT2G33233	2	14083029	14083614	585	-	0
AT2G33240	2	14086941	14096914	9973	-	64
AT2G33250	2	14097431	14098711	1280	+	862
AT2G33255	2	14098777	14100593	1816	+	894
AT2G33260	2	14100839	14102252	1413	-	11
AT2G33270	2	14103542	14105204	1662	+	0
AT2G33280	2	14106409	14107720	1311	+	2
AT2G33290	2	14109963	14112387	2424	+	223
AT2G33300	2	14113024	14114200	1176	+	0
AT2G33310	2	14113024	14116087	3063	-	577
AT2G33320	2	14119525	14122094	2569	-	296
AT2G33330	2	14122889	14125137	2248	-	619
AT2G33340	2	14126216	14131153	4937	-	1806
AT2G33350	2	14133928	14137154	3226	+	7
AT2G33360	2	14139797	14143118	3321	+	314
AT2G33370	2	14143553	14144721	1168	-	1531
AT2G33380	2	14144830	14146471	1641	-	679
AT2G33385	2	14147502	14149799	2297	-	23
AT2G33390	2	14151134	14153118	1984	+	231
AT2G33400	2	14152705	14154530	1825	-	174
AT2G33410	2	14155870	14157762	1892	+	1099
AT2G33420	2	14158704	14162527	3823	+	2
AT2G33430	2	14162666	14165042	2376	+	1559
AT2G33435	2	14165255	14169492	4237	+	372
AT2G33440	2	14170145	14173437	3292	+	258
AT2G33450	2	14173578	14174533	955	+	5836
AT2G33460	2	14174589	14175838	1249	-	4
AT2G33470	2	14176362	14178653	2291	-	1126
AT2G33480	2	14181185	14182402	1217	+	445
AT2G33490	2	14183551	14187869	4318	+	374
AT2G33500	2	14187986	14190254	2268	-	263
AT2G33509	2	14193889	14194114	225	-	0
AT2G33510	2	14194149	14195647	1498	+	180
AT2G33520	2	14196751	14197706	955	+	2
AT2G33530	2	14197645	14200560	2915	-	889
AT2G33540	2	14203504	14208797	5293	-	968
AT2G33550	2	14210031	14211588	1557	-	257
AT2G33560	2	14213600	14215999	2399	-	104
AT2G33570	2	14217222	14219252	2030	+	541
AT2G33580	2	14219622	14221861	2239	-	88
AT2G33585	2	14223199	14224167	968	-	102
AT2G33590	2	14224267	14226602	2335	+	799
AT2G33600	2	14226765	14228711	1946	+	750
AT2G33610	2	14228971	14231309	2338	+	397
AT2G33620	2	14234025	14236883	2858	+	1018
AT2G33630	2	14236832	14238793	1961	-	697
AT2G33640	2	14239212	14242365	3153	+	54
AT2G33650	2	14243130	14243202	72	+	0
AT2G33655	2	14242914	14244569	1655	-	0
AT2G33660	2	14244698	14244770	72	+	0
AT2G33670	2	14245029	14247931	2902	+	0
AT2G33680	2	14249607	14251791	2184	+	33
AT2G33690	2	14252198	14252588	390	+	0
AT2G33700	2	14253423	14255993	2570	+	499
AT2G33705	2	14256150	14256360	210	+	0
AT2G33707	2	14257018	14257258	240	-	0
AT2G33710	2	14258508	14260739	2231	-	3
AT2G33720	2	14263731	14265202	1471	+	0
AT2G33730	2	14265449	14267972	2523	-	976
AT2G33735	2	14268268	14269441	1173	-	80
AT2G33740	2	14269580	14271723	2143	+	549
AT2G33750	2	14271709	14273385	1676	-	24
AT2G33760	2	14275799	14277551	1752	+	5
AT2G33770	2	14277557	14283040	5483	-	5650
AT2G33775	2	14288424	14289225	801	+	5
AT2G33780	2	14291023	14291806	783	-	0
AT2G33790	2	14293560	14295271	1711	-	0
AT2G33793	2	14296993	14300506	3513	+	76
AT2G33796	2	14299708	14300252	544	-	0
AT2G33800	2	14300771	14302430	1659	-	10776
AT2G33810	2	14305000	14306072	1072	+	0
AT2G33815	2	14305007	14306053	1046	-	0
AT2G33820	2	14306292	14308293	2001	-	208
AT2G33830	2	14309483	14310351	868	-	38
AT2G33835	2	14311786	14314700	2914	-	217
AT2G33840	2	14314943	14317499	2556	+	484
AT2G33845	2	14317675	14319389	1714	+	369
AT2G33847	2	14318963	14320591	1628	-	5
AT2G33850	2	14321061	14322049	988	-	835
AT2G33855	2	14324308	14325192	884	-	755
AT2G33860	2	14325268	14328978	3710	-	597
AT2G33870	2	14337365	14338251	886	-	0
AT2G33880	2	14341429	14343778	2349	-	0
AT2G33890	2	14350385	14350457	72	+	0
AT2G33900	2	14351358	14351430	72	+	0
AT2G33910	2	14352190	14352262	72	+	0
AT2G33920	2	14353142	14353214	72	+	0
AT2G33930	2	14353655	14353727	72	+	0
AT2G33940	2	14354097	14354169	72	+	0
AT2G33950	2	14355136	14355208	72	+	0
AT2G33960	2	14356054	14356126	72	+	0
AT2G33970	2	14356520	14356592	72	+	0
AT2G33980	2	14349763	14359840	10077	-	136
AT2G33990	2	14360275	14362241	1966	-	274
AT2G34000	2	14365176	14365632	456	+	0
AT2G34010	2	14368855	14370438	1583	+	57
AT2G34020	2	14371184	14373855	2671	-	0
AT2G34030	2	14375085	14377364	2279	-	2
AT2G34040	2	14377733	14382494	4761	-	1048
AT2G34050	2	14382682	14384279	1597	-	212
AT2G34060	2	14384895	14386669	1774	+	147
AT2G34070	2	14387420	14390230	2810	-	147
AT2G34080	2	14393180	14394858	1678	-	7
AT2G34090	2	14396015	14399297	3282	-	179
AT2G34100	2	14399533	14413489	13956	-	0
AT2G34110	2	14392550	14403317	10767	+	0
AT2G34120	2	14405338	14405551	213	+	0
AT2G34123	2	14406239	14406742	503	+	0
AT2G34130	2	14409488	14412365	2877	+	0
AT2G34135	2	14412727	14412865	138	+	0
AT2G34140	2	14413757	14414765	1008	-	8
AT2G34150	2	14419294	14423478	4184	-	341
AT2G34160	2	14426202	14427383	1181	+	386
AT2G34170	2	14428214	14430860	2646	+	652
AT2G34180	2	14430760	14432269	1509	-	65
AT2G34185	2	14434338	14436174	1836	+	4
AT2G34186	2	14435853	14435949	96	-	0
AT2G34190	2	14436808	14439516	2708	+	165
AT2G34200	2	14440647	14442005	1358	+	57
AT2G34202	2	14442977	14443077	100	-	0
AT2G34204	2	14443503	14443612	109	+	0
AT2G34208	2	14444996	14445114	118	+	0
AT2G34210	2	14445937	14450522	4585	+	0
AT2G34220	2	14450535	14453856	3321	+	7
AT2G34224	2	14454087	14454258	171	-	0
AT2G34230	2	14454638	14457213	2575	+	3
AT2G34238	2	14458820	14458979	159	+	0
AT2G34240	2	14459156	14461802	2646	+	11
AT2G34250	2	14462058	14464868	2810	+	3918
AT2G34260	2	14465848	14468531	2683	+	152
AT2G34270	2	14468751	14469876	1125	-	0
AT2G34280	2	14470200	14471837	1637	-	0
AT2G34290	2	14472632	14473430	798	-	0
AT2G34300	2	14473664	14477430	3766	-	539
AT2G34310	2	14477714	14479988	2274	-	1101
AT2G34315	2	14480218	14483056	2838	-	0
AT2G34320	2	14484958	14485837	879	+	0
AT2G34330	2	14486538	14487401	863	+	0
AT2G34340	2	14488785	14489602	817	-	24
AT2G34350	2	14493585	14495802	2217	+	1
AT2G34355	2	14496327	14498389	2062	+	157
AT2G34357	2	14498589	14505727	7138	+	862
AT2G34360	2	14507293	14510231	2938	+	22
AT2G34370	2	14510481	14511891	1410	+	0
AT2G34380	2	14512706	14514516	1810	+	159
AT2G34390	2	14514486	14515915	1429	-	10
AT2G34400	2	14516225	14518186	1961	+	22
AT2G34410	2	14518405	14522622	4217	+	365
AT2G34420	2	14522523	14523568	1045	-	182815
AT2G34430	2	14524755	14525763	1008	+	45622
AT2G34440	2	14526949	14527689	740	+	30
AT2G34450	2	14527735	14529492	1757	-	119
AT2G34460	2	14529607	14530958	1351	+	3806
AT2G34470	2	14530734	14532505	1771	-	815
AT2G34480	2	14532707	14534239	1532	-	5618
AT2G34490	2	14535644	14537432	1788	-	181
AT2G34500	2	14539478	14541406	1928	-	3
AT2G34510	2	14543996	14546879	2883	-	1076
AT2G34520	2	14547783	14548758	975	-	375
AT2G34530	2	14548961	14550245	1284	-	50
AT2G34540	2	14550656	14552230	1574	+	14
AT2G34555	2	14556987	14558697	1710	+	0
AT2G34560	2	14560162	14562950	2788	+	2224
AT2G34570	2	14562891	14564782	1891	-	106
AT2G34580	2	14565659	14567673	2014	-	0
AT2G34585	2	14568046	14568637	591	-	547
AT2G34590	2	14568810	14570969	2159	-	1646
AT2G34600	2	14573079	14573856	777	+	0
AT2G34610	2	14575391	14576517	1126	+	1
AT2G34620	2	14577173	14578288	1115	+	4178
AT2G34630	2	14578539	14581727	3188	+	817
AT2G34640	2	14581885	14584699	2814	-	1374
AT2G34650	2	14589759	14591788	2029	-	85
AT2G34655	2	14596630	14597540	910	+	49
AT2G34660	2	14602469	14612565	10096	+	2805
AT2G34670	2	14612580	14615795	3215	-	105
AT2G34680	2	14616621	14629129	12508	-	2163
AT2G34690	2	14630306	14632061	1755	+	731
AT2G34700	2	14634133	14635627	1494	-	1
AT2G34710	2	14639322	14644273	4951	-	1310
AT2G34720	2	14649766	14651627	1861	-	886
AT2G34730	2	14654356	14657623	3267	+	361
AT2G34740	2	14658409	14660305	1896	+	0
AT2G34750	2	14660298	14664268	3970	-	1204
AT2G34760	2	14664670	14666076	1406	-	2
AT2G34770	2	14665666	14668250	2584	+	871
AT2G34780	2	14668439	14673904	5465	+	442
AT2G34790	2	14673839	14677270	3431	-	198
AT2G34800	2	14682362	14682515	153	-	0
AT2G34810	2	14685255	14687062	1807	+	168
AT2G34820	2	14689623	14690879	1256	+	0
AT2G34825	2	14691410	14691629	219	+	0
AT2G34830	2	14693755	14696378	2623	-	14
AT2G34835	2	14701501	14701886	385	-	0
AT2G34840	2	14702487	14704353	1866	+	196
AT2G34850	2	14704631	14706191	1560	-	46
AT2G34860	2	14708359	14710197	1838	+	4302
AT2G34870	2	14710776	14711453	677	+	0
AT2G34880	2	14711879	14716634	4755	-	1
AT2G34890	2	14718194	14721271	3077	-	0
AT2G34900	2	14723012	14725650	2638	-	244
AT2G34910	2	14726799	14728128	1329	+	2
AT2G34920	2	14728026	14731156	3130	-	112
AT2G34925	2	14734269	14734536	267	+	66
AT2G34930	2	14737065	14739904	2839	-	336
AT2G34940	2	14740467	14743417	2950	+	20
AT2G34950	2	14743474	14743548	74	-	0
AT2G34960	2	14744036	14745961	1925	-	65
AT2G34970	2	14746306	14748781	2475	+	489
AT2G34980	2	14748966	14749878	912	+	30
AT2G34985	2	14750063	14750134	71	+	0
AT2G34990	2	14750259	14751168	909	-	2
AT2G35000	2	14751573	14753319	1746	-	2
AT2G35010	2	14754270	14756323	2053	+	504
AT2G35020	2	14756710	14760706	3996	+	857
AT2G35030	2	14760868	14763077	2209	-	51
AT2G35035	2	14763177	14765079	1902	-	39
AT2G35040	2	14765159	14768329	3170	-	1976
AT2G35050	2	14768723	14775035	6312	+	3510
AT2G35060	2	14775062	14778870	3808	-	1741
AT2G35070	2	14783290	14784710	1420	+	7
AT2G35075	2	14786681	14789023	2342	+	58
AT2G35080	2	14789244	14791448	2204	-	0
AT2G35090	2	14792170	14793032	862	+	2
AT2G35100	2	14793650	14795629	1979	-	236
AT2G35110	2	14795714	14803937	8223	-	1191
AT2G35120	2	14805638	14807369	1731	-	516
AT2G35130	2	14807448	14810229	2781	-	1261
AT2G35140	2	14813420	14816808	3388	+	33
AT2G35150	2	14817046	14818211	1165	-	19
AT2G35155	2	14818993	14821965	2972	-	604
AT2G35160	2	14822823	14826162	3339	+	52
AT2G35170	2	14827462	14829802	2340	+	101
AT2G35180	2	14829864	14830139	275	-	0
AT2G35190	2	14830625	14833319	2694	+	410
AT2G35200	2	14833847	14834624	777	+	0
AT2G35208	2	14835853	14836009	156	+	0
AT2G35210	2	14836061	14838149	2088	+	15
AT2G35215	2	14839090	14839799	709	+	0
AT2G35220	2	14840606	14840644	38	+	0
AT2G35230	2	14842292	14844434	2142	+	218
AT2G35240	2	14844939	14846304	1365	-	350
AT2G35250	2	14846661	14848662	2001	-	0
AT2G35260	2	14849535	14851969	2434	+	7250
AT2G35270	2	14857020	14857878	858	+	0
AT2G35280	2	14859377	14860200	823	-	0
AT2G35290	2	14861411	14862029	618	-	10
AT2G35300	2	14862900	14863387	487	-	2
AT2G35310	2	14864854	14866598	1744	+	25
AT2G35320	2	14866831	14868860	2029	-	288
AT2G35330	2	14868988	14871940	2952	+	903
AT2G35340	2	14872319	14879739	7420	+	309
AT2G35345	2	14880273	14880636	363	-	14
AT2G35350	2	14881038	14884116	3078	-	139
AT2G35360	2	14889047	14890847	1800	-	156
AT2G35370	2	14891101	14892218	1117	+	15349
AT2G35380	2	14892600	14893993	1393	+	3
AT2G35382	2	14894379	14894455	76	-	0
AT2G35384	2	14894548	14894627	79	-	1
AT2G35387	2	14894717	14894796	79	-	2
AT2G35390	2	14895278	14897822	2544	-	1510
AT2G35410	2	14898323	14899750	1427	+	3182
AT2G35420	2	14899714	14900692	978	-	29
AT2G35430	2	14900871	14902385	1514	-	60
AT2G35450	2	14903044	14905372	2328	-	753
AT2G35460	2	14905787	14906504	717	+	0
AT2G35470	2	14908843	14909863	1020	-	385
AT2G35480	2	14910409	14912048	1639	+	50
AT2G35490	2	14912143	14913877	1734	-	4565
AT2G35500	2	14914002	14916135	2133	+	1628
AT2G35510	2	14916722	14920377	3655	-	1038
AT2G35520	2	14921491	14922845	1354	+	306
AT2G35530	2	14922961	14926591	3630	-	360
AT2G35540	2	14927157	14928930	1773	+	125
AT2G35550	2	14929280	14930892	1612	+	16
AT2G35570	2	14931138	14933175	2037	-	0
AT2G35580	2	14933827	14935482	1655	-	0
AT2G35585	2	14936665	14937964	1299	+	18
AT2G35590	2	14938535	14939921	1386	-	0
AT2G35600	2	14940844	14945357	4513	-	22
AT2G35605	2	14946062	14947276	1214	+	178
AT2G35610	2	14947364	14951247	3883	-	544
AT2G35612	2	14955240	14955501	261	-	0
AT2G35613	2	14958044	14958630	586	+	0
AT2G35615	2	14959390	14960734	1344	+	0
AT2G35620	2	14960939	14965497	4558	-	1030
AT2G35630	2	14966677	14980606	13929	+	2572
AT2G35635	2	14980969	14982116	1147	+	1953
AT2G35637	2	14982607	14983998	1391	-	2
AT2G35640	2	14982834	14984182	1348	+	2
AT2G35650	2	14985487	14988357	2870	+	497
AT2G35658	2	14990324	14990935	611	-	7
AT2G35660	2	14988446	14990426	1980	+	927
AT2G35670	2	14992564	14996756	4192	+	1
AT2G35680	2	14996712	14999085	2373	-	2845
AT2G35690	2	14999753	15003066	3313	+	491
AT2G35700	2	15005204	15005789	585	+	46
AT2G35710	2	15010795	15014284	3489	-	16
AT2G35720	2	15016669	15020011	3342	+	248
AT2G35730	2	15020491	15021556	1065	-	0
AT2G35733	2	15022675	15022867	192	-	0
AT2G35736	2	15022581	15023364	783	-	37
AT2G35738	2	15023558	15025465	1907	+	14
AT2G35740	2	15024488	15026414	1926	-	42
AT2G35742	2	15027588	15027668	80	-	3
AT2G35743	2	15027809	15027989	180	-	2
AT2G35744	2	15029711	15029790	79	-	38
AT2G35747	2	15029831	15029911	80	-	0
AT2G35750	2	15029828	15030290	462	-	90
AT2G35760	2	15031922	15033307	1385	+	296
AT2G35765	2	15033594	15034091	497	+	1
AT2G35770	2	15034036	15036518	2482	-	7
AT2G35780	2	15037661	15040127	2466	-	1338
AT2G35790	2	15040678	15042123	1445	+	284
AT2G35795	2	15042174	15043575	1401	+	402
AT2G35800	2	15044044	15048603	4559	+	2143
AT2G35810	2	15049149	15050323	1174	+	415
AT2G35820	2	15050911	15052239	1328	+	379
AT2G35830	2	15052198	15053275	1077	+	1956
AT2G35840	2	15053622	15057426	3804	+	3547
AT2G35850	2	15056752	15056995	243	+	0
AT2G35859	2	15059336	15061100	1764	-	0
AT2G35860	2	15059762	15062122	2360	+	163
AT2G35880	2	15062987	15065870	2883	-	706
AT2G35890	2	15067174	15069136	1962	-	0
AT2G35900	2	15069996	15071653	1657	-	260
AT2G35910	2	15072931	15074081	1150	-	9
AT2G35920	2	15075596	15080812	5216	+	656
AT2G35930	2	15082854	15084473	1619	-	47
AT2G35940	2	15088831	15092415	3584	-	1293
AT2G35945	2	15090866	15091764	898	+	0
AT2G35950	2	15104760	15106088	1328	+	45
AT2G35960	2	15106939	15107993	1054	+	1213
AT2G35970	2	15109006	15109773	767	+	1
AT2G35980	2	15110587	15111471	884	+	4
AT2G35990	2	15112083	15116776	4693	+	0
AT2G36000	2	15117074	15118697	1623	+	1413
AT2G36010	2	15119541	15123184	3643	+	120
AT2G36020	2	15123153	15125588	2435	-	0
AT2G36026	2	15127264	15127816	552	+	68
AT2G36030	2	15127558	15127771	213	-	0
AT2G36040	2	15130645	15130828	183	-	5
AT2G36050	2	15135571	15136749	1178	-	154
AT2G36053	2	15138995	15139178	183	+	0
AT2G36060	2	15142676	15144182	1506	-	1245
AT2G36070	2	15144835	15148131	3296	-	570
AT2G36080	2	15148258	15151575	3317	-	19
AT2G36090	2	15158560	15159639	1079	+	19
AT2G36100	2	15159590	15160750	1160	-	2
AT2G36110	2	15161701	15162676	975	+	0
AT2G36120	2	15165436	15166465	1029	+	1258
AT2G36130	2	15166772	15168497	1725	+	436
AT2G36140	2	15168861	15168935	74	+	0
AT2G36145	2	15168540	15169514	974	+	2784
AT2G36150	2	15169577	15169657	80	+	0
AT2G36160	2	15169817	15171353	1536	+	2711
AT2G36170	2	15172093	15173280	1187	+	1390
AT2G36180	2	15173781	15174216	435	-	0
AT2G36190	2	15174729	15177870	3141	-	0
AT2G36200	2	15179868	15185314	5446	-	450
AT2G36210	2	15186039	15186804	765	-	1
AT2G36220	2	15192479	15193698	1219	+	158
AT2G36230	2	15193693	15195538	1845	-	368
AT2G36240	2	15195652	15197264	1612	+	509
AT2G36250	2	15197368	15200603	3235	-	1957
AT2G36255	2	15201401	15201728	327	-	0
AT2G36260	2	15202645	15203703	1058	+	0
AT2G36261	2	15203903	15204146	243	-	0
AT2G36270	2	15204763	15207528	2765	-	8
AT2G36280	2	15208401	15208438	37	-	0
AT2G36290	2	15208626	15210845	2219	-	455
AT2G36295	2	15211717	15212269	552	+	0
AT2G36300	2	15213021	15214272	1251	-	271
AT2G36305	2	15214518	15216612	2094	+	116
AT2G36307	2	15218039	15219415	1376	-	35
AT2G36310	2	15224496	15226872	2376	-	617
AT2G36320	2	15228787	15230496	1709	+	731
AT2G36325	2	15231392	15233281	1889	+	0
AT2G36330	2	15233521	15235453	1932	+	306
AT2G36340	2	15235722	15237728	2006	+	130
AT2G36350	2	15238092	15241923	3831	+	379
AT2G36355	2	15242375	15243492	1117	+	33
AT2G36360	2	15242903	15247627	4724	-	394
AT2G36370	2	15247792	15252967	5175	+	177
AT2G36380	2	15257582	15263766	6184	+	385
AT2G36390	2	15264236	15270092	5856	+	1498
AT2G36400	2	15270087	15272823	2736	-	138
AT2G36402	2	15273644	15274632	988	+	0
AT2G36410	2	15278768	15280688	1920	+	337
AT2G36420	2	15286497	15288990	2493	+	146
AT2G36430	2	15290203	15291763	1560	+	345
AT2G36440	2	15292647	15292872	225	+	1
AT2G36450	2	15294302	15294857	555	-	0
AT2G36460	2	15296700	15298514	1814	-	2005
AT2G36470	2	15299361	15300990	1629	-	66
AT2G36480	2	15302566	15306274	3708	-	382
AT2G36485	2	15306953	15307794	841	-	108
AT2G36490	2	15308020	15314807	6787	-	1813
AT2G36500	2	15318027	15320152	2125	+	39
AT2G36510	2	15320233	15320316	83	+	0
AT2G36520	2	15320384	15320467	83	-	0
AT2G36530	2	15320755	15323869	3114	-	11157
AT2G36540	2	15325236	15326449	1213	+	7
AT2G36550	2	15327478	15328802	1324	+	0
AT2G36560	2	15329142	15332447	3305	-	0
AT2G36570	2	15335495	15337927	2432	+	928
AT2G36571	2	15337988	15338129	141	-	0
AT2G36580	2	15339121	15343086	3965	+	1328
AT2G36590	2	15343005	15345337	2332	-	218
AT2G36600	2	15346159	15346232	73	+	0
AT2G36610	2	15349326	15350088	762	+	2
AT2G36620	2	15350346	15351900	1554	-	2635
AT2G36630	2	15352490	15355177	2687	-	1782
AT2G36632	2	15355647	15355764	117	+	0
AT2G36640	2	15356833	15358612	1779	-	1
AT2G36650	2	15359914	15361328	1414	+	9
AT2G36660	2	15361320	15364398	3078	-	20
AT2G36670	2	15364787	15368158	3371	-	232
AT2G36680	2	15368797	15370846	2049	-	432
AT2G36690	2	15379693	15381987	2294	+	1
AT2G36695	2	15382660	15383440	780	+	0
AT2G36700	2	15384705	15386421	1716	-	0
AT2G36710	2	15389465	15391251	1786	-	1
AT2G36720	2	15393070	15399418	6348	+	1111
AT2G36724	2	15401373	15401787	414	+	0
AT2G36730	2	15405067	15406573	1506	-	38
AT2G36740	2	15406689	15409835	3146	-	268
AT2G36750	2	15410461	15412038	1577	-	60
AT2G36760	2	15413041	15414594	1553	-	2
AT2G36770	2	15415138	15416766	1628	-	7
AT2G36780	2	15417489	15419154	1665	-	5
AT2G36790	2	15420189	15421866	1677	-	1
AT2G36792	2	15420354	15421964	1610	+	5
AT2G36800	2	15423379	15425016	1637	-	227
AT2G36810	2	15425478	15439462	13984	-	1369
AT2G36815	2	15440768	15441276	508	+	0
AT2G36830	2	15445424	15446574	1150	+	10759
AT2G36835	2	15449602	15451426	1824	-	1298
AT2G36840	2	15451572	15453714	2142	-	113
AT2G36850	2	15454696	15469889	15193	-	2910
AT2G36854	2	15469718	15469904	186	+	1
AT2G36860	2	15470208	15470245	37	-	0
AT2G36870	2	15472644	15474681	2037	-	1611
AT2G36880	2	15479365	15481412	2047	-	7623
AT2G36881	2	15481541	15481703	162	-	0
AT2G36885	2	15482002	15483711	1709	-	1438
AT2G36890	2	15485778	15487277	1499	+	6
AT2G36895	2	15489027	15490347	1320	-	2826
AT2G36900	2	15491039	15492822	1783	-	253
AT2G36910	2	15502013	15507320	5307	+	2377
AT2G36916	2	15508282	15508381	99	+	0
AT2G36920	2	15508797	15509850	1053	+	2
AT2G36930	2	15509897	15511514	1617	-	557
AT2G36940	2	15511785	15511987	202	-	0
AT2G36950	2	15515132	15516931	1799	+	567
AT2G36960	2	15522919	15527758	4839	+	399
AT2G36970	2	15529005	15530749	1744	+	178
AT2G36980	2	15531160	15533265	2105	+	76
AT2G36985	2	15534778	15535192	414	-	10
AT2G36990	2	15537257	15540139	2882	-	2554
AT2G37000	2	15540298	15541248	950	+	4
AT2G37010	2	15541719	15546159	4440	+	0
AT2G37020	2	15546423	15549037	2614	+	385
AT2G37025	2	15549051	15552105	3054	+	55
AT2G37030	2	15553731	15554106	375	+	1
AT2G37035	2	15554916	15556831	1915	-	351
AT2G37040	2	15557375	15560363	2988	-	2999
AT2G37050	2	15568985	15573726	4741	+	1231
AT2G37060	2	15576023	15577877	1854	+	91
AT2G37070	2	15578414	15581308	2894	+	17
AT2G37080	2	15581385	15585186	3801	-	1242
AT2G37090	2	15587393	15589257	1864	-	79
AT2G37100	2	15591100	15592104	1004	+	185
AT2G37110	2	15592551	15594014	1463	+	967
AT2G37120	2	15594029	15594961	932	-	322
AT2G37130	2	15597920	15600077	2157	-	118
AT2G37140	2	15602862	15603329	467	+	0
AT2G37150	2	15603580	15608454	4874	-	162
AT2G37160	2	15608826	15612934	4108	+	411
AT2G37170	2	15613401	15614857	1456	-	3870
AT2G37180	2	15617707	15619155	1448	+	1218
AT2G37190	2	15619406	15620119	713	-	2157
AT2G37195	2	15620348	15621632	1284	+	58
AT2G37200	2	15621953	15623097	1144	-	242
AT2G37210	2	15623990	15626940	2950	-	7
AT2G37220	2	15634524	15636409	1885	-	13272
AT2G37230	2	15637045	15639522	2477	-	352
AT2G37240	2	15639938	15641763	1825	-	2283
AT2G37250	2	15641905	15643786	1881	+	804
AT2G37260	2	15644839	15647065	2226	+	83
AT2G37270	2	15647676	15649221	1545	-	2228
AT2G37280	2	15650399	15656417	6018	+	48
AT2G37290	2	15656426	15661685	5259	-	8
AT2G37300	2	15662566	15664599	2033	-	186
AT2G37310	2	15664799	15667079	2280	-	37
AT2G37320	2	15667207	15668851	1644	+	28
AT2G37330	2	15669137	15670187	1050	+	159
AT2G37340	2	15670146	15672700	2554	-	1201
AT2G37360	2	15673441	15675920	2479	-	0
AT2G37362	2	15673686	15675978	2292	+	0
AT2G37370	2	15679114	15683217	4103	+	6
AT2G37380	2	15686757	15688003	1246	+	67
AT2G37390	2	15694199	15695825	1626	+	131
AT2G37400	2	15696154	15697402	1248	-	253
AT2G37410	2	15697833	15699275	1442	-	1284
AT2G37420	2	15700330	15705346	5016	+	202
AT2G37430	2	15706356	15707224	868	+	1
AT2G37435	2	15709807	15710912	1105	+	0
AT2G37440	2	15718052	15722108	4056	+	0
AT2G37450	2	15722567	15725062	2495	-	755
AT2G37460	2	15726447	15729098	2651	-	845
AT2G37470	2	15736763	15737368	605	+	672
AT2G37478	2	15737841	15739848	2007	+	0
AT2G37480	2	15737841	15739848	2007	+	0
AT2G37500	2	15739782	15742838	3056	-	1046
AT2G37510	2	15742991	15744541	1550	-	36
AT2G37520	2	15744768	15750107	5339	-	519
AT2G37530	2	15750969	15751672	703	+	6
AT2G37540	2	15751567	15753967	2400	-	424
AT2G37550	2	15755096	15757601	2505	-	699
AT2G37555	2	15756721	15758279	1558	+	1
AT2G37560	2	15758644	15761262	2618	+	56
AT2G37570	2	15761299	15763383	2084	-	642
AT2G37580	2	15764727	15765553	826	+	40
AT2G37585	2	15765783	15767878	2095	+	323
AT2G37590	2	15769120	15770619	1499	+	62
AT2G37600	2	15774244	15775374	1130	-	732
AT2G37610	2	15776868	15777673	805	-	1
AT2G37620	2	15779173	15781561	2388	+	558
AT2G37630	2	15781614	15783433	1819	-	747
AT2G37640	2	15787704	15789853	2149	-	604
AT2G37650	2	15792622	15795235	2613	+	173
AT2G37660	2	15795212	15797059	1847	-	7688
AT2G37670	2	15797383	15800536	3153	-	11
AT2G37678	2	15801464	15802793	1329	-	145
AT2G37680	2	15803242	15805573	2331	-	150
AT2G37690	2	15805714	15810552	4838	+	220
AT2G37700	2	15810580	15814208	3628	-	3
AT2G37710	2	15814717	15817004	2287	-	1672
AT2G37720	2	15818081	15821295	3214	+	25
AT2G37730	2	15822185	15824538	2353	-	0
AT2G37740	2	15827705	15828620	915	-	0
AT2G37750	2	15830988	15831558	570	+	5
AT2G37760	2	15831853	15833920	2067	+	279
AT2G37770	2	15834866	15837001	2135	+	29
AT2G37780	2	15837441	15838302	861	-	0
AT2G37790	2	15838763	15840932	2169	+	509
AT2G37800	2	15841038	15843610	2572	-	0
AT2G37810	2	15845349	15846051	702	-	0
AT2G37820	2	15847491	15848490	999	+	1
AT2G37830	2	15849270	15849591	321	-	0
AT2G37840	2	15851802	15856301	4499	+	724
AT2G37860	2	15856629	15858920	2291	+	1149
AT2G37870	2	15859238	15859907	669	+	17
AT2G37880	2	15860632	15861618	986	+	19
AT2G37890	2	15861687	15864009	2322	-	66
AT2G37900	2	15864395	15866408	2013	-	67
AT2G37910	2	15868398	15869097	699	+	0
AT2G37920	2	15868579	15870071	1492	-	681
AT2G37925	2	15870219	15870697	478	-	13
AT2G37930	2	15873116	15874972	1856	+	108
AT2G37940	2	15876749	15879655	2906	+	567
AT2G37950	2	15882487	15883979	1492	-	51
AT2G37960	2	15886547	15889220	2673	-	43
AT2G37970	2	15890971	15891843	872	+	713
AT2G37975	2	15891734	15893639	1905	-	161
AT2G37980	2	15894056	15897610	3554	-	8
AT2G37990	2	15900634	15903218	2584	+	537
AT2G38000	2	15903124	15905391	2267	-	318
AT2G38010	2	15906861	15909931	3070	+	617
AT2G38020	2	15909907	15914710	4803	-	815
AT2G38025	2	15914957	15916733	1776	-	789
AT2G38030	2	15916816	15916889	73	+	0
AT2G38040	2	15917092	15921170	4078	+	5372
AT2G38050	2	15921135	15922313	1178	-	208
AT2G38060	2	15922556	15925623	3067	-	21
AT2G38070	2	15928590	15930794	2204	+	67
AT2G38080	2	15934459	15937616	3157	+	270
AT2G38090	2	15944710	15947085	2375	+	60
AT2G38100	2	15948483	15950228	1745	-	1
AT2G38110	2	15952606	15955494	2888	-	244
AT2G38120	2	15972992	15977180	4188	+	1572
AT2G38130	2	15978511	15980749	2238	-	301
AT2G38140	2	15980882	15981612	730	+	5297
AT2G38150	2	15981699	15982917	1218	-	0
AT2G38152	2	15984061	15985278	1217	-	7
AT2G38160	2	15986427	15988659	2232	-	52
AT2G38170	2	15989082	15993278	4196	-	4112
AT2G38180	2	15997113	15998906	1793	+	143
AT2G38185	2	15999925	16003169	3244	+	139
AT2G38195	2	16002262	16006654	4392	+	6
AT2G38210	2	16007011	16007690	679	+	394
AT2G38220	2	16007890	16010932	3042	+	2
AT2G38230	2	16011455	16012508	1053	+	6035
AT2G38240	2	16012534	16014753	2219	-	2
AT2G38250	2	16018356	16019500	1144	+	14
AT2G38255	2	16021749	16024854	3105	-	4
AT2G38260	2	16025428	16028594	3166	-	337
AT2G38270	2	16031261	16033076	1815	-	1626
AT2G38280	2	16033447	16038876	5429	-	980
AT2G38290	2	16039474	16042383	2909	-	148
AT2G38300	2	16043959	16045992	2033	-	129
AT2G38304	2	16047923	16048115	192	-	0
AT2G38310	2	16050062	16051168	1106	+	318
AT2G38320	2	16055288	16057980	2692	+	80
AT2G38325	2	16061953	16062060	107	+	0
AT2G38330	2	16064502	16067437	2935	+	1277
AT2G38340	2	16067395	16068291	896	-	2
AT2G38350	2	16068340	16069308	968	+	2
AT2G38360	2	16069614	16070589	975	-	164
AT2G38365	2	16070880	16072007	1127	+	0
AT2G38370	2	16072069	16074258	2189	-	150
AT2G38380	2	16076383	16078583	2200	+	83
AT2G38390	2	16079680	16081509	1829	+	24
AT2G38400	2	16083688	16086349	2661	+	332
AT2G38410	2	16086629	16090208	3579	-	373
AT2G38420	2	16091092	16092549	1457	+	95
AT2G38430	2	16092938	16095031	2093	-	53
AT2G38440	2	16095328	16101221	5893	+	1412
AT2G38450	2	16101974	16102916	942	+	306
AT2G38460	2	16103310	16106177	2867	+	330
AT2G38465	2	16106262	16106913	651	-	1
AT2G38470	2	16108360	16110766	2406	+	265
AT2G38480	2	16110740	16111797	1057	-	191
AT2G38490	2	16113490	16115285	1795	-	5
AT2G38500	2	16117394	16119108	1714	-	24
AT2G38510	2	16123984	16125445	1461	+	0
AT2G38520	2	16125918	16126578	660	+	1
AT2G38530	2	16128377	16129158	781	+	217
AT2G38540	2	16130349	16131174	825	+	299
AT2G38544	2	16131507	16131648	141	+	14
AT2G38550	2	16132005	16134415	2410	+	2029
AT2G38560	2	16134637	16136695	2058	+	417
AT2G38570	2	16136688	16138886	2198	-	153
AT2G38580	2	16138569	16142588	4019	+	361
AT2G38590	2	16142896	16144184	1288	+	0
AT2G38600	2	16145906	16146857	951	+	7
AT2G38610	2	16147112	16149873	2761	-	457
AT2G38620	2	16152504	16154086	1582	+	87
AT2G38630	2	16154066	16156579	2513	-	261
AT2G38640	2	16157603	16158561	958	-	361
AT2G38646	2	16160575	16160809	234	+	0
AT2G38650	2	16161487	16165796	4309	-	1126
AT2G38660	2	16165951	16168386	2435	+	308
AT2G38670	2	16168836	16171918	3082	+	951
AT2G38680	2	16174010	16176080	2070	-	315
AT2G38690	2	16176630	16177754	1124	-	4
AT2G38695	2	16177940	16180403	2463	+	175
AT2G38700	2	16180695	16183946	3251	-	972
AT2G38710	2	16184368	16187173	2805	-	552
AT2G38720	2	16188046	16192266	4220	+	77
AT2G38730	2	16192355	16194103	1748	-	302
AT2G38740	2	16194326	16196113	1787	-	1737
AT2G38750	2	16196264	16198491	2227	-	413
AT2G38760	2	16200993	16202669	1676	+	54
AT2G38770	2	16202962	16210338	7376	-	625
AT2G38780	2	16210856	16214232	3376	+	1207
AT2G38790	2	16214188	16215264	1076	-	76
AT2G38800	2	16216998	16219159	2161	+	2618
AT2G38810	2	16219268	16220928	1660	-	189
AT2G38820	2	16221835	16223662	1827	+	341
AT2G38823	2	16224071	16225296	1225	+	43
AT2G38830	2	16225776	16226872	1096	+	87
AT2G38840	2	16227050	16232456	5406	+	464
AT2G38860	2	16233314	16235235	1921	-	516
AT2G38870	2	16236380	16237280	900	-	424
AT2G38880	2	16238475	16240834	2359	+	277
AT2G38890	2	16241188	16242917	1729	+	6
AT2G38900	2	16243214	16244067	853	+	0
AT2G38905	2	16244098	16244503	405	-	0
AT2G38910	2	16245213	16247483	2270	-	0
AT2G38920	2	16248145	16251002	2857	-	0
AT2G38940	2	16257227	16260225	2998	+	45
AT2G38950	2	16260852	16265219	4367	+	850
AT2G38960	2	16265398	16268334	2936	+	206
AT2G38970	2	16273900	16276872	2972	+	380
AT2G38980	2	16277008	16279354	2346	-	362
AT2G38990	2	16280084	16280392	308	+	0
AT2G38995	2	16282119	16284868	2749	+	264
AT2G39000	2	16286335	16287970	1635	-	1021
AT2G39010	2	16291476	16294034	2558	+	6102
AT2G39020	2	16295314	16296328	1014	+	652
AT2G39030	2	16298226	16299202	976	+	1
AT2G39040	2	16299350	16301227	1877	-	0
AT2G39050	2	16303402	16305629	2227	+	176
AT2G39060	2	16306687	16308252	1565	-	0
AT2G39080	2	16309797	16312541	2744	-	1316
AT2G39090	2	16312681	16317300	4619	-	371
AT2G39100	2	16317437	16319387	1950	+	106
AT2G39110	2	16319663	16321685	2022	+	21
AT2G39120	2	16321793	16322957	1164	+	36
AT2G39130	2	16322955	16327266	4311	-	302
AT2G39140	2	16330182	16333360	3178	+	528
AT2G39160	2	16333489	16334173	684	-	0
AT2G39170	2	16334629	16336210	1581	-	414
AT2G39175	2	16340281	16340360	79	+	0
AT2G39180	2	16344150	16346665	2515	-	87
AT2G39190	2	16349967	16355963	5996	+	2892
AT2G39200	2	16356147	16359813	3666	-	4
AT2G39210	2	16366156	16368275	2119	-	197
AT2G39220	2	16374895	16377020	2125	-	393
AT2G39230	2	16381646	16384250	2604	+	24
AT2G39240	2	16384785	16387827	3042	-	50
AT2G39250	2	16388885	16391073	2188	-	394
AT2G39260	2	16392046	16399680	7634	-	1150
AT2G39270	2	16399971	16401671	1700	+	436
AT2G39280	2	16401525	16406854	5329	-	764
AT2G39290	2	16407238	16409123	1885	+	478
AT2G39300	2	16410108	16413484	3376	-	65
AT2G39310	2	16414072	16416815	2743	-	165
AT2G39320	2	16417476	16418517	1041	-	0
AT2G39330	2	16419595	16421852	2257	-	92
AT2G39340	2	16423638	16430108	6470	+	1632
AT2G39350	2	16430084	16432557	2473	-	75
AT2G39360	2	16437471	16440154	2683	-	310
AT2G39370	2	16444129	16445266	1137	-	1
AT2G39380	2	16447005	16449083	2078	-	75
AT2G39390	2	16450659	16451878	1219	-	1000
AT2G39400	2	16452611	16454801	2190	+	168
AT2G39410	2	16455568	16458217	2649	+	0
AT2G39415	2	16458606	16458966	360	-	0
AT2G39420	2	16460363	16463061	2698	+	243
AT2G39430	2	16463346	16464531	1185	+	10
AT2G39435	2	16464413	16466941	2528	-	152
AT2G39440	2	16467854	16469628	1774	-	173
AT2G39445	2	16470024	16471246	1222	-	105
AT2G39450	2	16471631	16473818	2187	-	1141
AT2G39460	2	16474148	16476108	1960	+	4276
AT2G39470	2	16476215	16477843	1628	+	7018
AT2G39480	2	16477791	16485039	7248	-	576
AT2G39490	2	16486901	16488645	1744	-	1
AT2G39500	2	16489072	16489588	516	+	209
AT2G39510	2	16491142	16493151	2009	-	77
AT2G39518	2	16495874	16496995	1121	-	1
AT2G39520	2	16496812	16497621	809	+	0
AT2G39530	2	16498485	16499471	986	-	0
AT2G39540	2	16500865	16501241	376	+	0
AT2G39550	2	16501622	16504304	2682	+	365
AT2G39560	2	16504845	16506008	1163	-	107
AT2G39570	2	16507895	16510198	2303	+	1198
AT2G39580	2	16510424	16517073	6649	+	1656
AT2G39590	2	16517587	16518265	678	-	0
AT2G39600	2	16518563	16518635	72	-	0
AT2G39610	2	16518768	16518840	72	+	0
AT2G39620	2	16518967	16521478	2511	-	1
AT2G39630	2	16521743	16524687	2944	-	479
AT2G39640	2	16525085	16527012	1927	-	0
AT2G39650	2	16527791	16529407	1616	-	94
AT2G39660	2	16531687	16533931	2244	+	113
AT2G39670	2	16534229	16537318	3089	+	1233
AT2G39675	2	16537287	16538277	990	-	176
AT2G39681	2	16539383	16540417	1034	-	346
AT2G39690	2	16541025	16543378	2353	+	111
AT2G39700	2	16543831	16545584	1753	-	1142
AT2G39705	2	16556855	16557577	722	+	86
AT2G39710	2	16561787	16563380	1593	-	261
AT2G39720	2	16567208	16568822	1614	-	733
AT2G39725	2	16569429	16570549	1120	+	36
AT2G39730	2	16570745	16573548	2803	-	373184
AT2G39740	2	16575751	16579120	3369	+	443
AT2G39750	2	16578823	16582404	3581	-	715
AT2G39760	2	16583072	16586252	3180	+	577
AT2G39770	2	16588695	16591032	2337	+	2643
AT2G39780	2	16591221	16593775	2554	+	1128
AT2G39782	2	16594036	16594516	480	-	0
AT2G39790	2	16594832	16595800	968	+	0
AT2G39795	2	16596986	16598162	1176	+	194
AT2G39800	2	16598071	16603319	5248	-	9916
AT2G39805	2	16609914	16612554	2640	-	267
AT2G39810	2	16612799	16618057	5258	+	714
AT2G39820	2	16618276	16619689	1413	+	2
AT2G39830	2	16619761	16623791	4030	-	80
AT2G39840	2	16627257	16629289	2032	+	436
AT2G39850	2	16630472	16634253	3781	+	2538
AT2G39851	2	16634518	16635568	1050	+	0
AT2G39855	2	16637676	16639308	1632	+	10
AT2G39860	2	16639779	16639851	72	-	0
AT2G39865	2	16641760	16641907	147	-	0
AT2G39870	2	16643380	16645377	1997	+	659
AT2G39880	2	16647944	16649479	1535	-	74
AT2G39885	2	16652100	16652233	133	+	0
AT2G39890	2	16655627	16658331	2704	+	779
AT2G39900	2	16658655	16660437	1782	+	305
AT2G39910	2	16660595	16663048	2453	+	244
AT2G39920	2	16663016	16664539	1523	-	68
AT2G39930	2	16666022	16672494	6472	+	2545
AT2G39940	2	16672492	16675748	3256	-	863
AT2G39950	2	16676541	16680489	3948	-	1212
AT2G39960	2	16681473	16683640	2167	-	1022
AT2G39970	2	16683831	16686709	2878	-	1066
AT2G39975	2	16687870	16688248	378	+	0
AT2G39980	2	16687672	16689956	2284	-	237
AT2G39990	2	16698091	16700012	1921	-	1168
AT2G40000	2	16700509	16702028	1519	-	561
AT2G40004	2	16704062	16704954	892	+	0
AT2G40008	2	16708055	16709436	1381	+	0
AT2G40010	2	16708378	16710448	2070	-	60
AT2G40020	2	16710978	16713070	2092	+	567
AT2G40030	2	16714493	16723583	9090	+	376
AT2G40050	2	16723880	16725774	1894	-	8
AT2G40060	2	16726483	16728185	1702	+	1929
AT2G40070	2	16728193	16731606	3413	-	578
AT2G40080	2	16734293	16734912	619	-	7
AT2G40081	2	16735001	16735115	114	-	0
AT2G40085	2	16736460	16737259	799	-	15
AT2G40090	2	16737465	16740370	2905	-	216
AT2G40095	2	16743022	16745144	2122	+	21
AT2G40100	2	16745652	16747400	1748	+	7647
AT2G40110	2	16747939	16749545	1606	+	111
AT2G40113	2	16750034	16751084	1050	+	0
AT2G40116	2	16751713	16754535	2822	+	1
AT2G40120	2	16754938	16757592	2654	-	117
AT2G40130	2	16765919	16769268	3349	+	724
AT2G40140	2	16772072	16774657	2585	+	283
AT2G40150	2	16775441	16777243	1802	+	264
AT2G40160	2	16777389	16779408	2019	+	66
AT2G40170	2	16779551	16780258	707	-	0
AT2G40180	2	16782521	16784147	1626	+	14
AT2G40190	2	16785193	16787530	2337	+	293
AT2G40200	2	16791097	16792090	993	+	16
AT2G40205	2	16792316	16792531	215	-	343
AT2G40210	2	16793212	16794328	1116	-	0
AT2G40220	2	16796598	16797585	987	-	0
AT2G40230	2	16803091	16804741	1650	-	211
AT2G40233	2	16807046	16807208	162	+	0
AT2G40240	2	16811025	16812228	1203	+	34
AT2G40250	2	16813329	16815251	1922	+	4
AT2G40260	2	16816817	16818473	1656	-	109
AT2G40270	2	16821933	16824506	2573	-	1288
AT2G40280	2	16825499	16828398	2899	-	463
AT2G40290	2	16828765	16831054	2289	-	1270
AT2G40300	2	16831292	16833280	1988	-	767
AT2G40310	2	16834064	16835711	1647	+	0
AT2G40316	2	16836209	16839189	2980	+	439
AT2G40320	2	16840146	16842282	2136	+	74
AT2G40330	2	16844863	16845934	1071	-	7
AT2G40340	2	16848437	16850487	2050	-	4
AT2G40350	2	16851594	16852068	474	-	0
AT2G40360	2	16852879	16856690	3811	-	803
AT2G40370	2	16858165	16860606	2441	-	6
AT2G40380	2	16864494	16865442	948	-	481
AT2G40390	2	16867292	16869089	1797	+	179
AT2G40400	2	16869333	16873258	3925	+	3173
AT2G40410	2	16873398	16875396	1998	+	630
AT2G40420	2	16877222	16879214	1992	+	481
AT2G40430	2	16879215	16882445	3230	-	1145
AT2G40435	2	16886823	16888638	1815	+	374
AT2G40440	2	16889211	16891292	2081	-	11
AT2G40450	2	16892023	16892790	767	-	0
AT2G40460	2	16896906	16901280	4374	+	1319
AT2G40470	2	16902303	16903652	1349	-	11
AT2G40475	2	16906910	16908128	1218	-	773
AT2G40480	2	16910363	16912592	2229	+	348
AT2G40490	2	16912844	16915177	2333	+	6545
AT2G40500	2	16916329	16917217	888	+	0
AT2G40510	2	16918432	16919888	1456	+	1247
AT2G40520	2	16922586	16925914	3328	+	411
AT2G40530	2	16927501	16928208	707	+	48
AT2G40540	2	16930863	16934588	3725	+	1445
AT2G40550	2	16934833	16938201	3368	+	375
AT2G40560	2	16938704	16939616	912	-	0
AT2G40570	2	16940834	16943492	2658	+	245
AT2G40580	2	16943863	16945003	1140	+	1
AT2G40590	2	16945044	16946419	1375	-	688
AT2G40600	2	16946869	16948561	1692	-	859
AT2G40610	2	16948862	16950557	1695	-	3637
AT2G40620	2	16954540	16956978	2438	-	175
AT2G40630	2	16958145	16961144	2999	+	268
AT2G40640	2	16961139	16963205	2066	-	210
AT2G40650	2	16963318	16965752	2434	-	456
AT2G40660	2	16965932	16969035	3103	+	718
AT2G40670	2	16970229	16971234	1005	+	174
AT2G40680	2	16972828	16973719	891	+	0
AT2G40690	2	16973991	16976458	2467	+	455
AT2G40700	2	16976782	16979558	2776	+	241
AT2G40710	2	16980942	16981368	426	-	7
AT2G40711	2	16981690	16982257	567	-	20
AT2G40720	2	16987268	16989851	2583	+	38
AT2G40730	2	16989835	16996298	6463	-	1317
AT2G40740	2	16997176	16999277	2101	+	0
AT2G40745	2	17008173	17008917	744	-	0
AT2G40750	2	17000453	17002468	2015	-	187
AT2G40760	2	17010047	17012067	2020	+	513
AT2G40765	2	17012197	17013325	1128	+	786
AT2G40770	2	17013268	17021315	8047	-	471
AT2G40780	2	17021504	17022916	1412	+	98
AT2G40790	2	17022962	17024270	1308	-	2
AT2G40800	2	17024390	17026973	2583	-	577
AT2G40802	2	17028303	17028405	102	-	1
AT2G40805	2	17029700	17029899	199	+	1
AT2G40810	2	17032463	17034600	2137	+	144
AT2G40815	2	17034540	17036208	1668	-	168
AT2G40820	2	17036462	17040063	3601	-	475
AT2G40830	2	17042651	17044859	2208	+	718
AT2G40840	2	17044962	17050947	5985	+	5726
AT2G40850	2	17051122	17053292	2170	+	122
AT2G40860	2	17053567	17057182	3615	-	513
AT2G40880	2	17057401	17058122	721	+	1894
AT2G40890	2	17058052	17060652	2600	-	1199
AT2G40900	2	17063121	17065684	2563	-	370
AT2G40910	2	17069867	17071657	1790	-	3
AT2G40920	2	17072463	17074164	1701	-	434
AT2G40925	2	17074904	17076239	1335	-	0
AT2G40930	2	17076311	17082433	6122	-	561
AT2G40935	2	17082847	17084347	1500	+	161
AT2G40940	2	17084355	17087297	2942	-	504
AT2G40950	2	17087619	17090424	2805	-	334
AT2G40955	2	17093092	17095132	2040	+	0
AT2G40960	2	17095521	17097454	1933	+	678
AT2G40970	2	17097549	17098695	1146	-	209
AT2G40980	2	17102089	17104802	2713	+	370
AT2G40990	2	17105096	17106773	1677	-	0
AT2G40995	2	17109393	17109712	319	+	0
AT2G41000	2	17111444	17113636	2192	+	178
AT2G41010	2	17113865	17114804	939	-	144
AT2G41020	2	17117262	17121119	3857	+	356
AT2G41040	2	17121375	17123204	1829	+	901
AT2G41050	2	17123189	17126349	3160	-	347
AT2G41060	2	17126988	17129563	2575	+	627
AT2G41070	2	17130773	17132386	1613	+	40
AT2G41080	2	17132852	17134593	1741	+	152
AT2G41082	2	17134824	17134929	105	+	5
AT2G41090	2	17135720	17136852	1132	+	8779
AT2G41100	2	17137828	17139612	1784	+	1032
AT2G41110	2	17140228	17141431	1203	+	521
AT2G41120	2	17141274	17142457	1183	-	671
AT2G41130	2	17143293	17144949	1656	+	82
AT2G41140	2	17150386	17153690	3304	+	1402
AT2G41150	2	17153843	17155983	2140	+	83
AT2G41160	2	17156028	17158880	2852	-	363
AT2G41170	2	17159103	17161136	2033	-	236
AT2G41178	2	17164794	17165449	655	-	2
AT2G41180	2	17165190	17166025	835	+	384
AT2G41190	2	17167278	17170407	3129	-	512
AT2G41200	2	17171624	17173131	1507	+	109
AT2G41210	2	17173412	17176807	3395	+	260
AT2G41220	2	17177663	17188751	11088	+	1403
AT2G41225	2	17191027	17191486	459	-	0
AT2G41230	2	17194925	17195674	749	-	0
AT2G41231	2	17195291	17195915	624	+	0
AT2G41233	2	17196650	17196758	108	-	0
AT2G41240	2	17198281	17199320	1039	-	4
AT2G41250	2	17200658	17202618	1960	-	1397
AT2G41260	2	17206509	17207698	1189	+	0
AT2G41270	2	17208544	17209402	858	-	0
AT2G41280	2	17209696	17210423	727	+	0
AT2G41290	2	17210427	17212959	2532	-	305
AT2G41300	2	17214236	17216292	2056	-	47
AT2G41310	2	17221932	17224427	2495	+	738
AT2G41312	2	17225522	17226693	1171	+	108
AT2G41330	2	17226947	17228378	1431	+	92
AT2G41340	2	17229007	17230482	1475	+	65
AT2G41342	2	17230532	17231037	505	-	10
AT2G41350	2	17231340	17233557	2217	+	360
AT2G41360	2	17234373	17236279	1906	+	0
AT2G41370	2	17237744	17240440	2696	-	258
AT2G41380	2	17251940	17253057	1117	+	66
AT2G41390	2	17257379	17258196	817	+	0
AT2G41391	2	17258351	17258612	261	+	0
AT2G41400	2	17259456	17260120	664	+	0
AT2G41410	2	17261727	17262884	1157	-	991
AT2G41415	2	17264401	17265082	681	-	0
AT2G41420	2	17266476	17268024	1548	-	1090
AT2G41430	2	17269231	17270542	1311	+	4225
AT2G41440	2	17271171	17274370	3199	+	140
AT2G41445	2	17275590	17277330	1740	+	2
AT2G41450	2	17278157	17281830	3673	+	32
AT2G41451	2	17282898	17285361	2463	+	1
AT2G41460	2	17285722	17288928	3206	+	270
AT2G41470	2	17289951	17293749	3798	-	2
AT2G41473	2	17294452	17294728	276	-	0
AT2G41475	2	17295073	17296420	1347	-	571
AT2G41480	2	17296811	17298731	1920	-	19
AT2G41490	2	17301694	17304211	2517	+	251
AT2G41500	2	17304129	17307426	3297	-	240
AT2G41510	2	17314531	17317003	2472	+	54
AT2G41520	2	17317484	17323021	5537	+	583
AT2G41530	2	17323494	17325618	2124	-	2191
AT2G41540	2	17326092	17328902	2810	+	634
AT2G41550	2	17328969	17331173	2204	-	89
AT2G41560	2	17332083	17337269	5186	-	2784
AT2G41570	2	17337736	17338993	1257	+	3
AT2G41580	2	17339803	17343088	3285	+	3
AT2G41590	2	17343359	17345005	1646	+	0
AT2G41600	2	17344636	17346737	2101	-	346
AT2G41610	2	17347156	17348239	1083	+	2
AT2G41616	2	17349436	17349574	138	-	0
AT2G41620	2	17347303	17355084	7781	-	843
AT2G41630	2	17355330	17357598	2268	-	825
AT2G41640	2	17360485	17363788	3303	+	128
AT2G41650	2	17363906	17364434	528	+	478
AT2G41660	2	17367821	17369189	1368	+	15
AT2G41670	2	17374082	17376238	2156	+	56
AT2G41680	2	17376154	17379055	2901	-	6308
AT2G41690	2	17381722	17382577	855	+	2
AT2G41700	2	17382889	17396110	13221	-	1164
AT2G41705	2	17397273	17400081	2808	+	257
AT2G41710	2	17400021	17403050	3029	-	492
AT2G41720	2	17403602	17407135	3533	-	1084
AT2G41730	2	17409462	17409937	475	+	18
AT2G41740	2	17410714	17417740	7026	-	2447
AT2G41745	2	17417953	17419423	1470	-	0
AT2G41750	2	17421643	17422522	879	-	91
AT2G41760	2	17422769	17424371	1602	+	243
AT2G41770	2	17424357	17427282	2925	-	639
AT2G41780	2	17428097	17428812	715	+	13
AT2G41790	2	17429293	17436174	6881	-	2114
AT2G41800	2	17436528	17438040	1512	-	6
AT2G41810	2	17439373	17441350	1977	-	5
AT2G41820	2	17446743	17450071	3328	+	1035
AT2G41830	2	17450108	17457087	6979	-	196
AT2G41835	2	17457785	17459568	1783	-	109
AT2G41840	2	17459787	17461539	1752	-	6625
AT2G41850	2	17461654	17464161	2507	-	0
AT2G41860	2	17467343	17469786	2443	-	0
AT2G41870	2	17470865	17472936	2071	-	1548
AT2G41880	2	17474618	17477223	2605	+	337
AT2G41890	2	17478057	17480352	2295	-	425
AT2G41900	2	17490404	17493922	3518	+	2440
AT2G41905	2	17495679	17496142	463	+	38
AT2G41910	2	17496955	17498077	1122	+	0
AT2G41920	2	17499403	17500452	1049	+	0
AT2G41930	2	17501628	17502684	1056	+	2
AT2G41940	2	17507508	17508616	1108	+	884
AT2G41945	2	17509068	17512954	3886	-	172
AT2G41950	2	17513078	17514167	1089	+	716
AT2G41960	2	17514117	17519293	5176	-	1083
AT2G41970	2	17520378	17522756	2378	-	0
AT2G41980	2	17523493	17525914	2421	-	368
AT2G41990	2	17527256	17528937	1681	+	58
AT2G41997	2	17110827	17111207	380	+	0
AT2G42000	2	17529242	17530443	1201	-	0
AT2G42005	2	17531191	17532582	1391	-	5
AT2G42010	2	17532812	17538400	5588	-	547
AT2G42020	2	17538702	17538784	82	-	0
AT2G42030	2	17538905	17540966	2061	-	509
AT2G42040	2	17543033	17545230	2197	+	154
AT2G42050	2	17546139	17546559	420	-	0
AT2G42060	2	17548094	17549069	975	+	0
AT2G42070	2	17549090	17551175	2085	-	783
AT2G42080	2	17553239	17555504	2265	-	290
AT2G42090	2	17556743	17558369	1626	+	3
AT2G42100	2	17560210	17561945	1735	+	0
AT2G42110	2	17562151	17562733	582	-	36
AT2G42120	2	17563156	17566032	2876	-	220
AT2G42130	2	17566184	17568144	1960	+	1829
AT2G42140	2	17568676	17569527	851	-	0
AT2G42150	2	17572368	17574679	2311	+	39
AT2G42160	2	17574640	17577463	2823	-	374
AT2G42170	2	17577713	17580392	2679	+	93
AT2G42180	2	17580916	17581956	1040	-	0
AT2G42190	2	17582868	17584194	1326	+	1228
AT2G42200	2	17587406	17589630	2224	+	285
AT2G42210	2	17590190	17591852	1662	+	2174
AT2G42220	2	17592037	17593500	1463	+	11159
AT2G42230	2	17593410	17596629	3219	-	610
AT2G42240	2	17596816	17599604	2788	+	232
AT2G42247	2	17599369	17601825	2456	+	19
AT2G42250	2	17600074	17601849	1775	-	28
AT2G42260	2	17601954	17603633	1679	-	68
AT2G42270	2	17604329	17611333	7004	+	1684
AT2G42280	2	17611184	17613519	2335	-	224
AT2G42290	2	17616840	17619593	2753	-	137
AT2G42300	2	17621155	17624841	3686	+	647
AT2G42310	2	17625211	17625889	678	+	739
AT2G42320	2	17627341	17630797	3456	+	1211
AT2G42330	2	17630728	17634299	3571	-	484
AT2G42340	2	17636322	17637727	1405	-	3
AT2G42350	2	17639151	17639998	847	+	2
AT2G42360	2	17640797	17641790	993	+	37
AT2G42365	2	17641783	17645835	4052	-	41
AT2G42370	2	17643333	17645533	2200	+	85
AT2G42380	2	17646899	17648945	2046	-	484
AT2G42388	2	17650224	17651083	859	+	2
AT2G42390	2	17651252	17652588	1336	-	313
AT2G42395	2	17653137	17654034	897	-	17
AT2G42400	2	17654231	17656839	2608	-	382
AT2G42410	2	17658149	17658794	645	+	1
AT2G42420	2	17660777	17660848	71	+	0
AT2G42425	2	17661833	17662358	525	-	0
AT2G42430	2	17663443	17665295	1852	+	0
AT2G42440	2	17668700	17669817	1117	-	0
AT2G42450	2	17672252	17675019	2767	-	149
AT2G42460	2	17676398	17679293	2895	-	0
AT2G42470	2	17679886	17685187	5301	-	0
AT2G42480	2	17685804	17689928	4124	-	3
AT2G42485	2	17690530	17691018	488	+	95
AT2G42490	2	17691406	17695853	4447	-	1825
AT2G42500	2	17697666	17701417	3751	-	1388
AT2G42510	2	17701661	17704618	2957	+	70
AT2G42520	2	17704831	17708947	4116	+	683
AT2G42530	2	17709035	17709945	910	-	273
AT2G42540	2	17711031	17712330	1299	-	2875
AT2G42550	2	17713195	17714230	1035	+	0
AT2G42560	2	17714637	17716912	2275	-	0
AT2G42570	2	17717366	17720080	2714	-	176
AT2G42580	2	17728714	17731718	3004	+	728
AT2G42590	2	17731854	17733967	2113	-	6413
AT2G42600	2	17734323	17739085	4762	-	13803
AT2G42610	2	17747916	17750440	2524	+	671
AT2G42620	2	17756139	17758468	2329	+	554
AT2G42640	2	17758531	17764111	5580	-	77
AT2G42650	2	17765479	17766888	1409	+	70
AT2G42660	2	17767049	17768290	1241	-	0
AT2G42670	2	17771775	17774647	2872	-	272
AT2G42680	2	17774902	17776320	1418	+	1590
AT2G42690	2	17776240	17777717	1477	-	4850
AT2G42700	2	17778273	17782187	3914	+	402
AT2G42710	2	17782307	17785063	2756	+	380
AT2G42720	2	17785408	17787421	2013	+	11
AT2G42730	2	17787453	17791582	4129	-	87
AT2G42740	2	17791728	17793082	1354	+	289
AT2G42750	2	17793306	17795680	2374	+	4361
AT2G42760	2	17795983	17797231	1248	-	161
AT2G42770	2	17798284	17800006	1722	-	1445
AT2G42780	2	17800443	17802816	2373	+	152
AT2G42790	2	17801470	17806049	4579	-	636
AT2G42800	2	17807941	17809590	1649	-	82
AT2G42810	2	17811934	17816692	4758	-	956
AT2G42820	2	17817337	17818545	1208	-	58
AT2G42830	2	17820254	17824013	3759	+	0
AT2G42835	2	17823264	17824842	1578	-	0
AT2G42840	2	17826115	17827536	1421	-	4086
AT2G42850	2	17831654	17833432	1778	+	0
AT2G42860	2	17833764	17835113	1349	+	14
AT2G42870	2	17836415	17837250	835	-	64
AT2G42880	2	17840387	17844380	3993	-	1748
AT2G42885	2	17845966	17846603	637	-	0
AT2G42890	2	17849818	17854553	4735	+	439
AT2G42900	2	17854556	17855481	925	+	102
AT2G42910	2	17856267	17858597	2330	+	864
AT2G42920	2	17858697	17863466	4769	+	205
AT2G42930	2	17860867	17861272	405	-	0
AT2G42940	2	17862253	17863456	1203	-	1
AT2G42950	2	17863818	17866487	2669	+	229
AT2G42955	2	17866685	17867572	887	-	1
AT2G42960	2	17868596	17870630	2034	-	141
AT2G42970	2	17873689	17873762	73	+	0
AT2G42975	2	17873946	17874936	990	+	801
AT2G42980	2	17875004	17876588	1584	-	41
AT2G42990	2	17879030	17880563	1533	+	6
AT2G43000	2	17880614	17882636	2022	-	13
AT2G43010	2	17886426	17889050	2624	+	3047
AT2G43018	2	17891503	17894633	3130	+	0
AT2G43020	2	17891502	17894635	3133	+	0
AT2G43030	2	17894835	17895866	1031	+	10100
AT2G43040	2	17895882	17899374	3492	-	96
AT2G43050	2	17902483	17904443	1960	+	18
AT2G43060	2	17909184	17910082	898	+	249
AT2G43070	2	17910887	17914870	3983	-	881
AT2G43080	2	17915560	17918754	3194	+	319
AT2G43090	2	17918926	17920429	1503	+	3474
AT2G43100	2	17920659	17921689	1030	+	2008
AT2G43110	2	17922059	17924355	2296	+	206
AT2G43120	2	17927263	17928984	1721	+	514
AT2G43130	2	17929653	17930936	1283	-	321
AT2G43137	2	17923080	17923157	77	+	5
AT2G43138	2	17923237	17923316	79	+	1
AT2G43139	2	17923398	17923477	79	+	1
AT2G43140	2	17931524	17935686	4162	-	2
AT2G43141	2	17923562	17923637	75	+	1
AT2G43150	2	17945892	17947022	1130	+	989
AT2G43160	2	17948061	17953669	5608	+	2701
AT2G43180	2	17953496	17955829	2333	-	481
AT2G43190	2	17955983	17958041	2058	+	104
AT2G43200	2	17958229	17960536	2307	+	285
AT2G43210	2	17960699	17963727	3028	+	407
AT2G43220	2	17964218	17966211	1993	+	0
AT2G43230	2	17966250	17968726	2476	+	32
AT2G43235	2	17968697	17970835	2138	-	473
AT2G43240	2	17970858	17975867	5009	-	358
AT2G43250	2	17977227	17979608	2381	+	153
AT2G43255	2	17979702	17981309	1607	-	0
AT2G43260	2	17983690	17985104	1414	-	192
AT2G43261	2	17985246	17986775	1529	-	1
AT2G43270	2	17988206	17989491	1285	-	0
AT2G43280	2	17989697	17991022	1325	+	229
AT2G43290	2	17991051	17992047	996	-	572
AT2G43300	2	17995572	17995644	72	-	0
AT2G43310	2	17995900	17996688	788	+	32
AT2G43320	2	17996649	17999927	3278	-	165
AT2G43330	2	18000853	18004083	3230	+	793
AT2G43340	2	18007696	18008665	969	+	314
AT2G43350	2	18008481	18010606	2125	-	389
AT2G43360	2	18010750	18013238	2488	-	890
AT2G43370	2	18013369	18015454	2085	+	160
AT2G43371	2	18015942	18016197	255	-	0
AT2G43375	2	18017115	18018691	1576	-	85
AT2G43386	2	18019511	18019682	171	+	0
AT2G43390	2	18020349	18020861	512	-	1
AT2G43400	2	18021179	18025292	4113	+	604
AT2G43410	2	18025246	18031243	5997	-	929
AT2G43420	2	18031267	18035098	3831	-	447
AT2G43430	2	18035368	18038255	2887	-	439
AT2G43440	2	18039310	18040722	1412	+	39
AT2G43445	2	18041484	18043086	1602	+	42
AT2G43450	2	18043233	18044225	992	-	0
AT2G43460	2	18046003	18047401	1398	-	2753
AT2G43465	2	18047532	18049763	2231	-	149
AT2G43470	2	18049857	18051218	1361	-	2
AT2G43480	2	18053001	18054387	1386	+	0
AT2G43490	2	18054391	18058836	4445	-	277
AT2G43500	2	18061924	18066639	4715	+	556
AT2G43510	2	18067171	18067802	631	+	32
AT2G43520	2	18068424	18069168	744	+	18
AT2G43530	2	18070055	18070718	663	+	210
AT2G43535	2	18070972	18071676	704	+	75
AT2G43540	2	18072370	18072963	593	+	245
AT2G43550	2	18073233	18073905	672	+	449
AT2G43560	2	18073858	18075498	1640	-	4754
AT2G43570	2	18076223	18077463	1240	-	52
AT2G43580	2	18078648	18080028	1380	-	0
AT2G43590	2	18081330	18082767	1437	-	33
AT2G43600	2	18086048	18087018	970	-	8
AT2G43610	2	18087839	18089224	1385	-	28
AT2G43620	2	18093769	18095025	1256	-	25
AT2G43630	2	18095774	18097488	1714	+	1106
AT2G43640	2	18097399	18099136	1737	-	317
AT2G43650	2	18099237	18103345	4108	+	480
AT2G43660	2	18103750	18104581	831	-	2
AT2G43670	2	18105124	18106043	919	+	7
AT2G43680	2	18108348	18111831	3483	+	2578
AT2G43690	2	18112588	18114583	1995	+	34
AT2G43700	2	18115091	18118844	3753	+	67
AT2G43710	2	18119955	18122889	2934	+	5188
AT2G43720	2	18123266	18124338	1072	+	53
AT2G43730	2	18124647	18125868	1221	-	0
AT2G43740	2	18126577	18128293	1716	-	0
AT2G43745	2	18128528	18129841	1313	-	4
AT2G43750	2	18129434	18132637	3203	-	4418
AT2G43760	2	18132672	18134068	1396	+	518
AT2G43770	2	18134060	18136001	1941	-	535
AT2G43780	2	18136181	18137652	1471	-	202
AT2G43790	2	18138306	18140988	2682	+	984
AT2G43795	2	18140943	18142369	1426	-	0
AT2G43800	2	18145720	18148897	3177	+	646
AT2G43810	2	18149310	18151295	1985	+	363
AT2G43820	2	18152226	18153908	1682	+	230
AT2G43830	2	18154541	18156488	1947	-	13
AT2G43840	2	18157637	18159231	1594	+	38
AT2G43850	2	18159181	18162044	2863	-	217
AT2G43860	2	18162944	18164428	1484	-	0
AT2G43865	2	18165418	18165878	460	-	0
AT2G43870	2	18166614	18168264	1650	-	4
AT2G43871	2	18168703	18168829	126	+	0
AT2G43880	2	18173033	18174482	1449	+	0
AT2G43890	2	18176923	18178390	1467	+	0
AT2G43900	2	18178587	18183871	5284	-	694
AT2G43910	2	18184460	18187028	2568	-	4145
AT2G43920	2	18189007	18191348	2341	-	451
AT2G43930	2	18193150	18195582	2432	+	4
AT2G43932	2	18194949	18195425	476	-	3
AT2G43940	2	18195952	18197687	1735	-	138
AT2G43945	2	18197843	18200194	2351	-	3117
AT2G43950	2	18200323	18202729	2406	-	1048
AT2G43960	2	18203311	18204912	1601	-	1
AT2G43970	2	18205234	18208218	2984	-	8330
AT2G43980	2	18208252	18211644	3392	-	382
AT2G43990	2	18211923	18213922	1999	+	56
AT2G44000	2	18214323	18215571	1248	+	18
AT2G44010	2	18216683	18217438	755	+	1
AT2G44020	2	18217558	18219385	1827	-	129
AT2G44030	2	18220085	18221228	1143	+	0
AT2G44040	2	18221768	18224104	2336	-	788
AT2G44050	2	18224250	18226160	1910	+	1662
AT2G44060	2	18226316	18228151	1835	+	5361
AT2G44065	2	18228472	18231407	2935	+	406
AT2G44070	2	18231046	18232493	1447	-	0
AT2G44080	2	18237151	18238173	1022	+	22
AT2G44090	2	18238359	18241316	2957	-	1616
AT2G44100	2	18241691	18246498	4807	+	2605
AT2G44110	2	18245356	18248329	2973	-	0
AT2G44120	2	18249041	18251156	2115	-	2330
AT2G44130	2	18253609	18255054	1445	+	0
AT2G44140	2	18253496	18258035	4539	-	517
AT2G44150	2	18258609	18261442	2833	+	356
AT2G44160	2	18262209	18265346	3137	+	3833
AT2G44170	2	18265430	18267426	1996	-	3
AT2G44175	2	18268787	18269214	427	+	0
AT2G44180	2	18269242	18271860	2618	-	553
AT2G44190	2	18272190	18274497	2307	+	62
AT2G44195	2	18274805	18275792	987	+	2
AT2G44198	2	18276065	18276164	99	-	0
AT2G44200	2	18276209	18278627	2418	+	351
AT2G44210	2	18280622	18282876	2254	+	3584
AT2G44220	2	18283802	18285837	2035	+	0
AT2G44230	2	18286524	18288400	1876	+	956
AT2G44240	2	18289823	18292345	2522	+	0
AT2G44250	2	18293456	18295536	2080	+	2
AT2G44255	2	18295755	18297567	1812	-	0
AT2G44260	2	18295837	18297867	2030	+	29
AT2G44270	2	18297860	18300273	2413	-	252
AT2G44280	2	18301349	18304284	2935	-	158
AT2G44290	2	18305200	18306251	1051	-	446
AT2G44300	2	18307308	18308349	1041	-	113
AT2G44304	2	18308757	18308913	156	+	0
AT2G44310	2	18309211	18309826	615	+	813
AT2G44320	2	18309976	18310058	82	-	0
AT2G44330	2	18310585	18311185	600	+	0
AT2G44340	2	18314278	18314845	567	+	0
AT2G44350	2	18316277	18320789	4512	+	2172
AT2G44360	2	18320731	18321696	965	-	325
AT2G44370	2	18321993	18323121	1128	-	4
AT2G44380	2	18323460	18324428	968	-	32
AT2G44383	2	18324979	18325291	312	+	4
AT2G44390	2	18325810	18326551	741	-	0
AT2G44400	2	18327095	18327536	441	+	4
AT2G44410	2	18328416	18330336	1920	+	553
AT2G44420	2	18330472	18332913	2441	+	223
AT2G44430	2	18333546	18336364	2818	+	294
AT2G44440	2	18336399	18339214	2815	-	267
AT2G44450	2	18340920	18343849	2929	+	29
AT2G44460	2	18346438	18349966	3528	+	16
AT2G44470	2	18354185	18358679	4494	+	0
AT2G44480	2	18359733	18363088	3355	+	5
AT2G44490	2	18364755	18367725	2970	+	2146
AT2G44500	2	18374291	18376790	2499	+	142
AT2G44510	2	18377069	18379210	2141	+	78
AT2G44520	2	18379563	18381942	2379	+	647
AT2G44525	2	18382069	18383513	1444	+	410
AT2G44530	2	18383514	18386143	2629	+	802
AT2G44540	2	18386218	18388110	1892	-	0
AT2G44550	2	18389380	18391142	1762	-	0
AT2G44560	2	18391779	18393707	1928	-	0
AT2G44570	2	18394241	18396268	2027	-	9
AT2G44578	2	18400645	18401326	681	-	2
AT2G44580	2	18401877	18403416	1539	-	119
AT2G44581	2	18397995	18398433	438	-	0
AT2G44590	2	18403681	18407095	3414	-	7
AT2G44600	2	18408694	18410053	1359	+	131
AT2G44610	2	18411425	18414081	2656	-	1168
AT2G44620	2	18414250	18415303	1053	+	1693
AT2G44630	2	18415694	18416983	1289	-	27
AT2G44640	2	18417242	18419396	2154	+	899
AT2G44650	2	18419369	18421110	1741	-	2779
AT2G44660	2	18420831	18422839	2008	-	230
AT2G44670	2	18425179	18426060	881	+	1179
AT2G44680	2	18426545	18428357	1812	-	526
AT2G44690	2	18429263	18430804	1541	+	64
AT2G44700	2	18431014	18432121	1107	+	20
AT2G44710	2	18432718	18437132	4414	+	783
AT2G44730	2	18437332	18438565	1233	-	363
AT2G44735	2	18438622	18441641	3019	+	19
AT2G44740	2	18441988	18443399	1411	-	174
AT2G44745	2	18447272	18449009	1737	-	23
AT2G44750	2	18451425	18452875	1450	+	147
AT2G44760	2	18452850	18454809	1959	-	1013
AT2G44770	2	18457321	18460383	3062	+	489
AT2G44780	2	18460686	18461194	508	-	0
AT2G44790	2	18461905	18463309	1404	-	15
AT2G44798	2	18466463	18471277	4814	-	6
AT2G44800	2	18466819	18468551	1732	+	1
AT2G44810	2	18479052	18480197	1145	+	0
AT2G44820	2	18484350	18485816	1466	+	268
AT2G44830	2	18490128	18492816	2688	+	399
AT2G44840	2	18495340	18496272	932	+	9
AT2G44850	2	18498671	18500879	2208	+	68
AT2G44860	2	18500802	18502562	1760	-	656
AT2G44870	2	18503137	18504681	1544	+	2043
AT2G44880	2	18505238	18506906	1668	+	8
AT2G44890	2	18508270	18510364	2094	-	0
AT2G44900	2	18511718	18516408	4690	-	637
AT2G44910	2	18517886	18519525	1639	-	32
AT2G44920	2	18524386	18526827	2441	+	2431
AT2G44925	2	18527920	18528295	375	+	0
AT2G44930	2	18529522	18531752	2230	-	69
AT2G44940	2	18537256	18538418	1162	+	732
AT2G44950	2	18542212	18548591	6379	-	722
AT2G44970	2	18548812	18552159	3347	-	667
AT2G44980	2	18552191	18556669	4478	-	163
AT2G44990	2	18558937	18561621	2684	+	2
AT2G44995	2	18562101	18563678	1577	+	7
AT2G45000	2	18564110	18567735	3625	+	279
AT2G45010	2	18567909	18569859	1950	+	394
AT2G45020	2	18569910	18569983	73	+	0
AT2G45023	2	18570155	18572173	2018	-	93
AT2G45030	2	18572410	18576970	4560	+	253
AT2G45040	2	18577649	18578914	1265	+	5
AT2G45050	2	18582871	18584083	1212	+	68
AT2G45060	2	18584351	18586776	2425	-	409
AT2G45070	2	18587016	18588377	1361	-	1581
AT2G45080	2	18591664	18592455	791	+	50
AT2G45090	2	18593611	18594813	1202	-	0
AT2G45100	2	18595347	18598438	3091	-	248
AT2G45110	2	18599500	18601339	1839	+	0
AT2G45120	2	18603617	18604751	1134	+	15
AT2G45126	2	18605870	18605963	93	-	0
AT2G45130	2	18606409	18607853	1444	+	4
AT2G45135	2	18608823	18610574	1751	+	1
AT2G45140	2	18610805	18613290	2485	+	577
AT2G45150	2	18613304	18615717	2413	+	308
AT2G45160	2	18617861	18620150	2289	-	800
AT2G45161	2	18620464	18620590	126	+	0
AT2G45170	2	18624263	18625717	1454	+	471
AT2G45180	2	18626319	18626997	678	+	11675
AT2G45190	2	18628264	18630712	2448	-	778
AT2G45200	2	18637502	18640039	2537	-	441
AT2G45210	2	18641565	18642704	1139	+	7
AT2G45220	2	18644083	18646447	2364	-	3
AT2G45230	2	18651319	18655444	4125	-	0
AT2G45240	2	18655938	18659077	3139	+	496
AT2G45245	2	18659234	18661294	2060	-	41
AT2G45250	2	18661463	18663029	1566	+	270
AT2G45260	2	18664529	18666413	1884	-	306
AT2G45270	2	18666525	18669873	3348	+	689
AT2G45280	2	18670008	18672277	2269	+	92
AT2G45290	2	18672681	18675906	3225	+	249
AT2G45300	2	18677310	18680072	2762	+	1139
AT2G45310	2	18682080	18684042	1962	+	50
AT2G45315	2	18682107	18683827	1720	-	0
AT2G45320	2	18684115	18686145	2030	-	97
AT2G45330	2	18686311	18688035	1724	+	313
AT2G45340	2	18691721	18694725	3004	+	1608
AT2G45350	2	18694815	18696657	1842	-	55
AT2G45360	2	18698591	18699514	923	+	2
AT2G45380	2	18699427	18703093	3666	-	1016
AT2G45390	2	18703677	18703750	73	+	0
AT2G45400	2	18703828	18706266	2438	-	139
AT2G45403	2	18709536	18710153	617	+	10
AT2G45406	2	18710960	18711548	588	-	0
AT2G45410	2	18712286	18713116	830	-	0
AT2G45412	2	18714573	18714729	156	-	0
AT2G45420	2	18718347	18720729	2382	+	3
AT2G45430	2	18727560	18728935	1375	+	0
AT2G45434	2	18729732	18729843	111	+	0
AT2G45440	2	18730839	18733015	2176	+	589
AT2G45450	2	18733274	18734127	853	-	247
AT2G45460	2	18736827	18741841	5014	-	188
AT2G45470	2	18742539	18744111	1572	-	3204
AT2G45480	2	18745339	18747533	2194	+	63
AT2G45490	2	18747638	18749075	1437	-	32
AT2G45500	2	18749797	18752851	3054	-	290
AT2G45510	2	18753073	18755172	2099	+	83
AT2G45520	2	18755044	18756302	1258	-	544
AT2G45530	2	18756477	18757513	1036	+	280
AT2G45540	2	18757488	18772831	15343	-	2428
AT2G45550	2	18773540	18775654	2114	-	0
AT2G45560	2	18776051	18778510	2459	-	1023
AT2G45570	2	18779792	18781958	2166	-	3
AT2G45580	2	18782324	18784347	2023	-	0
AT2G45590	2	18786657	18788988	2331	+	1027
AT2G45600	2	18789587	18790952	1365	+	353
AT2G45610	2	18791462	18792586	1124	+	0
AT2G45620	2	18792863	18795904	3041	+	1205
AT2G45630	2	18795925	18797089	1164	+	205
AT2G45640	2	18799609	18801471	1862	-	852
AT2G45650	2	18804349	18806522	2173	+	1
AT2G45660	2	18807537	18811047	3510	-	684
AT2G45670	2	18814708	18818463	3755	-	1981
AT2G45680	2	18820241	18821889	1648	-	29
AT2G45685	2	18820690	18822184	1494	+	0
AT2G45690	2	18823170	18825735	2565	-	278
AT2G45695	2	18825992	18826879	887	+	173
AT2G45700	2	18826999	18830528	3529	-	586
AT2G45710	2	18831160	18832211	1051	+	302
AT2G45720	2	18833363	18836374	3011	+	260
AT2G45730	2	18836263	18839160	2897	-	494
AT2G45740	2	18839585	18841403	1818	+	3963
AT2G45750	2	18842538	18845467	2929	+	73
AT2G45760	2	18847006	18847821	815	-	6
AT2G45770	2	18851215	18853709	2494	+	1499
AT2G45780	2	18854554	18855184	630	-	1
AT2G45790	2	18855774	18858018	2244	+	1316
AT2G45800	2	18857940	18859189	1249	-	52
AT2G45810	2	18859598	18862918	3320	+	2085
AT2G45820	2	18862952	18864691	1739	-	3039
AT2G45830	2	18866060	18868542	2482	+	103
AT2G45840	2	18869260	18871561	2301	+	1
AT2G45850	2	18871478	18873972	2494	-	537
AT2G45860	2	18874759	18875586	827	-	241
AT2G45870	2	18875893	18877477	1584	+	76
AT2G45880	2	18878517	18882578	4061	-	409
AT2G45890	2	18883472	18885566	2094	+	46
AT2G45900	2	18886068	18888674	2606	-	227
AT2G45910	2	18894073	18898528	4455	+	647
AT2G45920	2	18899083	18901303	2220	+	198
AT2G45930	2	18901391	18902798	1407	-	5
AT2G45940	2	18903012	18904325	1313	+	1
AT2G45950	2	18904323	18907814	3491	-	540
AT2G45960	2	18910294	18911982	1688	+	27512
AT2G45970	2	18912259	18914739	2480	-	829
AT2G45980	2	18917351	18919109	1758	-	897
AT2G45990	2	18919315	18921511	2196	+	1725
AT2G46000	2	18921023	18922179	1156	-	86
AT2G46020	2	18923303	18931934	8631	+	2049
AT2G46030	2	18932018	18933507	1489	-	1070
AT2G46040	2	18935300	18938447	3147	-	118
AT2G46050	2	18939261	18941034	1773	+	3
AT2G46060	2	18941098	18945099	4001	-	417
AT2G46070	2	18945980	18947823	1843	-	371
AT2G46080	2	18948116	18950105	1989	-	735
AT2G46090	2	18950855	18953275	2420	+	578
AT2G46100	2	18953279	18954619	1340	+	1660
AT2G46110	2	18954569	18956530	1961	-	158
AT2G46120	2	18956640	18956713	73	+	0
AT2G46130	2	18957225	18957911	686	+	1
AT2G46140	2	18959077	18960547	1470	+	88
AT2G46150	2	18961402	18962376	974	+	18
AT2G46160	2	18963082	18963885	803	+	93
AT2G46170	2	18965312	18967213	1901	+	858
AT2G46180	2	18967358	18971350	3992	-	546
AT2G46190	2	18971798	18972804	1006	+	0
AT2G46192	2	18973306	18974133	827	+	50
AT2G46200	2	18974661	18976871	2210	-	108
AT2G46210	2	18977343	18979001	1658	+	65
AT2G46220	2	18979470	18980770	1300	+	3825
AT2G46225	2	18981910	18984292	2382	+	651
AT2G46230	2	18984198	18985959	1761	-	702
AT2G46240	2	18986132	18989947	3815	+	155
AT2G46250	2	18991170	18993327	2157	+	400
AT2G46255	2	18994631	18994856	225	+	0
AT2G46260	2	18995967	18998633	2666	+	648
AT2G46270	2	19000190	19003403	3213	+	177
AT2G46280	2	19003425	19005571	2146	-	1893
AT2G46290	2	19005770	19007879	2109	-	114
AT2G46300	2	19008290	19009558	1268	+	6
AT2G46308	2	19011166	19011355	189	-	0
AT2G46310	2	19011502	19012857	1355	+	74
AT2G46320	2	19015812	19018491	2679	+	454
AT2G46330	2	19018507	19019255	748	-	1266
AT2G46340	2	19022172	19027413	5241	-	3447
AT2G46360	2	19028487	19029015	528	+	0
AT2G46370	2	19033740	19036659	2919	+	1506
AT2G46375	2	19037863	19038379	516	+	8
AT2G46380	2	19039201	19042348	3147	+	228
AT2G46390	2	19042300	19043060	760	-	747
AT2G46400	2	19043413	19044826	1413	-	152
AT2G46410	2	19049171	19050341	1170	-	27
AT2G46420	2	19053685	19057096	3411	+	649
AT2G46430	2	19058129	19061436	3307	+	307
AT2G46440	2	19061860	19064881	3021	+	468
AT2G46450	2	19065715	19069569	3854	+	1302
AT2G46455	2	19069628	19071004	1376	-	7
AT2G46460	2	19071536	19072019	483	+	0
AT2G46470	2	19072312	19075123	2811	+	469
AT2G46480	2	19076404	19078386	1982	-	4
AT2G46490	2	19079405	19080053	648	+	399
AT2G46493	2	19080253	19081751	1498	-	0
AT2G46494	2	19082343	19083811	1468	-	0
AT2G46495	2	19084133	19085704	1571	-	0
AT2G46500	2	19086560	19089027	2467	-	862
AT2G46505	2	19089728	19090549	821	-	796
AT2G46510	2	19090952	19093315	2363	-	377
AT2G46520	2	19096767	19100272	3505	+	790
AT2G46530	2	19104664	19108331	3667	+	428
AT2G46535	2	19109619	19110497	878	+	178
AT2G46540	2	19110471	19111769	1298	-	708
AT2G46550	2	19111988	19114227	2239	-	1076
AT2G46560	2	19115370	19125856	10486	-	1612
AT2G46567	2	19126640	19126751	111	-	11
AT2G46570	2	19126871	19129069	2198	+	23
AT2G46572	2	19126871	19129105	2234	-	5
AT2G46580	2	19129240	19130595	1355	-	447
AT2G46590	2	19133039	19135289	2250	+	291
AT2G46600	2	19136018	19136600	582	+	1115
AT2G46610	2	19136565	19138762	2197	-	210
AT2G46620	2	19138800	19140747	1947	-	99
AT2G46630	2	19145528	19146713	1185	+	529
AT2G46640	2	19148661	19151080	2419	+	137
AT2G46650	2	19151645	19152600	955	+	1816
AT2G46660	2	19153327	19155489	2162	-	294
AT2G46662	2	19157901	19158042	141	-	0
AT2G46670	2	19164413	19165233	820	-	1
AT2G46680	2	19165402	19166949	1547	-	609
AT2G46685	2	19176125	19176261	136	+	0
AT2G46690	2	19180729	19181467	738	+	515
AT2G46700	2	19182669	19186578	3909	-	235
AT2G46710	2	19191934	19194849	2915	+	1375
AT2G46720	2	19197382	19200221	2839	+	38
AT2G46730	2	19200859	19203138	2279	+	110
AT2G46735	2	19204184	19205112	928	+	390
AT2G46740	2	19205156	19207455	2299	-	9
AT2G46750	2	19208319	19210958	2639	-	4
AT2G46760	2	19213027	19215166	2139	-	20
AT2G46770	2	19220726	19222916	2190	-	0
AT2G46780	2	19229292	19231505	2213	+	238
AT2G46787	2	19232376	19232523	147	+	0
AT2G46790	2	19232648	19235087	2439	+	1356
AT2G46800	2	19237433	19239405	1972	+	729
AT2G46810	2	19239693	19242672	2979	+	340
AT2G46820	2	19243495	19245141	1646	+	64402
AT2G46830	2	19245671	19248914	3243	+	4337
AT2G46840	2	19249190	19249909	719	-	3
AT2G46850	2	19251065	19253368	2303	+	0
AT2G46860	2	19253687	19255275	1588	+	0
AT2G46870	2	19260917	19262404	1487	+	294
AT2G46880	2	19264572	19266446	1874	-	0
AT2G46890	2	19266732	19268170	1438	-	154
AT2G46900	2	19269557	19272195	2638	+	593
AT2G46910	2	19272280	19274002	1722	+	1491
AT2G46915	2	19273898	19277773	3875	-	2150
AT2G46920	2	19277902	19281760	3858	-	382
AT2G46930	2	19283518	19286347	2829	+	706
AT2G46940	2	19286657	19287581	924	-	30
AT2G46950	2	19289137	19291614	2477	-	6
AT2G46960	2	19292048	19294260	2212	-	0
AT2G46970	2	19295489	19297826	2337	-	30
AT2G46980	2	19299491	19304191	4700	-	200
AT2G46990	2	19307854	19308990	1136	+	2
AT2G46995	2	19309467	19309584	117	-	0
AT2G47000	2	19309867	19315241	5374	-	103
AT2G47010	2	19317125	19319397	2272	+	231
AT2G47015	2	19319779	19321026	1247	+	3
AT2G47020	2	19319684	19322391	2707	-	49
AT2G47030	2	19324232	19326397	2165	-	0
AT2G47040	2	19327895	19330197	2302	-	0
AT2G47050	2	19331684	19332646	962	-	5
AT2G47060	2	19332903	19335031	2128	-	813
AT2G47070	2	19336694	19340869	4175	+	3256
AT2G47090	2	19341250	19344341	3091	-	260
AT2G47100	2	19344426	19344499	73	+	0
AT2G47110	2	19344634	19345345	711	+	0
AT2G47115	2	19344667	19346921	2254	-	0
AT2G47120	2	19347358	19348238	880	-	0
AT2G47130	2	19349535	19350539	1004	-	39
AT2G47140	2	19350739	19352088	1349	-	6
AT2G47150	2	19352323	19353114	791	-	1
AT2G47160	2	19357477	19361147	3670	-	1091
AT2G47170	2	19366622	19368840	2218	+	4680
AT2G47180	2	19368797	19370441	1644	-	242
AT2G47190	2	19376201	19377531	1330	+	2
AT2G47200	2	19377728	19378331	603	-	4
AT2G47210	2	19378868	19382418	3550	+	904
AT2G47220	2	19383742	19386954	3212	+	235
AT2G47230	2	19387019	19390234	3215	+	196
AT2G47240	2	19392557	19397831	5274	+	1604
AT2G47250	2	19399693	19403044	3351	-	1169
AT2G47260	2	19404819	19407084	2265	-	121
AT2G47270	2	19411559	19412151	592	-	0
AT2G47275	2	19415051	19415186	135	+	1
AT2G47280	2	19416774	19418383	1609	+	0
AT2G47300	2	19418470	19422241	3771	+	52
AT2G47310	2	19423683	19427277	3594	+	167
AT2G47320	2	19427371	19428933	1562	+	991
AT2G47330	2	19428896	19431720	2824	-	645
AT2G47340	2	19432167	19433104	937	+	0
AT2G47350	2	19433790	19437249	3459	+	283
AT2G47360	2	19437799	19438871	1072	+	13
AT2G47370	2	19438950	19440345	1395	-	276
AT2G47380	2	19440954	19442053	1099	+	598
AT2G47390	2	19441991	19446365	4374	-	2439
AT2G47400	2	19446853	19447438	585	+	14049
AT2G47410	2	19448138	19457294	9156	+	1133
AT2G47420	2	19457484	19458881	1397	+	342
AT2G47430	2	19459044	19464087	5043	-	0
AT2G47440	2	19469718	19471886	2168	+	1048
AT2G47450	2	19472680	19474314	1634	+	10187
AT2G47460	2	19476336	19479478	3142	+	15
AT2G47470	2	19481419	19484015	2596	+	2268
AT2G47480	2	19483918	19484642	724	-	7
AT2G47485	2	19485874	19486553	679	+	23
AT2G47490	2	19487245	19489619	2374	+	1123
AT2G47500	2	19492994	19498160	5166	+	665
AT2G47510	2	19498367	19502246	3879	+	1598
AT2G47520	2	19502801	19503569	768	-	3
AT2G47530	2	19504219	19504971	752	+	0
AT2G47540	2	19505859	19506598	739	+	0
AT2G47550	2	19508979	19511792	2813	+	1
AT2G47560	2	19511716	19512728	1012	-	23
AT2G47570	2	19515897	19517361	1464	-	3
AT2G47580	2	19517186	19518871	1685	+	725
AT2G47585	2	19520769	19520847	78	+	0
AT2G47590	2	19521796	19524063	2267	+	6746
AT2G47600	2	19524159	19527413	3254	-	758
AT2G47610	2	19529743	19531659	1916	+	4969
AT2G47620	2	19531946	19534401	2455	+	259
AT2G47630	2	19534502	19537014	2512	+	464
AT2G47640	2	19537177	19538624	1447	+	357
AT2G47650	2	19538609	19541473	2864	-	636
AT2G47660	2	19542951	19543160	209	+	0
AT2G47670	2	19543990	19544806	816	-	22
AT2G47680	2	19545827	19550905	5078	-	126
AT2G47690	2	19551262	19552358	1096	+	615
AT2G47700	2	19552313	19554584	2271	-	668
AT2G47710	2	19554833	19556065	1232	-	2445
AT2G47720	2	19556623	19557139	516	+	0
AT2G47730	2	19556325	19559463	3138	+	4061
AT2G47740	2	19559854	19559925	71	-	0
AT2G47750	2	19560126	19563191	3065	-	272
AT2G47760	2	19565481	19568265	2784	-	424
AT2G47770	2	19568463	19569507	1044	+	3
AT2G47780	2	19570048	19571034	986	+	25
AT2G47790	2	19570963	19573027	2064	-	277
AT2G47800	2	19574863	19580599	5736	+	899
AT2G47810	2	19582749	19583618	869	-	0
AT2G47820	2	19587136	19590822	3686	+	110
AT2G47830	2	19590855	19594014	3159	-	249
AT2G47840	2	19594186	19595001	815	-	846
AT2G47844	2	19595292	19595439	147	+	0
AT2G47850	2	19595639	19598581	2942	+	426
AT2G47860	2	19599947	19602192	2245	+	112
AT2G47870	2	19603338	19603650	312	+	10
AT2G47880	2	19605039	19605671	632	+	95
AT2G47890	2	19607995	19609645	1650	+	206
AT2G47895	2	19610472	19610962	490	+	3
AT2G47900	2	19610922	19613232	2310	-	805
AT2G47910	2	19614697	19615769	1072	+	866
AT2G47920	2	19615776	19616904	1128	+	77
AT2G47930	2	19616974	19617681	707	-	403
AT2G47940	2	19617985	19622251	4266	-	5741
AT2G47950	2	19624209	19624809	600	+	1
AT2G47960	2	19625613	19629183	3570	+	813
AT2G47970	2	19629473	19631182	1709	+	637
AT2G47980	2	19631258	19636978	5720	+	1130
AT2G47990	2	19636866	19638678	1812	-	229
AT2G48000	2	19639006	19640803	1797	-	382
AT2G48010	2	19641376	19643491	2115	+	155
AT2G48020	2	19644099	19647180	3081	+	1517
AT2G48030	2	19647522	19650148	2626	-	125
AT2G48060	2	19651195	19662617	11422	-	1312
AT2G48070	2	19662816	19664465	1649	+	1583
AT2G48075	2	19663915	19664767	852	-	10
AT2G48080	2	19664989	19667092	2103	-	11
AT2G48090	2	19669109	19669764	655	-	14
AT2G48100	2	19670500	19673292	2792	+	684
AT2G48110	2	19673292	19679711	6419	+	585
AT2G48120	2	19679729	19681546	1817	+	736
AT2G48121	2	19681636	19682391	755	+	9
AT2G48130	2	19685065	19685993	928	-	5
AT2G48140	2	19686408	19687664	1256	+	7
AT2G48150	2	19687961	19689173	1212	-	7
AT2G48160	2	19689408	19696821	7413	-	1863
AT3G01010	3	4341	4818	477	+	0
AT3G01015	3	1652	4159	2507	-	3
AT3G01020	3	5103	6049	946	+	0
AT3G01030	3	6656	7772	1116	+	1
AT3G01040	3	8956	12444	3488	+	630
AT3G01050	3	13229	14675	1446	+	393
AT3G01060	3	16642	18840	2198	-	5702
AT3G01070	3	19591	20719	1128	+	11
AT3G01080	3	25506	27449	1943	+	20
AT3G01085	3	27990	30718	2728	+	0
AT3G01090	3	31180	34597	3417	-	1124
AT3G01100	3	34718	38529	3811	-	755
AT3G01120	3	38758	41932	3174	-	11908
AT3G01130	3	44044	45590	1546	-	589
AT3G01140	3	46395	48296	1901	-	18
AT3G01142	3	46717	48296	1579	+	24
AT3G01150	3	51582	54506	2924	+	535
AT3G01160	3	54540	57462	2922	-	415
AT3G01170	3	57640	58909	1269	+	213
AT3G01175	3	59470	60845	1375	+	3
AT3G01180	3	62244	65845	3601	-	2552
AT3G01185	3	66150	66980	830	+	0
AT3G01190	3	67057	68536	1479	-	0
AT3G01200	3	69510	71362	1852	-	63
AT3G01202	3	69853	71415	1562	+	1
AT3G01210	3	71625	73220	1595	+	550
AT3G01220	3	73480	75538	2058	+	12
AT3G01230	3	76654	77411	757	-	0
AT3G01240	3	78375	79037	662	-	0
AT3G01250	3	79304	80105	801	+	0
AT3G01260	3	80175	82005	1830	-	1
AT3G01270	3	82684	84897	2213	-	0
AT3G01280	3	85600	87858	2258	+	3551
AT3G01290	3	88053	89422	1369	-	243
AT3G01300	3	90597	93585	2988	-	341
AT3G01310	3	94170	101992	7822	-	1635
AT3G01311	3	103042	104287	1245	-	0
AT3G01313	3	104686	104769	83	-	0
AT3G01316	3	104834	104909	75	-	0
AT3G01319	3	106295	106436	141	-	23
AT3G01320	3	106635	113618	6983	+	967
AT3G01322	3	114289	114604	315	+	0
AT3G01323	3	121056	121423	367	-	0
AT3G01324	3	122139	122448	309	-	0
AT3G01325	3	123368	123741	373	-	1
AT3G01326	3	115319	115756	437	+	0
AT3G01327	3	116230	116548	318	-	0
AT3G01328	3	117253	117568	315	-	0
AT3G01329	3	118872	119178	306	-	1
AT3G01330	3	124378	126835	2457	-	96
AT3G01331	3	119617	119917	300	-	0
AT3G01340	3	127347	128994	1647	-	973
AT3G01345	3	129137	130749	1612	+	6
AT3G01350	3	135023	137460	2437	+	42
AT3G01360	3	136398	138799	2401	-	190
AT3G01370	3	139010	143706	4696	+	2964
AT3G01380	3	144287	149828	5541	-	397
AT3G01390	3	149998	151539	1541	-	2657
AT3G01400	3	151761	153217	1456	+	216
AT3G01410	3	153355	155642	2287	-	141
AT3G01420	3	159465	162837	3372	-	0
AT3G01430	3	165407	166247	840	-	54
AT3G01435	3	166618	168288	1670	-	132
AT3G01440	3	168434	169618	1184	+	1189
AT3G01450	3	169596	172022	2426	-	135
AT3G01460	3	173315	182454	9139	+	670
AT3G01470	3	182395	184403	2008	-	0
AT3G01472	3	182395	184403	2008	-	0
AT3G01480	3	188383	190851	2468	+	11328
AT3G01490	3	190871	193537	2666	-	503
AT3G01500	3	194723	198019	3296	-	171853
AT3G01510	3	198678	201742	3064	-	1092
AT3G01513	3	201919	202740	821	-	0
AT3G01516	3	207335	208086	751	+	0
AT3G01520	3	208438	210137	1699	+	743
AT3G01530	3	210118	211804	1686	-	0
AT3G01540	3	212517	216671	4154	-	3000
AT3G01550	3	216806	219054	2248	-	1914
AT3G01560	3	219581	221879	2298	+	432
AT3G01570	3	221938	222827	889	-	7
AT3G01572	3	222967	223081	114	-	1
AT3G01580	3	223528	225511	1983	-	11
AT3G01590	3	225915	228623	2708	+	544
AT3G01600	3	229170	231105	1935	+	10
AT3G01610	3	231650	235214	3564	+	384
AT3G01620	3	235196	236925	1729	-	9
AT3G01630	3	237238	239113	1875	+	5
AT3G01640	3	239380	241443	2063	+	225
AT3G01650	3	242010	245268	3258	+	257
AT3G01660	3	245477	246508	1031	+	409
AT3G01670	3	247233	250470	3237	+	1738
AT3G01680	3	251980	255513	3533	+	1434
AT3G01690	3	256536	258547	2011	+	2170
AT3G01700	3	258878	259631	753	+	2
AT3G01705	3	259633	259705	72	+	0
AT3G01710	3	259638	261840	2202	-	197
AT3G01720	3	262250	265905	3655	-	442
AT3G01730	3	266557	266987	430	+	1
AT3G01740	3	267820	268838	1018	+	649
AT3G01750	3	270228	272976	2748	+	123
AT3G01760	3	273298	275270	1972	+	0
AT3G01770	3	275410	278785	3375	-	832
AT3G01780	3	279059	283580	4521	+	933
AT3G01790	3	283688	285778	2090	-	411
AT3G01800	3	285870	287950	2080	+	139
AT3G01810	3	288537	292755	4218	+	2009
AT3G01820	3	293753	295458	1705	-	310
AT3G01830	3	296053	299263	3210	+	3
AT3G01840	3	296581	298648	2067	-	4
AT3G01850	3	299986	302038	2052	-	440
AT3G01860	3	302644	304562	1918	+	503
AT3G01870	3	305130	307225	2095	+	2
AT3G01880	3	307781	309560	1779	+	0
AT3G01890	3	310014	311976	1962	+	219
AT3G01900	3	312358	313849	1491	-	0
AT3G01910	3	314693	317431	2738	-	2810
AT3G01920	3	317431	319121	1690	+	704
AT3G01930	3	319060	321560	2500	-	214
AT3G01940	3	322830	323053	223	-	20
AT3G01950	3	323976	324365	389	+	87
AT3G01960	3	324580	325087	507	-	147
AT3G01961	3	325180	325351	171	+	0
AT3G01970	3	326396	327412	1016	-	4
AT3G01980	3	327454	329031	1577	-	609
AT3G01990	3	330136	332262	2126	+	72
AT3G02000	3	332274	333022	748	-	19
AT3G02010	3	337964	340442	2478	+	20
AT3G02020	3	340545	343835	3290	-	3572
AT3G02030	3	344907	348847	3940	+	132
AT3G02040	3	348166	350010	1844	-	114
AT3G02050	3	350615	354345	3730	+	1233
AT3G02060	3	354359	358833	4474	+	698
AT3G02065	3	358915	360889	1974	+	384
AT3G02070	3	360920	363429	2509	+	152
AT3G02080	3	363880	365275	1395	-	2927
AT3G02090	3	365548	368911	3363	+	4769
AT3G02100	3	368839	370484	1645	-	0
AT3G02110	3	370761	373722	2961	-	708
AT3G02120	3	377096	377713	617	+	165
AT3G02125	3	378204	379612	1408	+	1
AT3G02130	3	380725	384405	3680	+	786
AT3G02140	3	385316	386538	1222	-	12
AT3G02150	3	391056	392758	1702	+	280
AT3G02160	3	394069	395984	1915	+	58
AT3G02170	3	396011	399779	3768	-	1272
AT3G02180	3	404732	405656	924	+	927
AT3G02190	3	405815	406401	586	-	193
AT3G02200	3	406593	409163	2570	+	1432
AT3G02210	3	409200	411652	2452	-	179
AT3G02220	3	412068	413634	1566	-	583
AT3G02230	3	415392	417547	2155	+	1416
AT3G02240	3	418458	419164	706	+	0
AT3G02242	3	420107	420680	573	+	0
AT3G02250	3	423800	427061	3261	-	1229
AT3G02260	3	430983	448489	17506	-	4253
AT3G02270	3	448976	451007	2031	-	0
AT3G02280	3	453420	457841	4421	+	269
AT3G02290	3	458411	461019	2608	+	318
AT3G02300	3	461147	464174	3027	+	1306
AT3G02310	3	464278	467074	2796	-	0
AT3G02315	3	469659	469733	74	+	0
AT3G02320	3	469933	473717	3784	+	273
AT3G02330	3	473880	476592	2712	-	22
AT3G02335	3	476801	476873	72	+	0
AT3G02340	3	477002	478442	1440	+	216
AT3G02350	3	479005	481474	2469	+	1199
AT3G02360	3	481897	484147	2250	+	2366
AT3G02370	3	484490	485614	1124	+	65
AT3G02380	3	487235	488693	1458	-	2415
AT3G02390	3	488779	489474	695	+	24
AT3G02400	3	489829	491587	1758	+	154
AT3G02410	3	492117	494948	2831	-	39
AT3G02420	3	495884	498841	2957	-	368
AT3G02430	3	499344	500174	830	+	0
AT3G02440	3	500803	502229	1426	-	0
AT3G02450	3	502706	505230	2524	-	1728
AT3G02460	3	505433	508428	2995	+	374
AT3G02468	3	509086	511557	2471	+	0
AT3G02470	3	508885	511561	2676	+	10
AT3G02480	3	512311	513027	716	+	7
AT3G02490	3	513524	515925	2401	+	168
AT3G02493	3	515943	516358	415	-	2
AT3G02500	3	519363	521747	2384	+	50
AT3G02510	3	521745	524631	2886	-	308
AT3G02515	3	525369	526255	886	+	32
AT3G02520	3	526436	528313	1877	-	1315
AT3G02530	3	528573	532582	4009	-	1008
AT3G02540	3	532807	536342	3535	-	1992
AT3G02550	3	536504	537998	1494	-	133
AT3G02555	3	539638	541503	1865	-	105
AT3G02560	3	541714	543385	1671	+	2440
AT3G02570	3	543345	545595	2250	-	1116
AT3G02580	3	546902	548795	1893	+	498
AT3G02590	3	549339	550553	1214	+	0
AT3G02600	3	551099	554671	3572	+	788
AT3G02610	3	555625	557723	2098	+	5
AT3G02620	3	560255	561880	1625	+	5
AT3G02630	3	562029	564870	2841	+	787
AT3G02640	3	564883	565708	825	-	371
AT3G02645	3	566270	567860	1590	+	2
AT3G02650	3	568046	570103	2057	+	263
AT3G02660	3	570133	572345	2212	-	812
AT3G02670	3	573779	574626	847	-	4
AT3G02680	3	576377	579559	3182	+	91
AT3G02690	3	579585	581611	2026	+	2075
AT3G02700	3	581540	582949	1409	-	417
AT3G02710	3	583112	585948	2836	+	524
AT3G02715	3	586085	586167	82	+	0
AT3G02720	3	586223	588365	2142	+	1730
AT3G02730	3	588407	589685	1278	-	11176
AT3G02740	3	590447	593186	2739	+	600
AT3G02750	3	593206	596520	3314	-	1533
AT3G02760	3	597358	600650	3292	-	1203
AT3G02770	3	600892	602259	1367	-	460
AT3G02780	3	602432	604684	2252	-	1588
AT3G02790	3	604844	605421	577	+	307
AT3G02800	3	606470	607886	1416	-	28
AT3G02810	3	608459	610985	2526	-	0
AT3G02820	3	611523	613448	1925	+	106
AT3G02830	3	613801	616144	2343	+	4187
AT3G02832	3	616379	617322	943	+	13
AT3G02840	3	618408	619686	1278	+	4
AT3G02850	3	619677	623558	3881	-	35
AT3G02860	3	625162	627367	2205	-	449
AT3G02870	3	627511	629845	2334	-	2003
AT3G02875	3	631912	634074	2162	+	146
AT3G02880	3	634652	637284	2632	+	661
AT3G02885	3	638020	639055	1035	-	42
AT3G02890	3	640275	645692	5417	+	495
AT3G02900	3	645775	647684	1909	+	687
AT3G02910	3	649813	650921	1108	+	347
AT3G02920	3	650596	654350	3754	-	176
AT3G02930	3	655055	658637	3582	+	218
AT3G02940	3	661872	664006	2134	+	0
AT3G02950	3	665357	666907	1550	-	330
AT3G02960	3	667244	668626	1382	-	0
AT3G02970	3	669102	670541	1439	-	0
AT3G02980	3	670896	672215	1319	-	33
AT3G02990	3	673471	676403	2932	+	79
AT3G03000	3	677239	678084	845	+	51
AT3G03010	3	678687	680605	1918	-	169
AT3G03020	3	680943	681999	1056	+	199
AT3G03030	3	682053	684069	2016	+	75
AT3G03040	3	684505	686544	2039	+	380
AT3G03050	3	687051	691898	4847	+	530
AT3G03060	3	692055	695648	3593	+	145
AT3G03070	3	696298	698156	1858	-	1375
AT3G03080	3	698529	700301	1772	-	1
AT3G03090	3	700455	704769	4314	-	401
AT3G03100	3	705380	707651	2271	-	1746
AT3G03110	3	708935	717093	8158	+	408
AT3G03120	3	717152	719315	2163	+	173
AT3G03130	3	721290	723646	2356	-	173
AT3G03140	3	723877	727502	3625	+	210
AT3G03150	3	727553	729504	1951	-	2087
AT3G03160	3	729767	730467	700	+	407
AT3G03170	3	731890	732875	985	+	17
AT3G03180	3	733386	734483	1097	+	86
AT3G03190	3	735027	735987	960	+	450
AT3G03200	3	736140	738527	2387	-	23
AT3G03210	3	740769	742309	1540	+	147
AT3G03220	3	742353	744047	1694	-	226
AT3G03230	3	744388	746009	1621	-	1
AT3G03240	3	746654	748600	1946	-	2
AT3G03250	3	749389	754159	4770	-	3971
AT3G03260	3	755158	759282	4124	-	2
AT3G03270	3	761309	763115	1806	-	361
AT3G03272	3	763656	764437	781	-	1
AT3G03280	3	765458	766387	929	+	1
AT3G03290	3	766744	767742	998	+	0
AT3G03300	3	767925	776214	8289	-	809
AT3G03305	3	775367	778396	3029	-	245
AT3G03310	3	778567	781580	3013	-	305
AT3G03320	3	781714	783464	1750	+	181
AT3G03330	3	783331	786209	2878	-	435
AT3G03340	3	786319	790077	3758	+	525
AT3G03341	3	790129	790648	519	-	24
AT3G03350	3	791182	794812	3630	+	138
AT3G03360	3	794905	797013	2108	+	230
AT3G03370	3	797253	799148	1895	-	92
AT3G03380	3	799614	808522	8908	+	1540
AT3G03400	3	808744	809158	414	-	0
AT3G03405	3	809874	810795	921	-	0
AT3G03410	3	811323	811719	396	-	0
AT3G03420	3	812447	814027	1580	+	183
AT3G03430	3	814472	814732	260	+	0
AT3G03440	3	815643	818834	3191	+	226
AT3G03450	3	819336	821406	2070	-	276
AT3G03456	3	822440	822542	102	-	0
AT3G03460	3	822936	824546	1610	-	82
AT3G03470	3	824551	826437	1886	-	463
AT3G03480	3	828295	829896	1601	-	64
AT3G03490	3	830164	831888	1724	-	246
AT3G03500	3	832928	834350	1422	+	2
AT3G03510	3	836038	837707	1669	+	0
AT3G03520	3	837876	840624	2748	-	207
AT3G03530	3	842498	845043	2545	-	21
AT3G03540	3	846349	848297	1948	-	0
AT3G03550	3	850107	851590	1483	-	188
AT3G03560	3	852909	856486	3577	-	668
AT3G03570	3	856875	860469	3594	+	338
AT3G03580	3	860511	863352	2841	-	55
AT3G03590	3	865182	867008	1826	-	118
AT3G03600	3	867659	868578	919	-	322
AT3G03610	3	868790	871812	3022	+	177
AT3G03620	3	873748	876800	3052	-	1
AT3G03626	3	877500	877629	129	-	0
AT3G03630	3	877927	880446	2519	-	423
AT3G03640	3	881005	884157	3152	+	662
AT3G03650	3	884132	886410	2278	-	0
AT3G03660	3	889508	892162	2654	-	0
AT3G03670	3	901840	903411	1571	-	0
AT3G03680	3	907499	910807	3308	+	294
AT3G03690	3	911237	913677	2440	-	196
AT3G03700	3	916434	918490	2056	+	3
AT3G03702	3	916355	918834	2479	-	49
AT3G03710	3	919541	925338	5797	+	1977
AT3G03720	3	925611	930974	5363	-	846
AT3G03726	3	933340	934464	1124	-	0
AT3G03730	3	935138	936320	1182	-	0
AT3G03740	3	936877	939808	2931	-	580
AT3G03750	3	939951	942094	2143	+	124
AT3G03760	3	943556	944834	1278	+	0
AT3G03770	3	945134	949042	3908	-	2508
AT3G03773	3	951627	953840	2213	+	204
AT3G03776	3	954143	954760	617	-	7
AT3G03780	3	957084	960980	3896	+	11474
AT3G03790	3	961996	968149	6153	+	1433
AT3G03800	3	969106	971460	2354	+	1
AT3G03810	3	971671	976367	4696	-	404
AT3G03820	3	976932	977223	291	-	163
AT3G03826	3	978264	978570	306	+	0
AT3G03828	3	979378	979900	522	+	0
AT3G03830	3	979983	980488	505	-	42
AT3G03840	3	981071	981798	727	+	91
AT3G03845	3	981968	982040	72	+	0
AT3G03847	3	982191	982587	396	-	1
AT3G03850	3	983120	983751	631	+	71
AT3G03852	3	984098	984170	72	+	0
AT3G03855	3	986947	990738	3791	+	93
AT3G03860	3	992127	994580	2453	+	675
AT3G03870	3	995216	997410	2194	+	594
AT3G03880	3	997796	999261	1465	+	221
AT3G03890	3	999466	1002484	3018	-	1320
AT3G03900	3	1002974	1004271	1297	-	164
AT3G03910	3	1006841	1009018	2177	+	57
AT3G03920	3	1008994	1010480	1486	-	620
AT3G03930	3	1011413	1012810	1397	-	0
AT3G03940	3	1014024	1019224	5200	-	1559
AT3G03950	3	1021259	1024009	2750	+	581
AT3G03960	3	1024257	1027891	3634	+	1879
AT3G03970	3	1027996	1030605	2609	-	118
AT3G03980	3	1031741	1033207	1466	+	332
AT3G03990	3	1033767	1034906	1139	+	834
AT3G04000	3	1035499	1036672	1173	+	65
AT3G04010	3	1036840	1039482	2642	-	14
AT3G04020	3	1040547	1042518	1971	+	89
AT3G04030	3	1042881	1044698	1817	-	320
AT3G04040	3	1047639	1049260	1621	+	52
AT3G04050	3	1049794	1051522	1728	+	28
AT3G04060	3	1053365	1055163	1798	-	32
AT3G04070	3	1061525	1063103	1578	-	18
AT3G04080	3	1067789	1071295	3506	-	482
AT3G04090	3	1072091	1074160	2069	-	1140
AT3G04100	3	1075298	1075922	624	+	0
AT3G04110	3	1077327	1080405	3078	+	319
AT3G04120	3	1080949	1083530	2581	+	13975
AT3G04130	3	1083973	1086385	2412	+	93
AT3G04140	3	1086876	1089229	2353	+	966
AT3G04150	3	1089416	1090468	1052	-	0
AT3G04160	3	1091146	1094346	3200	-	236
AT3G04170	3	1094620	1095665	1045	-	0
AT3G04180	3	1097474	1098422	948	-	0
AT3G04181	3	1098838	1099452	614	+	4
AT3G04184	3	1100084	1100246	162	-	13
AT3G04190	3	1101877	1102763	886	-	0
AT3G04200	3	1103615	1104601	986	-	3
AT3G04210	3	1105962	1108069	2107	-	1197
AT3G04220	3	1109117	1112188	3071	-	5
AT3G04230	3	1112989	1113659	670	-	126
AT3G04240	3	1113933	1120872	6939	-	1779
AT3G04250	3	1121949	1122828	879	+	0
AT3G04260	3	1123022	1127515	4493	-	2058
AT3G04270	3	1127903	1128080	177	-	0
AT3G04280	3	1129943	1131094	1151	-	0
AT3G04290	3	1133319	1136316	2997	-	2054
AT3G04300	3	1140192	1141030	838	+	5
AT3G04310	3	1141580	1142528	948	-	145
AT3G04320	3	1143790	1144661	871	+	0
AT3G04330	3	1145756	1146365	609	+	0
AT3G04340	3	1146799	1153341	6542	-	3288
AT3G04350	3	1153726	1156776	3050	-	365
AT3G04360	3	1157003	1158310	1307	-	0
AT3G04370	3	1159422	1161126	1704	+	1
AT3G04380	3	1161386	1164929	3543	+	122
AT3G04390	3	1165374	1165765	391	-	0
AT3G04400	3	1167275	1168659	1384	+	6711
AT3G04410	3	1168836	1169205	369	+	0
AT3G04420	3	1172745	1174467	1722	+	12
AT3G04430	3	1175505	1176986	1481	-	0
AT3G04440	3	1178717	1180700	1983	+	10
AT3G04445	3	1181705	1183041	1336	+	5
AT3G04450	3	1181705	1186360	4655	+	139
AT3G04460	3	1186483	1189478	2995	+	333
AT3G04470	3	1189639	1192638	2999	-	1082
AT3G04480	3	1193629	1197397	3768	-	901
AT3G04485	3	1198113	1200104	1991	+	130
AT3G04490	3	1200641	1209869	9228	+	718
AT3G04500	3	1211761	1213855	2094	-	653
AT3G04510	3	1215635	1216958	1323	-	36
AT3G04520	3	1217238	1219771	2533	-	631
AT3G04525	3	1220228	1220301	73	+	0
AT3G04530	3	1221545	1222655	1110	+	1
AT3G04540	3	1223250	1223714	464	+	0
AT3G04545	3	1224965	1225325	360	+	0
AT3G04550	3	1225921	1227436	1515	+	2696
AT3G04560	3	1227359	1229408	2049	-	288
AT3G04570	3	1230985	1232328	1343	+	2
AT3G04580	3	1235282	1238493	3211	-	378
AT3G04590	3	1238852	1241640	2788	-	910
AT3G04600	3	1242972	1246211	3239	+	681
AT3G04605	3	1246668	1250395	3727	+	717
AT3G04610	3	1250552	1254873	4321	-	842
AT3G04620	3	1255525	1256869	1344	-	40
AT3G04630	3	1258544	1260871	2327	+	809
AT3G04640	3	1260905	1261683	778	-	27
AT3G04650	3	1261983	1264622	2639	+	663
AT3G04660	3	1264725	1265966	1241	+	0
AT3G04670	3	1266241	1268350	2109	-	328
AT3G04680	3	1269852	1272962	3110	-	363
AT3G04690	3	1273171	1276008	2837	-	182
AT3G04700	3	1276667	1277824	1157	+	13
AT3G04710	3	1276667	1281118	4451	+	256
AT3G04715	3	1281642	1282551	909	-	0
AT3G04717	3	1284850	1285293	443	-	0
AT3G04720	3	1285523	1286562	1039	-	190
AT3G04721	3	1286926	1287097	171	-	0
AT3G04730	3	1288611	1290602	1991	-	2928
AT3G04732	3	1291615	1291774	159	+	0
AT3G04735	3	1292407	1292725	318	-	0
AT3G04740	3	1293806	1300714	6908	+	699
AT3G04750	3	1301390	1303376	1986	-	177
AT3G04760	3	1303574	1305878	2304	-	1600
AT3G04765	3	1306621	1306781	160	-	0
AT3G04770	3	1309293	1310887	1594	-	154
AT3G04780	3	1311246	1313090	1844	-	409
AT3G04790	3	1313315	1315243	1928	+	8847
AT3G04800	3	1314478	1315045	567	-	0
AT3G04810	3	1317259	1321294	4035	+	701
AT3G04820	3	1321227	1325953	4726	-	230
AT3G04830	3	1326226	1329364	3138	+	1025
AT3G04840	3	1329664	1331617	1953	+	5962
AT3G04850	3	1331945	1335993	4048	-	99
AT3G04854	3	1337266	1337377	111	+	3
AT3G04855	3	1337785	1337920	135	-	0
AT3G04860	3	1339103	1340623	1520	-	139
AT3G04870	3	1342607	1346387	3780	+	4130
AT3G04880	3	1346272	1347377	1105	-	529
AT3G04890	3	1347645	1349202	1557	+	563
AT3G04900	3	1349301	1349928	627	-	0
AT3G04903	3	1350509	1350989	480	+	0
AT3G04910	3	1354634	1358219	3585	+	1749
AT3G04920	3	1360881	1362295	1414	+	3189
AT3G04930	3	1362904	1364799	1895	+	645
AT3G04940	3	1365164	1367759	2595	+	1216
AT3G04943	3	1368247	1368678	431	-	0
AT3G04945	3	1369113	1369532	419	-	0
AT3G04950	3	1371704	1373477	1773	+	43
AT3G04960	3	1373687	1375892	2205	+	56
AT3G04970	3	1376174	1378500	2326	+	157
AT3G04980	3	1378683	1382181	3498	-	106
AT3G04990	3	1383995	1384679	684	-	0
AT3G04997	3	1386497	1386629	132	-	0
AT3G05000	3	1387174	1388756	1582	-	322
AT3G05010	3	1389448	1391675	2227	+	327
AT3G05020	3	1391631	1392954	1323	-	379
AT3G05030	3	1393295	1397358	4063	-	1262
AT3G05040	3	1401270	1408197	6927	-	460
AT3G05050	3	1408612	1411803	3191	-	573
AT3G05060	3	1412866	1415966	3100	-	996
AT3G05070	3	1416147	1417806	1659	+	487
AT3G05080	3	1417906	1418280	374	+	0
AT3G05090	3	1417892	1423664	5772	-	1037
AT3G05100	3	1424092	1426000	1908	+	522
AT3G05110	3	1426296	1427719	1423	-	3
AT3G05120	3	1430470	1432778	2308	+	326
AT3G05130	3	1433474	1435379	1905	-	119
AT3G05140	3	1435697	1438341	2644	-	66
AT3G05150	3	1440072	1443530	3458	+	9
AT3G05152	3	1443966	1445087	1121	+	6
AT3G05155	3	1448569	1451213	2644	+	0
AT3G05160	3	1453105	1457150	4045	-	290
AT3G05165	3	1457380	1462942	5562	-	796
AT3G05170	3	1466572	1468400	1828	+	63
AT3G05180	3	1468397	1470551	2154	-	622
AT3G05190	3	1471396	1475784	4388	+	156
AT3G05193	3	1476175	1476328	153	-	0
AT3G05200	3	1476981	1478730	1749	+	152
AT3G05210	3	1479537	1482042	2505	+	378
AT3G05220	3	1488594	1491320	2726	+	1332
AT3G05230	3	1492141	1493619	1478	+	217
AT3G05240	3	1493683	1495381	1698	-	10
AT3G05250	3	1495596	1497469	1873	+	180
AT3G05260	3	1497482	1499004	1522	-	2
AT3G05270	3	1500802	1503407	2605	-	610
AT3G05280	3	1503757	1505654	1897	-	536
AT3G05290	3	1505889	1507702	1813	-	318
AT3G05300	3	1508023	1508611	588	-	0
AT3G05310	3	1510159	1513301	3142	+	2
AT3G05320	3	1513449	1514895	1446	-	69
AT3G05327	3	1517418	1518554	1136	-	20
AT3G05330	3	1518881	1521494	2613	-	171
AT3G05340	3	1523462	1526166	2704	-	90
AT3G05345	3	1522448	1523889	1441	-	603
AT3G05350	3	1526962	1533867	6905	-	2057
AT3G05360	3	1530734	1533288	2554	-	38
AT3G05370	3	1536013	1538719	2706	-	376
AT3G05380	3	1539526	1546469	6943	+	313
AT3G05390	3	1546442	1548300	1858	-	1
AT3G05400	3	1549585	1554176	4591	+	31
AT3G05410	3	1554699	1561535	6836	+	491
AT3G05415	3	1555536	1560588	5052	-	54
AT3G05420	3	1561777	1567318	5541	+	1112
AT3G05425	3	1567473	1567605	132	+	0
AT3G05430	3	1567624	1571072	3448	+	86
AT3G05440	3	1572717	1573266	549	+	0
AT3G05450	3	1573908	1576418	2510	-	0
AT3G05460	3	1577799	1578734	935	+	0
AT3G05470	3	1579666	1582547	2881	-	188
AT3G05480	3	1585301	1588722	3421	+	70
AT3G05490	3	1591276	1591983	707	+	248
AT3G05500	3	1593433	1595015	1582	+	820
AT3G05510	3	1595368	1598271	2903	+	119
AT3G05520	3	1598546	1601437	2891	+	538
AT3G05525	3	1601337	1601409	72	-	0
AT3G05530	3	1603399	1606231	2832	+	2495
AT3G05540	3	1606486	1608030	1544	-	0
AT3G05545	3	1609210	1612523	3313	+	1156
AT3G05550	3	1612859	1613748	889	+	12
AT3G05560	3	1614177	1615506	1329	+	2708
AT3G05570	3	1616101	1617339	1238	-	151
AT3G05580	3	1617846	1620120	2274	-	207
AT3G05590	3	1621456	1623014	1558	+	6059
AT3G05600	3	1623243	1624763	1520	-	229
AT3G05602	3	1624977	1625100	123	-	0
AT3G05610	3	1625671	1628173	2502	-	0
AT3G05620	3	1629657	1631766	2109	-	49
AT3G05625	3	1632283	1634139	1856	+	553
AT3G05630	3	1635199	1640348	5149	+	89
AT3G05640	3	1640392	1643253	2861	-	732
AT3G05650	3	1645679	1648573	2894	-	336
AT3G05660	3	1648842	1652001	3159	-	94
AT3G05670	3	1653263	1657159	3896	+	735
AT3G05675	3	1658215	1660368	2153	-	123
AT3G05680	3	1660522	1672522	12000	-	1263
AT3G05685	3	1673779	1674908	1129	-	31
AT3G05690	3	1676545	1678932	2387	-	137
AT3G05700	3	1682087	1684572	2485	-	333
AT3G05710	3	1684995	1687558	2563	+	362
AT3G05720	3	1687991	1691736	3745	-	1
AT3G05725	3	1692509	1693330	821	+	0
AT3G05727	3	1693551	1694138	587	+	500
AT3G05730	3	1695975	1696708	733	+	2405
AT3G05740	3	1698111	1701399	3288	+	102
AT3G05741	3	1701377	1702180	803	-	0
AT3G05746	3	1703249	1703408	159	+	1
AT3G05750	3	1704119	1707678	3559	+	481
AT3G05755	3	1707737	1707809	72	-	0
AT3G05760	3	1707796	1710038	2242	+	380
AT3G05770	3	1710012	1712165	2153	-	0
AT3G05780	3	1714940	1719608	4668	-	0
AT3G05790	3	1720153	1725182	5029	-	23
AT3G05800	3	1727305	1728296	991	+	90
AT3G05810	3	1730975	1732384	1409	-	174
AT3G05820	3	1732990	1735757	2767	-	14
AT3G05830	3	1736676	1738664	1988	+	208
AT3G05835	3	1738790	1738864	74	+	0
AT3G05840	3	1739980	1743163	3183	+	2671
AT3G05850	3	1743412	1746785	3373	-	331
AT3G05858	3	1749341	1749871	530	+	3
AT3G05860	3	1751405	1752355	950	-	0
AT3G05870	3	1753466	1755631	2165	+	58
AT3G05880	3	1755496	1756540	1044	-	361
AT3G05890	3	1757630	1758492	862	-	45
AT3G05900	3	1761204	1763984	2780	-	227
AT3G05905	3	1760904	1764212	3308	+	0
AT3G05910	3	1764317	1767620	3303	-	1892
AT3G05920	3	1768789	1769586	797	-	0
AT3G05930	3	1770336	1771409	1073	+	3
AT3G05932	3	1770278	1771716	1438	-	72
AT3G05935	3	1771961	1772599	638	-	168
AT3G05936	3	1773831	1774589	758	-	85
AT3G05937	3	1775901	1776775	874	-	43
AT3G05940	3	1777363	1780254	2891	-	189
AT3G05950	3	1781066	1782007	941	-	0
AT3G05960	3	1783586	1785334	1748	-	0
AT3G05970	3	1786317	1791802	5485	-	732
AT3G05975	3	1792144	1792714	570	-	0
AT3G05980	3	1795336	1796486	1150	+	19
AT3G05990	3	1796851	1799870	3019	-	313
AT3G06000	3	1801445	1802081	636	+	0
AT3G06010	3	1802227	1807478	5251	-	723
AT3G06019	3	1813113	1813224	111	-	1
AT3G06020	3	1813266	1814169	903	+	69
AT3G06030	3	1818739	1822840	4101	-	234
AT3G06035	3	1823098	1824216	1118	-	414
AT3G06040	3	1824375	1825663	1288	-	524
AT3G06050	3	1826072	1827861	1789	-	1686
AT3G06060	3	1827979	1830200	2221	-	506
AT3G06070	3	1831056	1831923	867	-	659
AT3G06080	3	1834706	1837984	3278	-	1275
AT3G06090	3	1840772	1841012	240	+	4
AT3G06100	3	1841170	1843093	1923	-	7
AT3G06105	3	1843323	1843394	71	-	0
AT3G06110	3	1843412	1845014	1602	+	311
AT3G06120	3	1846530	1848230	1700	+	51
AT3G06125	3	1848847	1850596	1749	+	821
AT3G06130	3	1852883	1855063	2180	-	661
AT3G06140	3	1856681	1858855	2174	-	155
AT3G06142	3	1859376	1859526	150	+	0
AT3G06145	3	1859923	1860650	727	-	411
AT3G06150	3	1861796	1864116	2320	-	685
AT3G06160	3	1864272	1867267	2995	+	47
AT3G06170	3	1867414	1869948	2534	+	758
AT3G06180	3	1871687	1873771	2084	+	93
AT3G06190	3	1874290	1876913	2623	-	592
AT3G06200	3	1877593	1879348	1755	+	340
AT3G06210	3	1880092	1883491	3399	+	259
AT3G06220	3	1883615	1884953	1338	-	14
AT3G06230	3	1885495	1886377	882	+	0
AT3G06240	3	1887042	1888750	1708	+	240
AT3G06250	3	1888835	1892775	3940	-	377
AT3G06260	3	1893472	1894859	1387	-	3
AT3G06270	3	1896136	1898034	1898	+	254
AT3G06280	3	1898154	1898751	597	-	0
AT3G06290	3	1899041	1907297	8256	-	793
AT3G06300	3	1907581	1909804	2223	+	251
AT3G06310	3	1912804	1914408	1604	-	471
AT3G06320	3	1914510	1915318	808	+	139
AT3G06330	3	1917239	1919925	2686	+	726
AT3G06335	3	1920032	1920104	72	-	0
AT3G06340	3	1920206	1923738	3532	-	347
AT3G06350	3	1924309	1927759	3450	-	1832
AT3G06360	3	1928901	1929446	545	+	12
AT3G06370	3	1930395	1934073	3678	-	169
AT3G06380	3	1936123	1938221	2098	+	643
AT3G06390	3	1938731	1939779	1048	-	3
AT3G06400	3	1940972	1946924	5952	+	1867
AT3G06410	3	1947239	1949789	2550	-	530
AT3G06420	3	1954989	1956397	1408	-	117
AT3G06430	3	1956408	1958299	1891	-	814
AT3G06433	3	1958900	1962344	3444	+	128
AT3G06435	3	1969120	1970784	1664	-	39
AT3G06437	3	1970996	1972455	1459	-	0
AT3G06440	3	1972621	1975754	3133	-	431
AT3G06450	3	1975958	1980036	4078	-	496
AT3G06455	3	1980541	1982162	1621	+	62
AT3G06460	3	1982658	1983714	1056	+	2
AT3G06470	3	1984167	1985259	1092	+	416
AT3G06480	3	1985454	1990153	4699	-	768
AT3G06483	3	1990415	1992744	2329	-	1762
AT3G06490	3	2003392	2006624	3232	+	5
AT3G06500	3	2012078	2015705	3627	+	887
AT3G06510	3	2016329	2019778	3449	+	4311
AT3G06520	3	2020283	2021955	1672	+	71
AT3G06530	3	2022432	2033791	11359	+	651
AT3G06540	3	2035002	2037788	2786	-	394
AT3G06545	3	2038311	2038977	666	+	0
AT3G06550	3	2039063	2042959	3896	-	2253
AT3G06560	3	2044351	2047209	2858	+	1
AT3G06570	3	2047304	2048553	1249	-	160
AT3G06580	3	2048904	2052025	3121	-	1087
AT3G06590	3	2052692	2055414	2722	-	555
AT3G06600	3	2057616	2060483	2867	-	7
AT3G06610	3	2060736	2062067	1331	+	454
AT3G06620	3	2062205	2067416	5211	-	480
AT3G06630	3	2070387	2073800	3413	-	24
AT3G06640	3	2074188	2078317	4129	-	15
AT3G06650	3	2079032	2083291	4259	-	3476
AT3G06660	3	2102401	2104906	2505	+	305
AT3G06665	3	2104955	2105027	72	-	0
AT3G06670	3	2105458	2113698	8240	-	1706
AT3G06680	3	2114150	2114948	798	-	621
AT3G06690	3	2115425	2116825	1400	-	36
AT3G06700	3	2117346	2118007	661	-	2662
AT3G06710	3	2118168	2120059	1891	+	9
AT3G06720	3	2120323	2124131	3808	+	1227
AT3G06730	3	2124216	2126142	1926	+	535
AT3G06740	3	2126413	2127467	1054	+	295
AT3G06750	3	2129622	2130315	693	-	716
AT3G06760	3	2132757	2134556	1799	+	515
AT3G06770	3	2134799	2137228	2429	-	763
AT3G06778	3	2140102	2141533	1431	-	52
AT3G06780	3	2143487	2144521	1034	+	435
AT3G06790	3	2144383	2145776	1393	-	280
AT3G06810	3	2146334	2150831	4497	+	951
AT3G06820	3	2150846	2153440	2594	-	334
AT3G06830	3	2153863	2156148	2285	+	41
AT3G06840	3	2156861	2157850	989	+	83
AT3G06850	3	2157973	2160623	2650	-	531
AT3G06860	3	2161868	2166349	4481	+	1429
AT3G06868	3	2167729	2169222	1493	+	125
AT3G06870	3	2167846	2168960	1114	-	0
AT3G06880	3	2169767	2175686	5919	-	1450
AT3G06890	3	2176855	2177586	731	+	15
AT3G06895	3	2178128	2178291	163	+	0
AT3G06900	3	2178052	2178626	574	-	0
AT3G06910	3	2178629	2181197	2568	-	189
AT3G06920	3	2181716	2184449	2733	+	107
AT3G06930	3	2185142	2189387	4245	-	415
AT3G06940	3	2189478	2192622	3144	-	314
AT3G06950	3	2192684	2194321	1637	+	459
AT3G06960	3	2194207	2196547	2340	-	509
AT3G06962	3	2197122	2197332	210	+	1
AT3G06970	3	2199652	2201150	1498	-	0
AT3G06980	3	2201466	2204833	3367	+	2403
AT3G06985	3	2205391	2205706	315	+	2
AT3G06990	3	2206386	2208058	1672	+	6
AT3G06995	3	2208721	2208877	156	+	0
AT3G07000	3	2209411	2211307	1896	+	7
AT3G07005	3	2212062	2212413	351	+	0
AT3G07010	3	2212727	2216483	3756	-	1078
AT3G07020	3	2217621	2221702	4081	-	664
AT3G07025	3	2222245	2222318	73	+	0
AT3G07030	3	2223000	2225254	2254	-	261
AT3G07040	3	2225951	2229024	3073	-	225
AT3G07050	3	2229589	2232361	2772	-	612
AT3G07055	3	2232464	2232500	36	-	0
AT3G07060	3	2232605	2237118	4513	+	165
AT3G07070	3	2237957	2240074	2117	+	4
AT3G07080	3	2241035	2243124	2089	+	140
AT3G07090	3	2242997	2244820	1823	-	898
AT3G07100	3	2245163	2250699	5536	-	2245
AT3G07110	3	2252018	2253528	1510	+	2164
AT3G07115	3	2253674	2253756	82	-	0
AT3G07120	3	2254478	2255742	1264	+	8
AT3G07130	3	2255709	2258005	2296	-	131
AT3G07140	3	2261191	2263737	2546	+	586
AT3G07150	3	2263805	2264576	771	-	11
AT3G07160	3	2264944	2279383	14439	-	3268
AT3G07170	3	2280193	2282339	2146	+	697
AT3G07180	3	2282232	2285549	3317	-	704
AT3G07185	3	2285601	2285673	72	+	0
AT3G07190	3	2285776	2287447	1671	-	177
AT3G07195	3	2288891	2290505	1614	+	31
AT3G07200	3	2290761	2292492	1731	+	197
AT3G07210	3	2292797	2295452	2655	-	255
AT3G07215	3	2296035	2297789	1754	-	182
AT3G07220	3	2297885	2299572	1687	+	326
AT3G07230	3	2299773	2300267	494	+	1012
AT3G07250	3	2300578	2308305	7727	-	3
AT3G07260	3	2309703	2310788	1085	+	6
AT3G07270	3	2313997	2317188	3191	+	1053
AT3G07273	3	2317713	2317926	213	-	28
AT3G07274	3	2317938	2318454	516	-	60
AT3G07280	3	2318921	2321215	2294	-	175
AT3G07290	3	2321739	2324382	2643	-	33
AT3G07300	3	2324616	2327625	3009	-	484
AT3G07310	3	2327817	2329801	1984	-	2101
AT3G07320	3	2332021	2334074	2053	-	394
AT3G07330	3	2335611	2339100	3489	-	688
AT3G07340	3	2340898	2343470	2572	-	164
AT3G07350	3	2347467	2348791	1324	+	57
AT3G07360	3	2354718	2356854	2136	+	1574
AT3G07370	3	2358082	2360549	2467	-	318
AT3G07380	3	2360987	2362014	1027	-	7
AT3G07390	3	2365300	2366496	1196	+	1960
AT3G07400	3	2367301	2372445	5144	+	588
AT3G07410	3	2372316	2373556	1240	-	249
AT3G07420	3	2373976	2376744	2768	-	274
AT3G07425	3	2378349	2378805	456	+	0
AT3G07430	3	2379192	2380198	1006	+	1303
AT3G07440	3	2381336	2383207	1871	+	195
AT3G07450	3	2383609	2383930	321	-	0
AT3G07460	3	2384417	2385719	1302	-	1281
AT3G07470	3	2386896	2388471	1575	-	951
AT3G07480	3	2388951	2389811	860	+	1622
AT3G07490	3	2391188	2391650	462	+	0
AT3G07500	3	2392286	2393778	1492	+	60
AT3G07510	3	2393685	2394675	990	-	140
AT3G07520	3	2394890	2398291	3401	-	165
AT3G07522	3	2398745	2398874	129	-	0
AT3G07525	3	2399122	2400437	1315	-	106
AT3G07530	3	2400792	2404280	3488	+	104
AT3G07540	3	2404508	2407541	3033	-	480
AT3G07550	3	2409476	2411294	1818	+	216
AT3G07560	3	2411320	2413475	2155	-	1401
AT3G07565	3	2413639	2416284	2645	+	370
AT3G07568	3	2416242	2417790	1548	-	382
AT3G07570	3	2418048	2420296	2248	-	270
AT3G07580	3	2420901	2422825	1924	-	58
AT3G07590	3	2423069	2424594	1525	+	125
AT3G07600	3	2424116	2425022	906	-	5
AT3G07610	3	2426068	2432913	6845	+	536
AT3G07620	3	2433266	2434988	1722	-	2
AT3G07630	3	2435444	2437965	2521	+	529
AT3G07640	3	2438131	2439883	1752	+	300
AT3G07650	3	2441656	2444532	2876	+	33
AT3G07660	3	2444777	2450561	5784	-	1024
AT3G07670	3	2451607	2454860	3253	+	1448
AT3G07680	3	2455289	2456879	1590	+	979
AT3G07690	3	2457107	2459552	2445	+	171
AT3G07700	3	2459490	2463965	4475	-	3713
AT3G07710	3	2464335	2464773	438	-	0
AT3G07720	3	2465364	2467233	1869	+	773
AT3G07730	3	2468184	2469606	1422	+	58
AT3G07740	3	2469782	2473095	3313	-	250
AT3G07750	3	2473234	2475447	2213	+	98
AT3G07760	3	2476366	2478254	1888	+	252
AT3G07770	3	2479547	2484194	4647	+	1139
AT3G07780	3	2484468	2487024	2556	+	817
AT3G07790	3	2487368	2489220	1852	+	784
AT3G07800	3	2489386	2491087	1701	-	333
AT3G07810	3	2492272	2495750	3478	+	708
AT3G07820	3	2496439	2498095	1656	-	0
AT3G07830	3	2499242	2501021	1779	-	2
AT3G07840	3	2501892	2503565	1673	-	0
AT3G07850	3	2505546	2507528	1982	-	0
AT3G07860	3	2507879	2509509	1630	+	68
AT3G07870	3	2510782	2512394	1612	+	277
AT3G07880	3	2513970	2515823	1853	+	1359
AT3G07890	3	2516303	2519375	3072	-	520
AT3G07900	3	2520773	2523108	2335	+	0
AT3G07910	3	2523156	2524165	1009	-	456
AT3G07920	3	2524419	2526229	1810	-	2
AT3G07930	3	2526617	2528633	2016	+	183
AT3G07940	3	2529203	2531533	2330	+	595
AT3G07950	3	2531851	2534504	2653	+	496
AT3G07960	3	2534886	2538372	3486	+	85
AT3G07970	3	2541005	2543432	2427	+	4
AT3G07980	3	2543615	2551225	7610	-	340
AT3G07990	3	2552476	2554921	2445	+	274
AT3G08000	3	2554828	2555929	1101	-	57
AT3G08010	3	2555970	2557505	1535	+	2160
AT3G08020	3	2557436	2561802	4366	-	698
AT3G08030	3	2564032	2566002	1970	+	1978
AT3G08040	3	2566276	2572151	5875	-	14
AT3G08490	3	2573943	2575215	1272	-	9
AT3G08500	3	2576793	2578246	1453	-	14
AT3G08505	3	2580076	2582129	2053	-	336
AT3G08510	3	2582361	2585851	3490	-	3148
AT3G08520	3	2586031	2586206	175	+	247
AT3G08530	3	2586805	2595572	8767	-	5396
AT3G08550	3	2596405	2599819	3414	+	714
AT3G08560	3	2600129	2601907	1778	+	1
AT3G08570	3	2602257	2604412	2155	-	47
AT3G08580	3	2605441	2607787	2346	-	19694
AT3G08590	3	2608470	2611418	2948	-	3920
AT3G08600	3	2612393	2613823	1430	+	486
AT3G08610	3	2615425	2616803	1378	-	2076
AT3G08620	3	2617767	2620573	2806	+	239
AT3G08630	3	2620831	2622220	1389	+	274
AT3G08636	3	2622665	2622845	180	+	0
AT3G08640	3	2622879	2624308	1429	+	1062
AT3G08650	3	2624460	2627450	2990	-	1246
AT3G08660	3	2631129	2633166	2037	+	93
AT3G08670	3	2633727	2636715	2988	+	409
AT3G08680	3	2637559	2640838	3279	+	1293
AT3G08690	3	2641055	2642688	1633	+	530
AT3G08700	3	2643481	2644545	1064	+	7
AT3G08710	3	2645166	2646497	1331	+	356
AT3G08720	3	2648508	2651160	2652	-	120
AT3G08730	3	2651446	2654212	2766	-	2966
AT3G08740	3	2654625	2656239	1614	-	3918
AT3G08750	3	2656715	2657825	1110	-	0
AT3G08760	3	2657917	2660889	2972	-	278
AT3G08762	3	2661835	2662012	177	-	0
AT3G08770	3	2664129	2664834	705	-	1248
AT3G08780	3	2666078	2667533	1455	-	271
AT3G08790	3	2667880	2671001	3121	+	0
AT3G08800	3	2671147	2675196	4049	+	109
AT3G08810	3	2675630	2676693	1063	-	1
AT3G08820	3	2677117	2679179	2062	-	21
AT3G08840	3	2679647	2686224	6577	-	834
AT3G08850	3	2686582	2695300	8718	-	1869
AT3G08860	3	2696558	2699158	2600	-	25
AT3G08870	3	2700354	2702581	2227	-	178
AT3G08880	3	2702972	2704365	1393	+	88
AT3G08885	3	2705469	2706278	809	-	44
AT3G08890	3	2706631	2708747	2116	+	263
AT3G08900	3	2708085	2709714	1629	-	0
AT3G08910	3	2710153	2711895	1742	-	258
AT3G08920	3	2712235	2713269	1034	+	1123
AT3G08930	3	2713397	2717318	3921	+	1146
AT3G08940	3	2717674	2718883	1209	+	81665
AT3G08943	3	2718879	2722624	3745	-	371
AT3G08947	3	2723288	2726942	3654	+	132
AT3G08950	3	2727214	2729601	2387	+	134
AT3G08960	3	2729818	2736884	7066	-	747
AT3G08970	3	2737536	2740530	2994	+	82
AT3G08980	3	2740807	2742685	1878	+	66
AT3G08990	3	2742969	2744932	1963	+	68
AT3G09000	3	2745643	2748459	2816	+	348
AT3G09010	3	2749952	2752276	2324	+	134
AT3G09020	3	2753306	2754621	1315	+	43
AT3G09030	3	2754781	2756507	1726	+	252
AT3G09032	3	2757434	2758097	663	-	10
AT3G09035	3	2758819	2760347	1528	+	353
AT3G09040	3	2761194	2764281	3087	-	44
AT3G09050	3	2764650	2766144	1494	+	963
AT3G09060	3	2766366	2768430	2064	-	16
AT3G09070	3	2768687	2771174	2487	-	324
AT3G09080	3	2776258	2781785	5527	-	24
AT3G09085	3	2782132	2782740	608	+	131
AT3G09090	3	2782697	2787804	5107	-	959
AT3G09100	3	2787980	2793532	5552	-	868
AT3G09110	3	2794164	2795991	1827	-	0
AT3G09120	3	2796957	2798764	1807	-	0
AT3G09130	3	2799311	2800505	1194	+	0
AT3G09140	3	2800852	2802795	1943	-	0
AT3G09150	3	2803527	2805588	2061	+	379
AT3G09160	3	2805778	2807055	1277	-	109
AT3G09162	3	2807666	2808268	602	-	59
AT3G09165	3	2808904	2812409	3505	+	0
AT3G09170	3	2814049	2817769	3720	-	0
AT3G09180	3	2819117	2821425	2308	+	473
AT3G09190	3	2821478	2822687	1209	-	79
AT3G09200	3	2823089	2825114	2025	-	6946
AT3G09210	3	2825278	2826880	1602	-	1922
AT3G09220	3	2827238	2830542	3304	-	0
AT3G09230	3	2833397	2835338	1941	+	111
AT3G09240	3	2835667	2837956	2289	-	4
AT3G09250	3	2838999	2840614	1615	+	675
AT3G09260	3	2840476	2843781	3305	-	1027
AT3G09270	3	2848288	2849289	1001	-	18
AT3G09280	3	2850919	2851258	339	-	0
AT3G09285	3	2854279	2854449	170	+	0
AT3G09290	3	2856140	2856659	519	+	0
AT3G09300	3	2857846	2860668	2822	+	952
AT3G09310	3	2860401	2861359	958	-	71
AT3G09320	3	2861742	2864245	2503	-	221
AT3G09330	3	2864781	2867230	2449	-	5
AT3G09340	3	2868049	2870526	2477	-	0
AT3G09350	3	2871044	2873312	2268	+	251
AT3G09360	3	2873448	2878591	5143	+	284
AT3G09370	3	2879365	2882267	2902	+	211
AT3G09375	3	2882491	2883862	1371	-	0
AT3G09380	3	2885137	2886116	979	-	0
AT3G09385	3	2886534	2887714	1180	+	0
AT3G09390	3	2889485	2890229	744	-	4704
AT3G09400	3	2891039	2893629	2590	-	0
AT3G09405	3	2894811	2897674	2863	-	73
AT3G09410	3	2897637	2901019	3382	-	628
AT3G09430	3	2901279	2903072	1793	+	22
AT3G09440	3	2903197	2905729	2532	-	5692
AT3G09450	3	2907547	2910091	2544	+	309
AT3G09470	3	2910372	2914513	4141	-	634
AT3G09480	3	2914713	2915321	608	-	36
AT3G09490	3	2915558	2916673	1115	+	16
AT3G09500	3	2916951	2918108	1157	+	4233
AT3G09505	3	2918412	2918486	74	-	0
AT3G09510	3	2921803	2923258	1455	+	0
AT3G09520	3	2923742	2925629	1887	+	35
AT3G09530	3	2926301	2928215	1914	+	0
AT3G09540	3	2928810	2931228	2418	-	302
AT3G09550	3	2931864	2934354	2490	+	80
AT3G09560	3	2934616	2939456	4840	-	797
AT3G09570	3	2940445	2942109	1664	+	469
AT3G09580	3	2942503	2944078	1575	-	866
AT3G09585	3	2944611	2944693	82	+	0
AT3G09590	3	2944952	2945513	561	+	3
AT3G09595	3	2945695	2945777	82	-	0
AT3G09600	3	2946405	2948995	2590	+	906
AT3G09620	3	2949151	2952205	3054	-	1
AT3G09630	3	2953736	2955748	2012	+	4220
AT3G09640	3	2956155	2958327	2172	+	0
AT3G09650	3	2958678	2961299	2621	+	659
AT3G09660	3	2961232	2966166	4934	-	91
AT3G09670	3	2966374	2968972	2598	+	274
AT3G09680	3	2969044	2970371	1327	-	1
AT3G09690	3	2971872	2974843	2971	+	401
AT3G09700	3	2974801	2976277	1476	-	111
AT3G09710	3	2976604	2979389	2785	-	120
AT3G09720	3	2980220	2983618	3398	-	166
AT3G09730	3	2983933	2986455	2522	+	86
AT3G09735	3	2986625	2987969	1344	-	431
AT3G09740	3	2989430	2991661	2231	+	1507
AT3G09750	3	2991654	2992679	1025	-	0
AT3G09760	3	2992653	2995634	2981	-	372
AT3G09770	3	2996268	2998190	1922	-	816
AT3G09780	3	3000758	3003179	2421	-	69
AT3G09790	3	3003861	3006192	2331	-	15
AT3G09800	3	3006514	3008489	1975	-	290
AT3G09810	3	3008693	3011437	2744	+	600
AT3G09820	3	3011989	3014944	2955	+	4609
AT3G09830	3	3016493	3018983	2490	+	201
AT3G09840	3	3019339	3023052	3713	+	7560
AT3G09850	3	3023210	3025851	2641	-	1066
AT3G09860	3	3026054	3027234	1180	+	1618
AT3G09863	3	3027291	3027423	132	+	0
AT3G09870	3	3027423	3027957	534	-	4
AT3G09880	3	3029510	3032256	2746	+	486
AT3G09890	3	3032558	3034443	1885	+	232
AT3G09900	3	3034556	3036593	2037	+	556
AT3G09910	3	3036713	3038449	1736	-	38
AT3G09915	3	3039014	3040186	1172	-	0
AT3G09920	3	3038779	3044919	6140	-	1415
AT3G09922	3	3050988	3051530	542	+	0
AT3G09925	3	3051867	3052784	917	-	0
AT3G09930	3	3053259	3055410	2151	+	0
AT3G09940	3	3056374	3059148	2774	-	6
AT3G09950	3	3060089	3060633	544	-	0
AT3G09960	3	3061951	3063594	1643	+	0
AT3G09970	3	3063773	3065575	1802	+	492
AT3G09975	3	3067682	3067781	99	+	0
AT3G09980	3	3069230	3071429	2199	+	1335
AT3G09990	3	3072661	3075142	2481	-	0
AT3G10000	3	3076780	3078947	2167	+	25
AT3G10010	3	3081813	3088195	6382	-	349
AT3G10015	3	3090543	3090626	83	+	0
AT3G10020	3	3091042	3091766	724	-	268
AT3G10030	3	3092022	3094945	2923	-	390
AT3G10035	3	3096215	3096288	73	+	0
AT3G10040	3	3096414	3098071	1657	-	84
AT3G10050	3	3098724	3101761	3037	-	1038
AT3G10060	3	3102156	3104014	1858	+	4704
AT3G10070	3	3103879	3106815	2936	-	279
AT3G10080	3	3107274	3108177	903	-	369
AT3G10090	3	3108809	3110026	1217	-	343
AT3G10100	3	3111777	3115437	3660	+	10
AT3G10110	3	3116109	3117671	1562	+	29
AT3G10113	3	3118042	3119391	1349	-	1
AT3G10114	3	3119490	3120025	535	+	0
AT3G10116	3	3126022	3126619	597	+	0
AT3G10120	3	3130071	3130891	820	+	50
AT3G10130	3	3130997	3133192	2195	-	1205
AT3G10140	3	3134872	3137417	2545	+	333
AT3G10150	3	3137361	3139056	1695	-	131
AT3G10160	3	3139382	3144523	5141	-	1506
AT3G10180	3	3146392	3154644	8252	-	148
AT3G10185	3	3145578	3146199	621	+	24
AT3G10190	3	3155297	3156143	846	+	134
AT3G10195	3	3156550	3157011	461	-	0
AT3G10200	3	3157607	3160188	2581	+	78
AT3G10210	3	3160236	3161614	1378	-	341
AT3G10220	3	3161756	3164231	2475	+	376
AT3G10230	3	3164074	3166038	1964	-	3391
AT3G10240	3	3166697	3167867	1170	+	0
AT3G10250	3	3167950	3170931	2981	-	411
AT3G10260	3	3171221	3172966	1745	-	783
AT3G10270	3	3173579	3179786	6207	-	1292
AT3G10280	3	3180063	3181588	1525	+	3
AT3G10282	3	3181969	3183328	1359	+	3
AT3G10290	3	3183402	3185348	1946	-	30
AT3G10300	3	3186313	3188205	1892	+	257
AT3G10310	3	3190000	3195005	5005	+	178
AT3G10320	3	3195313	3197346	2033	-	7
AT3G10330	3	3199769	3201855	2086	+	341
AT3G10340	3	3204012	3208022	4010	+	200
AT3G10350	3	3208238	3211294	3056	+	1531
AT3G10360	3	3210883	3215556	4673	-	1278
AT3G10370	3	3216367	3219270	2903	+	983
AT3G10380	3	3219522	3228933	9411	-	1872
AT3G10390	3	3229292	3232345	3053	+	418
AT3G10400	3	3232607	3233685	1078	+	94
AT3G10405	3	3233714	3235289	1575	-	1620
AT3G10410	3	3235290	3238113	2823	-	741
AT3G10415	3	3238366	3238402	36	-	0
AT3G10420	3	3239179	3242537	3358	+	1465
AT3G10430	3	3242749	3243862	1113	-	0
AT3G10439	3	3245230	3245329	99	-	0
AT3G10440	3	3245328	3248987	3659	+	198
AT3G10450	3	3249525	3252506	2981	+	247
AT3G10460	3	3255799	3256439	640	+	0
AT3G10470	3	3260350	3261854	1504	+	2
AT3G10480	3	3264347	3267090	2743	+	487
AT3G10490	3	3267834	3270883	3049	+	442
AT3G10500	3	3271489	3274030	2541	+	185
AT3G10510	3	3274219	3275551	1332	-	3
AT3G10520	3	3276225	3277860	1635	-	1239
AT3G10525	3	3281361	3282032	671	-	725
AT3G10526	3	3282466	3282637	171	+	0
AT3G10530	3	3285891	3288880	2989	+	216
AT3G10540	3	3289694	3292702	3008	+	421
AT3G10550	3	3292898	3298522	5624	-	399
AT3G10560	3	3299892	3301704	1812	+	2
AT3G10570	3	3302101	3303839	1738	+	156
AT3G10572	3	3304267	3306504	2237	+	318
AT3G10575	3	3306507	3307035	528	+	0
AT3G10580	3	3307050	3308237	1187	-	0
AT3G10585	3	3308488	3309509	1021	-	0
AT3G10590	3	3310423	3311311	888	-	10
AT3G10595	3	3311784	3312831	1047	-	0
AT3G10600	3	3313968	3317162	3194	+	13
AT3G10610	3	3319026	3320149	1123	+	700
AT3G10620	3	3320262	3321724	1462	+	671
AT3G10630	3	3321462	3323211	1749	-	130
AT3G10640	3	3323309	3325046	1737	-	360
AT3G10650	3	3325169	3330892	5723	-	1276
AT3G10660	3	3331397	3334268	2871	-	56
AT3G10670	3	3335048	3337387	2339	-	1907
AT3G10680	3	3337772	3339345	1573	+	55
AT3G10690	3	3339391	3346340	6949	-	1015
AT3G10700	3	3346577	3351023	4446	-	334
AT3G10710	3	3352288	3354237	1949	+	0
AT3G10720	3	3354446	3357614	3168	-	890
AT3G10730	3	3358327	3360682	2355	-	328
AT3G10740	3	3360887	3365414	4527	-	1850
AT3G10745	3	3366330	3366430	100	-	2
AT3G10750	3	3366926	3368269	1343	+	0
AT3G10760	3	3369579	3371227	1648	+	767
AT3G10770	3	3372263	3374271	2008	-	1157
AT3G10780	3	3375106	3376334	1228	+	2
AT3G10790	3	3377409	3378369	960	+	0
AT3G10800	3	3379253	3381621	2368	+	494
AT3G10810	3	3381847	3384509	2662	-	514
AT3G10815	3	3384806	3386327	1521	-	0
AT3G10820	3	3387199	3391003	3804	+	152
AT3G10840	3	3391064	3393290	2226	-	852
AT3G10845	3	3394008	3397526	3518	+	2
AT3G10850	3	3397548	3399574	2026	-	1754
AT3G10860	3	3399735	3400741	1006	+	2111
AT3G10870	3	3401077	3402672	1595	-	239
AT3G10880	3	3405814	3407434	1620	+	53
AT3G10890	3	3407454	3409000	1546	-	1
AT3G10900	3	3410251	3412070	1819	-	0
AT3G10910	3	3412910	3414019	1109	-	0
AT3G10912	3	3412910	3414019	1109	-	0
AT3G10915	3	3415957	3417809	1852	-	417
AT3G10920	3	3417953	3419853	1900	+	3908
AT3G10930	3	3420129	3420832	703	-	2
AT3G10940	3	3422077	3423445	1368	-	1989
AT3G10950	3	3423892	3424566	674	+	0
AT3G10960	3	3424812	3426997	2185	-	218
AT3G10970	3	3433072	3436279	3207	-	2566
AT3G10974	3	3437162	3437393	231	+	0
AT3G10980	3	3438277	3440809	2532	+	493
AT3G10985	3	3442527	3443445	918	+	633
AT3G10986	3	3444202	3445672	1470	-	0
AT3G10990	3	3446461	3446995	534	-	0
AT3G11000	3	3447567	3450589	3022	+	63
AT3G11010	3	3450495	3453683	3188	-	393
AT3G11020	3	3455354	3457214	1860	+	6
AT3G11030	3	3457226	3459380	2154	-	167
AT3G11040	3	3460142	3463312	3170	+	127
AT3G11050	3	3463597	3465506	1909	+	17
AT3G11060	3	3466302	3466944	642	-	0
AT3G11070	3	3467753	3470095	2342	+	514
AT3G11080	3	3470439	3473312	2873	+	42
AT3G11090	3	3475001	3475604	603	+	641
AT3G11100	3	3476186	3477405	1219	-	292
AT3G11110	3	3479978	3480455	477	+	372
AT3G11120	3	3481051	3481448	397	+	1104
AT3G11130	3	3482148	3491908	9760	-	5075
AT3G11150	3	3492866	3494653	1787	-	8
AT3G11160	3	3496066	3497163	1097	-	0
AT3G11165	3	3497945	3499090	1145	-	0
AT3G11170	3	3499800	3502452	2652	+	8855
AT3G11180	3	3504203	3507113	2910	+	0
AT3G11200	3	3508041	3510627	2586	-	878
AT3G11210	3	3510662	3513060	2398	-	173
AT3G11220	3	3513530	3516408	2878	-	157
AT3G11230	3	3516576	3518385	1809	+	146
AT3G11240	3	3518483	3521115	2632	-	223
AT3G11250	3	3521356	3523001	1645	+	677
AT3G11260	3	3527574	3528433	859	+	4
AT3G11270	3	3528800	3531724	2924	+	254
AT3G11280	3	3533254	3534847	1593	-	1461
AT3G11285	3	3535145	3535218	73	+	0
AT3G11290	3	3535609	3537843	2234	-	505
AT3G11300	3	3539346	3540473	1127	-	0
AT3G11310	3	3542535	3544333	1798	-	0
AT3G11320	3	3546645	3548856	2211	-	303
AT3G11325	3	3549770	3551661	1891	-	0
AT3G11330	3	3551973	3554763	2790	-	614
AT3G11340	3	3556704	3558269	1565	+	5
AT3G11350	3	3558494	3560078	1584	+	0
AT3G11370	3	3561098	3562880	1782	+	0
AT3G11380	3	3564078	3565779	1701	+	0
AT3G11385	3	3566577	3568878	2301	+	0
AT3G11390	3	3569827	3571960	2133	+	5
AT3G11395	3	3575843	3575917	74	+	0
AT3G11397	3	3576016	3578082	2066	+	24
AT3G11400	3	3578387	3580569	2182	+	1755
AT3G11402	3	3573360	3578125	4765	+	40
AT3G11405	3	3580894	3581359	465	+	2
AT3G11410	3	3583882	3585790	1908	-	2113
AT3G11415	3	3588683	3589685	1002	+	1
AT3G11420	3	3591474	3594570	3096	+	257
AT3G11430	3	3595764	3597952	2188	+	2
AT3G11435	3	3599775	3599908	133	-	0
AT3G11440	3	3602092	3605104	3012	+	81
AT3G11450	3	3605216	3608086	2870	-	1094
AT3G11460	3	3608249	3610121	1872	+	13
AT3G11470	3	3610146	3612370	2224	-	360
AT3G11480	3	3614436	3617314	2878	+	0
AT3G11490	3	3617522	3619567	2045	-	438
AT3G11500	3	3621408	3622606	1198	-	509
AT3G11505	3	3622691	3622763	72	-	0
AT3G11510	3	3623456	3624940	1484	-	4316
AT3G11520	3	3625323	3627273	1950	-	90
AT3G11530	3	3628593	3630536	1943	-	325
AT3G11540	3	3631886	3637955	6069	+	695
AT3G11550	3	3638194	3639197	1003	+	6
AT3G11560	3	3639434	3646061	6627	+	3409
AT3G11570	3	3645021	3647542	2521	-	14
AT3G11580	3	3648923	3651332	2409	-	52
AT3G11590	3	3660376	3663734	3358	+	605
AT3G11591	3	3663543	3663986	443	-	9
AT3G11600	3	3667228	3667979	751	+	120
AT3G11620	3	3669318	3672034	2716	-	351
AT3G11630	3	3672119	3674075	1956	+	23913
AT3G11640	3	3674498	3675198	700	+	8
AT3G11650	3	3676145	3677037	892	-	158
AT3G11660	3	3678834	3679943	1109	-	964
AT3G11670	3	3680892	3684558	3666	-	2567
AT3G11673	3	3685291	3685647	356	-	0
AT3G11680	3	3686994	3689329	2335	-	0
AT3G11690	3	3694987	3696478	1491	+	422
AT3G11700	3	3698838	3701493	2655	+	2029
AT3G11710	3	3702168	3705714	3546	-	2206
AT3G11720	3	3705864	3708721	2857	-	324
AT3G11730	3	3709324	3711529	2205	-	630
AT3G11740	3	3712378	3713446	1068	+	0
AT3G11745	3	3713759	3714579	820	-	63
AT3G11750	3	3715070	3715904	834	-	160
AT3G11760	3	3718415	3721251	2836	+	236
AT3G11770	3	3721323	3722658	1335	-	284
AT3G11773	3	3722891	3723733	842	-	0
AT3G11780	3	3724133	3725593	1460	-	717
AT3G11800	3	3726107	3727729	1622	+	452
AT3G11810	3	3727795	3729031	1236	+	528
AT3G11820	3	3729304	3731149	1845	-	424
AT3G11825	3	3731761	3732064	303	+	0
AT3G11830	3	3732627	3736377	3750	+	1785
AT3G11840	3	3736399	3738257	1858	-	44
AT3G11850	3	3738896	3741714	2818	-	139
AT3G11860	3	3744815	3746850	2035	+	1
AT3G11870	3	3746997	3749093	2096	-	0
AT3G11880	3	3751659	3754060	2401	+	510
AT3G11890	3	3755541	3757775	2234	+	380
AT3G11900	3	3758451	3760378	1927	+	818
AT3G11910	3	3761387	3770563	9176	-	1732
AT3G11920	3	3772310	3774887	2577	+	0
AT3G11930	3	3776236	3777694	1458	+	2394
AT3G11940	3	3777894	3779506	1612	-	5125
AT3G11945	3	3779838	3782954	3116	-	2624
AT3G11950	3	3783110	3785660	2550	-	174
AT3G11960	3	3786385	3793657	7272	+	1042
AT3G11964	3	3793956	3806626	12670	-	850
AT3G11970	3	3807726	3812227	4501	-	0
AT3G11980	3	3814235	3817117	2882	+	0
AT3G11990	3	3817293	3817946	653	+	0
AT3G12000	3	3818261	3819620	1359	-	0
AT3G12010	3	3820351	3825765	5414	+	0
AT3G12012	3	3820351	3825765	5414	+	0
AT3G12020	3	3826147	3834318	8171	+	1041
AT3G12030	3	3834360	3835075	715	-	127
AT3G12040	3	3835128	3836833	1705	-	66
AT3G12050	3	3839101	3841466	2365	+	1095
AT3G12060	3	3843141	3845150	2009	+	24
AT3G12070	3	3845210	3847562	2352	-	30
AT3G12080	3	3847791	3852138	4347	+	1611
AT3G12090	3	3852144	3853720	1576	-	93
AT3G12100	3	3854514	3857319	2805	-	354
AT3G12110	3	3857842	3859798	1956	+	945
AT3G12120	3	3860284	3863050	2766	-	6920
AT3G12130	3	3864151	3866596	2445	-	422
AT3G12140	3	3868587	3871728	3141	-	659
AT3G12143	3	3872313	3873608	1295	-	1
AT3G12145	3	3874498	3876237	1739	-	337
AT3G12150	3	3876406	3878900	2494	-	490
AT3G12160	3	3879494	3880437	943	-	4
AT3G12170	3	3880999	3882804	1805	+	90
AT3G12180	3	3883361	3884805	1444	+	173
AT3G12190	3	3886182	3886992	810	+	0
AT3G12200	3	3886991	3891000	4009	-	765
AT3G12203	3	3891356	3893981	2625	-	3
AT3G12210	3	3894777	3896066	1289	+	394
AT3G12220	3	3896530	3899019	2489	-	21
AT3G12230	3	3899430	3901879	2449	-	0
AT3G12240	3	3902435	3904918	2483	-	2
AT3G12250	3	3905513	3908983	3470	+	170
AT3G12260	3	3908939	3910420	1481	-	1715
AT3G12270	3	3910632	3913329	2697	+	234
AT3G12280	3	3913411	3919170	5759	-	1225
AT3G12290	3	3919501	3921519	2018	+	2330
AT3G12300	3	3921527	3923155	1628	-	317
AT3G12320	3	3923734	3925465	1731	+	2018
AT3G12340	3	3925525	3929405	3880	-	122
AT3G12345	3	3930179	3930992	813	-	4716
AT3G12350	3	3931554	3933356	1802	+	483
AT3G12360	3	3934077	3936694	2617	+	895
AT3G12370	3	3937189	3938094	905	-	287
AT3G12380	3	3938275	3941900	3625	-	298
AT3G12385	3	3942005	3942077	72	+	0
AT3G12390	3	3942256	3943809	1553	+	1560
AT3G12400	3	3944295	3945851	1556	-	380
AT3G12410	3	3946035	3946960	925	-	6
AT3G12420	3	3948013	3948882	869	-	0
AT3G12430	3	3949579	3950377	798	-	0
AT3G12440	3	3951198	3952260	1062	-	0
AT3G12450	3	3953307	3953997	690	-	0
AT3G12460	3	3954694	3955423	729	-	11
AT3G12470	3	3956056	3956827	771	-	0
AT3G12480	3	3957776	3960472	2696	+	522
AT3G12490	3	3960400	3961915	1515	-	1549
AT3G12500	3	3962381	3963984	1603	-	17
AT3G12502	3	3963123	3964222	1099	+	0
AT3G12510	3	3967094	3967822	728	+	31
AT3G12520	3	3967815	3971927	4112	-	159
AT3G12530	3	3972345	3974195	1850	-	59
AT3G12540	3	3975245	3977312	2067	+	0
AT3G12545	3	3977549	3978294	745	-	0
AT3G12550	3	3978004	3981762	3758	+	220
AT3G12560	3	3981982	3985550	3568	-	862
AT3G12570	3	3988669	3991079	2410	+	685
AT3G12580	3	3991260	3993792	2532	-	886
AT3G12585	3	3995096	3995169	73	-	0
AT3G12587	3	3994365	3995538	1173	-	224
AT3G12590	3	3995721	4003657	7936	-	677
AT3G12600	3	4004511	4006198	1687	+	365
AT3G12610	3	4006398	4007807	1409	-	1535
AT3G12620	3	4009274	4011399	2125	-	581
AT3G12630	3	4012607	4013583	976	+	1105
AT3G12640	3	4014212	4017869	3657	+	577
AT3G12650	3	4017829	4018631	802	-	180
AT3G12660	3	4019059	4019827	768	+	0
AT3G12670	3	4020119	4024268	4149	-	1022
AT3G12680	3	4025075	4029140	4065	-	483
AT3G12685	3	4029182	4030355	1173	-	407
AT3G12690	3	4030446	4033332	2886	-	213
AT3G12700	3	4037069	4039142	2073	+	219
AT3G12710	3	4040323	4041982	1659	-	159
AT3G12720	3	4043309	4044609	1300	-	1
AT3G12730	3	4047071	4048614	1543	-	141
AT3G12740	3	4049514	4051775	2261	+	632
AT3G12750	3	4051650	4053201	1551	-	248
AT3G12760	3	4054738	4056980	2242	+	767
AT3G12770	3	4057011	4059214	2203	-	24
AT3G12775	3	4059771	4060944	1173	+	0
AT3G12780	3	4060970	4063306	2336	-	50785
AT3G12800	3	4063322	4064822	1500	-	1572
AT3G12810	3	4065041	4074078	9037	+	864
AT3G12820	3	4074157	4075614	1457	-	31
AT3G12830	3	4078650	4079608	958	-	43
AT3G12835	3	4083264	4083369	105	-	0
AT3G12840	3	4085804	4086083	279	-	0
AT3G12850	3	4088373	4090303	1930	-	0
AT3G12860	3	4091569	4093921	2352	+	70
AT3G12870	3	4094416	4095037	621	-	119
AT3G12880	3	4095534	4096236	702	+	2
AT3G12890	3	4099198	4100473	1275	+	13
AT3G12900	3	4104575	4106112	1537	+	0
AT3G12910	3	4109374	4110648	1274	+	1
AT3G12915	3	4112628	4115951	3323	+	437
AT3G12920	3	4121882	4123508	1626	-	623
AT3G12930	3	4128406	4129956	1550	+	1330
AT3G12940	3	4130006	4132467	2461	-	238
AT3G12950	3	4132527	4135134	2607	-	542
AT3G12955	3	4135499	4136143	644	-	2
AT3G12960	3	4136487	4136828	341	+	0
AT3G12965	3	4136960	4137674	714	-	527
AT3G12970	3	4141050	4142548	1498	-	59
AT3G12977	3	4143725	4145967	2242	+	0
AT3G12980	3	4146498	4154895	8397	+	743
AT3G12981	3	4154904	4156051	1147	-	9
AT3G12990	3	4156185	4157964	1779	+	180
AT3G13000	3	4157966	4162065	4099	-	449
AT3G13010	3	4162930	4164733	1803	-	2
AT3G13020	3	4166994	4168917	1923	-	37
AT3G13030	3	4169540	4172051	2511	-	434
AT3G13040	3	4172141	4175248	3107	-	2710
AT3G13050	3	4176510	4179066	2556	+	223
AT3G13060	3	4180572	4183975	3403	+	898
AT3G13061	3	4183098	4183884	786	-	0
AT3G13062	3	4184568	4187453	2885	+	1580
AT3G13065	3	4187370	4191298	3928	+	282
AT3G13070	3	4191350	4195112	3762	-	1253
AT3G13080	3	4195785	4201265	5480	-	1182
AT3G13090	3	4203012	4208171	5159	-	7
AT3G13100	3	4208734	4214173	5439	-	187
AT3G13110	3	4214616	4216302	1686	-	1707
AT3G13120	3	4219774	4221666	1892	-	7632
AT3G13130	3	4222913	4223752	839	+	12
AT3G13140	3	4226653	4227377	724	-	0
AT3G13150	3	4227739	4229651	1912	-	73
AT3G13160	3	4229970	4231286	1316	-	151
AT3G13170	3	4231559	4234192	2633	-	10
AT3G13175	3	4235125	4235724	599	-	113
AT3G13180	3	4236016	4240011	3995	-	1141
AT3G13190	3	4240171	4241961	1790	+	257
AT3G13200	3	4242124	4244145	2021	+	1290
AT3G13205	3	4244281	4244686	405	-	0
AT3G13210	3	4244920	4247846	2926	+	13
AT3G13220	3	4247967	4250703	2736	-	0
AT3G13222	3	4251013	4254267	3254	-	395
AT3G13223	3	4254527	4254608	81	+	0
AT3G13224	3	4254742	4257409	2667	+	363
AT3G13225	3	4258769	4262911	4142	-	614
AT3G13226	3	4264294	4266362	2068	-	470
AT3G13227	3	4258005	4258505	500	+	1
AT3G13228	3	4266963	4268251	1288	+	0
AT3G13229	3	4268443	4269691	1248	-	0
AT3G13230	3	4269977	4271204	1227	+	234
AT3G13235	3	4271211	4274455	3244	-	746
AT3G13240	3	4275759	4276240	481	+	33
AT3G13250	3	4276746	4281476	4730	-	0
AT3G13260	3	4284052	4285300	1248	-	2
AT3G13270	3	4285850	4288332	2482	-	73
AT3G13275	3	4289193	4289842	649	-	79
AT3G13277	3	4290081	4291595	1514	+	43
AT3G13280	3	4295326	4297000	1674	-	0
AT3G13290	3	4297380	4303508	6128	+	671
AT3G13300	3	4303873	4310213	6340	+	1844
AT3G13310	3	4310607	4311441	834	-	565
AT3G13320	3	4314528	4318351	3823	+	632
AT3G13330	3	4319646	4330061	10415	-	1510
AT3G13335	3	4330771	4330843	72	+	0
AT3G13340	3	4331530	4335073	3543	+	1066
AT3G13350	3	4335474	4337986	2512	-	490
AT3G13360	3	4338358	4340412	2054	-	648
AT3G13370	3	4341663	4342230	567	+	0
AT3G13380	3	4346556	4350923	4367	+	128
AT3G13390	3	4351044	4353393	2349	-	0
AT3G13400	3	4355137	4357428	2291	+	7
AT3G13403	3	4358536	4358826	290	-	37
AT3G13404	3	4358178	4359007	829	-	51
AT3G13405	3	4359011	4359202	191	-	7
AT3G13410	3	4361856	4364262	2406	-	3454
AT3G13420	3	4364526	4366791	2265	+	49
AT3G13430	3	4367180	4368879	1699	+	180
AT3G13432	3	4371469	4371987	518	+	0
AT3G13433	3	4374235	4374712	477	+	0
AT3G13435	3	4375424	4376069	645	+	0
AT3G13437	3	4376360	4376959	599	+	15
AT3G13438	3	4377060	4378171	1111	-	6
AT3G13440	3	4377096	4379575	2479	+	152
AT3G13445	3	4379792	4382224	2432	+	520
AT3G13450	3	4382197	4384436	2239	-	291
AT3G13460	3	4384713	4388525	3812	-	4304
AT3G13470	3	4389255	4392801	3546	+	5435
AT3G13480	3	4392955	4393961	1006	-	376
AT3G13490	3	4395724	4399325	3601	-	1672
AT3G13500	3	4399973	4400306	333	+	0
AT3G13510	3	4403499	4406091	2592	+	880
AT3G13520	3	4408924	4409440	516	+	1160
AT3G13525	3	4411167	4411253	86	+	0
AT3G13530	3	4411687	4419320	7633	-	940
AT3G13540	3	4420172	4421701	1529	+	27
AT3G13550	3	4423348	4424883	1535	-	209
AT3G13560	3	4425226	4428179	2953	-	405
AT3G13570	3	4429297	4432159	2862	-	627
AT3G13580	3	4433046	4435305	2259	+	1075
AT3G13590	3	4435315	4437334	2019	-	33
AT3G13594	3	4441075	4441270	195	+	0
AT3G13600	3	4445101	4447383	2282	+	15
AT3G13610	3	4449373	4450811	1438	+	0
AT3G13620	3	4450744	4452624	1880	-	356
AT3G13624	3	4454218	4456010	1792	-	0
AT3G13630	3	4456953	4458134	1181	+	1
AT3G13640	3	4458460	4461733	3273	-	24
AT3G13650	3	4462891	4463872	981	+	77
AT3G13660	3	4464907	4465586	679	+	2
AT3G13662	3	4467089	4468498	1409	+	1
AT3G13670	3	4469221	4473547	4326	+	1152
AT3G13672	3	4472561	4474378	1817	-	35
AT3G13674	3	4474776	4475908	1132	-	52
AT3G13677	3	4476067	4477092	1025	+	94
AT3G13680	3	4477288	4478721	1433	-	1
AT3G13682	3	4479192	4481509	2317	-	74
AT3G13686	3	4483847	4484060	213	+	0
AT3G13690	3	4485734	4490231	4497	+	1416
AT3G13700	3	4490627	4493737	3110	-	0
AT3G13710	3	4490627	4493831	3204	-	0
AT3G13720	3	4495018	4495956	938	-	398
AT3G13724	3	4496821	4496918	97	-	0
AT3G13730	3	4497975	4500920	2945	-	157
AT3G13740	3	4504269	4506311	2042	+	853
AT3G13750	3	4510964	4516298	5334	+	6335
AT3G13760	3	4517516	4519475	1959	+	1
AT3G13770	3	4519646	4521533	1887	+	13
AT3G13772	3	4521531	4524394	2863	-	1080
AT3G13780	3	4525071	4526214	1143	+	96
AT3G13782	3	4526659	4528398	1739	+	59
AT3G13784	3	4528528	4530669	2141	-	9
AT3G13790	3	4532910	4535867	2957	-	216
AT3G13800	3	4538766	4541487	2721	+	355
AT3G13810	3	4544363	4547513	3150	+	550
AT3G13820	3	4549615	4550863	1248	+	0
AT3G13825	3	4552523	4553382	859	+	0
AT3G13830	3	4553942	4555076	1134	+	0
AT3G13840	3	4555304	4556837	1533	-	12
AT3G13845	3	4557320	4558579	1259	-	210
AT3G13850	3	4559907	4561020	1113	+	3
AT3G13855	3	4560654	4561570	916	+	1
AT3G13857	3	4561106	4561345	239	+	0
AT3G13860	3	4561516	4565279	3763	-	528
AT3G13870	3	4565411	4571260	5849	-	2529
AT3G13880	3	4572179	4574490	2311	+	22
AT3G13882	3	4574520	4576048	1528	+	701
AT3G13890	3	4576743	4578027	1284	-	0
AT3G13898	3	4584010	4584487	477	+	2
AT3G13900	3	4586150	4590681	4531	+	7
AT3G13910	3	4590918	4591483	565	-	98
AT3G13920	3	4592255	4594999	2744	-	7201
AT3G13930	3	4595875	4600469	4594	+	2238
AT3G13940	3	4600491	4602486	1995	-	193
AT3G13950	3	4604148	4605425	1277	+	11
AT3G13960	3	4608382	4610399	2017	+	61
AT3G13965	3	4612140	4612770	630	-	38
AT3G13970	3	4613505	4614848	1343	-	42
AT3G13980	3	4619037	4620262	1225	-	378
AT3G13990	3	4625569	4630613	5044	-	762
AT3G14000	3	4630868	4633916	3048	-	213
AT3G14010	3	4636253	4640981	4728	+	998
AT3G14020	3	4642279	4644301	2022	+	199
AT3G14025	3	4644897	4645705	808	+	3
AT3G14030	3	4646271	4647124	853	-	0
AT3G14040	3	4648347	4650319	1972	-	0
AT3G14050	3	4650756	4653914	3158	-	460
AT3G14060	3	4657045	4657601	556	-	7
AT3G14067	3	4658197	4660784	2587	-	7392
AT3G14070	3	4661142	4663074	1932	-	67
AT3G14075	3	4663568	4667079	3511	-	496
AT3G14080	3	4667364	4669194	1830	+	275
AT3G14090	3	4669252	4671575	2323	-	234
AT3G14100	3	4672918	4676162	3244	+	1330
AT3G14110	3	4676117	4677689	1572	-	2330
AT3G14120	3	4677812	4685666	7854	+	412
AT3G14130	3	4685645	4688309	2664	-	153
AT3G14140	3	4688545	4690404	1859	+	9
AT3G14150	3	4690449	4693001	2552	-	563
AT3G14160	3	4693360	4695604	2244	+	157
AT3G14170	3	4695964	4698120	2156	-	160
AT3G14172	3	4698562	4705629	7067	-	478
AT3G14180	3	4707112	4708848	1736	-	368
AT3G14185	3	4709271	4709814	543	-	0
AT3G14190	3	4710482	4711969	1487	+	137
AT3G14200	3	4712573	4714653	2080	-	553
AT3G14205	3	4715706	4720951	5245	-	1323
AT3G14210	3	4729822	4731803	1981	+	25660
AT3G14220	3	4732892	4734609	1717	+	965
AT3G14225	3	4734615	4735993	1378	-	2
AT3G14230	3	4737145	4739141	1996	-	1189
AT3G14240	3	4741472	4744117	2645	-	1732
AT3G14250	3	4745925	4746958	1033	-	0
AT3G14260	3	4747768	4748819	1051	-	0
AT3G14270	3	4753924	4761456	7532	+	1582
AT3G14280	3	4761431	4762395	964	-	74
AT3G14290	3	4764148	4766586	2438	+	935
AT3G14300	3	4766904	4769898	2994	-	0
AT3G14310	3	4771901	4775119	3218	-	2187
AT3G14320	3	4777730	4778345	615	-	3
AT3G14330	3	4779687	4782452	2765	-	453
AT3G14340	3	4782756	4783137	381	+	0
AT3G14350	3	4782756	4787236	4480	-	2091
AT3G14360	3	4791588	4793684	2096	+	43
AT3G14362	3	4793677	4794417	740	-	0
AT3G14370	3	4797844	4799504	1660	-	15
AT3G14380	3	4802951	4803811	860	-	3
AT3G14385	3	4805683	4805850	167	-	0
AT3G14390	3	4806724	4809433	2709	+	1046
AT3G14395	3	4810922	4811481	559	+	6
AT3G14400	3	4811531	4815515	3984	-	1018
AT3G14410	3	4815810	4817980	2170	-	301
AT3G14415	3	4818297	4821006	2709	+	24824
AT3G14420	3	4821522	4824178	2656	+	50311
AT3G14430	3	4824195	4824837	642	-	189
AT3G14431	3	4825201	4825357	156	+	0
AT3G14440	3	4831287	4833599	2312	-	246
AT3G14450	3	4849787	4851601	1814	+	131
AT3G14452	3	4851695	4851812	117	+	10
AT3G14460	3	4851989	4856264	4275	-	103
AT3G14470	3	4857939	4861247	3308	+	141
AT3G14475	3	4860888	4861009	121	-	0
AT3G14480	3	4862152	4862680	528	+	0
AT3G14490	3	4863630	4865949	2319	-	0
AT3G14500	3	4866405	4866822	417	+	0
AT3G14510	3	4867377	4868414	1037	-	0
AT3G14515	3	4869123	4869815	692	-	0
AT3G14517	3	4869840	4872139	2299	-	0
AT3G14520	3	4875747	4878336	2589	-	0
AT3G14530	3	4879111	4880448	1337	-	2
AT3G14540	3	4881438	4883936	2498	-	42
AT3G14550	3	4884565	4885982	1417	-	39
AT3G14560	3	4889071	4890159	1088	+	142
AT3G14570	3	4892642	4902628	9986	+	396
AT3G14580	3	4903011	4904229	1218	+	9
AT3G14590	3	4904269	4907993	3724	-	60
AT3G14595	3	4908947	4910476	1529	+	939
AT3G14600	3	4910696	4912173	1477	+	2229
AT3G14610	3	4912465	4914652	2187	+	46
AT3G14620	3	4914913	4917078	2165	+	243
AT3G14630	3	4917497	4919409	1912	+	10
AT3G14640	3	4919855	4921787	1932	+	6
AT3G14650	3	4922130	4924694	2564	+	2682
AT3G14660	3	4924776	4927434	2658	+	1977
AT3G14670	3	4927846	4929018	1172	+	0
AT3G14680	3	4934419	4936563	2144	+	2
AT3G14690	3	4937316	4939465	2149	+	1785
AT3G14700	3	4940317	4941398	1081	+	18
AT3G14710	3	4941544	4943055	1511	+	4
AT3G14720	3	4945600	4949042	3442	+	1354
AT3G14730	3	4949384	4951346	1962	-	39
AT3G14735	3	4951284	4952077	793	+	2
AT3G14740	3	4952003	4953423	1420	-	120
AT3G14750	3	4953575	4955656	2081	-	133
AT3G14760	3	4956348	4957255	907	+	140
AT3G14770	3	4957333	4959704	2371	-	600
AT3G14780	3	4961805	4963544	1739	-	7
AT3G14790	3	4964154	4967075	2921	+	567
AT3G14800	3	4967159	4970274	3115	-	346
AT3G14810	3	4970989	4974534	3545	-	764
AT3G14820	3	4978725	4980241	1516	+	0
AT3G14830	3	4982942	4985857	2915	+	500
AT3G14840	3	4988106	4994058	5952	+	1280
AT3G14850	3	4995596	4997693	2097	+	66
AT3G14855	3	4998140	4998212	72	+	0
AT3G14860	3	4998356	5001046	2690	-	550
AT3G14870	3	5002366	5005739	3373	+	143
AT3G14880	3	5006564	5007689	1125	+	1
AT3G14890	3	5008741	5013265	4524	+	456
AT3G14900	3	5013290	5015292	2002	-	197
AT3G14910	3	5015425	5017805	2380	+	188
AT3G14920	3	5018274	5020273	1999	+	536
AT3G14930	3	5020569	5022959	2390	+	6356
AT3G14940	3	5025237	5029710	4473	+	266
AT3G14950	3	5030215	5032892	2677	-	5
AT3G14960	3	5035895	5038007	2112	-	224
AT3G14970	3	5039070	5039733	663	-	0
AT3G14980	3	5039930	5045403	5473	-	580
AT3G14981	3	5045109	5045328	219	+	0
AT3G14990	3	5047399	5049877	2478	+	606
AT3G15000	3	5050256	5052432	2176	+	1492
AT3G15010	3	5052730	5054942	2212	+	871
AT3G15020	3	5056067	5058248	2181	+	1068
AT3G15030	3	5061680	5064115	2435	+	1155
AT3G15040	3	5064703	5066690	1987	-	221
AT3G15050	3	5066878	5067960	1082	-	12
AT3G15055	3	5068293	5068367	74	-	0
AT3G15060	3	5069165	5070200	1035	+	152
AT3G15070	3	5070133	5073356	3223	-	434
AT3G15080	3	5074215	5076524	2309	+	158
AT3G15090	3	5076688	5079117	2429	+	476
AT3G15095	3	5081779	5084240	2461	+	1161
AT3G15110	3	5084277	5085843	1566	-	929
AT3G15111	3	5085859	5085976	117	+	1
AT3G15115	3	5085991	5087489	1498	-	215
AT3G15120	3	5088365	5095482	7117	-	720
AT3G15130	3	5097152	5099222	2070	-	38
AT3G15140	3	5099531	5101781	2250	-	109
AT3G15150	3	5101984	5104140	2156	-	97
AT3G15160	3	5104366	5108473	4107	+	674
AT3G15170	3	5109882	5111447	1565	+	2
AT3G15180	3	5111892	5116007	4115	+	435
AT3G15190	3	5116140	5117615	1475	+	7584
AT3G15200	3	5117488	5119060	1572	-	12
AT3G15210	3	5121421	5122562	1141	+	416
AT3G15220	3	5126596	5132306	5710	-	534
AT3G15240	3	5133605	5135902	2297	+	0
AT3G15250	3	5136261	5137195	934	-	0
AT3G15251	3	5137204	5137318	114	+	0
AT3G15260	3	5138685	5142644	3959	+	531
AT3G15270	3	5140364	5141348	984	-	27
AT3G15280	3	5143967	5144693	726	-	1
AT3G15290	3	5144996	5146856	1860	+	318
AT3G15300	3	5147404	5148305	901	-	23
AT3G15310	3	5152098	5153642	1544	-	88
AT3G15320	3	5154207	5155071	864	-	0
AT3G15330	3	5158748	5159597	849	+	0
AT3G15340	3	5159697	5162841	3144	-	15
AT3G15350	3	5166205	5169151	2946	+	677
AT3G15351	3	5176058	5177648	1590	+	141
AT3G15352	3	5179412	5180665	1253	+	68
AT3G15353	3	5180641	5181586	945	-	24088
AT3G15354	3	5169094	5172837	3743	-	2199
AT3G15355	3	5183738	5186929	3191	+	285
AT3G15356	3	5174401	5175469	1068	-	325
AT3G15357	3	5187115	5187710	595	+	5
AT3G15358	3	5178012	5178838	826	+	37
AT3G15359	3	5173592	5173781	189	+	0
AT3G15360	3	5188373	5189697	1324	+	10024
AT3G15370	3	5190571	5192077	1506	+	0
AT3G15380	3	5193227	5196591	3364	+	655
AT3G15390	3	5196521	5200337	3816	-	220
AT3G15395	3	5200638	5201514	876	+	302
AT3G15400	3	5201643	5203197	1554	+	123
AT3G15410	3	5203291	5207559	4268	+	916
AT3G15420	3	5207576	5208359	783	-	48
AT3G15430	3	5208737	5211745	3008	+	604
AT3G15440	3	5211922	5212354	432	-	0
AT3G15450	3	5212983	5214124	1141	+	452
AT3G15460	3	5214083	5216261	2178	-	171
AT3G15470	3	5216261	5220218	3957	-	722
AT3G15480	3	5226247	5227789	1542	-	991
AT3G15490	3	5229123	5230646	1523	+	2
AT3G15500	3	5234616	5236088	1472	+	0
AT3G15510	3	5243509	5245382	1873	+	263
AT3G15518	3	5249111	5249754	643	+	22
AT3G15520	3	5249598	5252506	2908	-	2739
AT3G15530	3	5252874	5254562	1688	-	465
AT3G15534	3	5258875	5259082	207	+	1
AT3G15536	3	5260722	5261322	600	+	13
AT3G15540	3	5264023	5265678	1655	+	150
AT3G15548	3	5267062	5267164	102	+	0
AT3G15550	3	5267350	5270118	2768	+	229
AT3G15570	3	5269848	5271922	2074	-	1333
AT3G15578	3	5273690	5273873	183	+	0
AT3G15580	3	5273894	5275095	1201	-	796
AT3G15585	3	5275148	5275221	73	+	0
AT3G15590	3	5275400	5277991	2591	-	416
AT3G15600	3	5279431	5281417	1986	+	0
AT3G15602	3	5283445	5285767	2322	-	0
AT3G15604	3	5287379	5287544	165	-	0
AT3G15605	3	5287322	5290971	3649	+	0
AT3G15610	3	5290846	5293090	2244	-	581
AT3G15620	3	5293305	5296592	3287	-	35
AT3G15630	3	5296846	5297599	753	-	64
AT3G15640	3	5299109	5301745	2636	+	1022
AT3G15650	3	5305917	5307968	2051	+	84
AT3G15660	3	5307943	5309581	1638	-	852
AT3G15670	3	5309885	5310988	1103	-	3
AT3G15680	3	5315000	5316466	1466	+	716
AT3G15690	3	5316915	5319613	2698	+	1353
AT3G15700	3	5321135	5322376	1241	-	0
AT3G15710	3	5323357	5324908	1551	-	422
AT3G15720	3	5325289	5327639	2350	-	20
AT3G15730	3	5330321	5333745	3424	+	7280
AT3G15740	3	5333878	5334553	675	-	0
AT3G15750	3	5335077	5336476	1399	+	53
AT3G15760	3	5337546	5338467	921	+	125
AT3G15770	3	5340073	5341339	1266	+	432
AT3G15780	3	5341425	5342557	1132	+	150
AT3G15790	3	5343015	5344700	1685	+	663
AT3G15800	3	5345050	5346988	1938	+	44
AT3G15810	3	5347821	5349288	1467	-	1162
AT3G15820	3	5351070	5353728	2658	+	372
AT3G15830	3	5354973	5356424	1451	+	0
AT3G15840	3	5356600	5358593	1993	-	6447
AT3G15850	3	5359008	5361185	2177	+	7024
AT3G15860	3	5361206	5361719	513	-	0
AT3G15870	3	5362887	5364544	1657	+	0
AT3G15880	3	5364080	5372293	8213	-	2362
AT3G15890	3	5374247	5376275	2028	+	97
AT3G15900	3	5376250	5377179	929	-	432
AT3G15909	3	5381602	5381740	138	+	0
AT3G15910	3	5382060	5383069	1009	+	0
AT3G15920	3	5383595	5387009	3414	-	556
AT3G15930	3	5387443	5389690	2247	+	13
AT3G15935	3	5390598	5391763	1165	-	0
AT3G15940	3	5393512	5396903	3391	-	701
AT3G15950	3	5397568	5402652	5084	-	353
AT3G15960	3	5403999	5406461	2462	-	0
AT3G15970	3	5408796	5411143	2347	-	478
AT3G15980	3	5411291	5418541	7250	-	1491
AT3G15990	3	5426986	5430880	3894	+	237
AT3G16000	3	5430888	5433817	2929	-	5825
AT3G16010	3	5434013	5436264	2251	+	199
AT3G16020	3	5438286	5438651	365	+	5
AT3G16030	3	5439608	5442802	3194	+	123
AT3G16040	3	5443090	5443952	862	+	0
AT3G16050	3	5443949	5445329	1380	-	116
AT3G16060	3	5447342	5451527	4185	+	1074
AT3G16070	3	5451863	5452316	453	-	27
AT3G16080	3	5454817	5455927	1110	+	1688
AT3G16090	3	5456143	5458966	2823	+	502
AT3G16100	3	5459171	5460790	1619	+	747
AT3G16110	3	5460792	5463760	2968	-	467
AT3G16117	3	5464542	5464710	168	+	0
AT3G16120	3	5464768	5465531	763	+	61
AT3G16130	3	5466245	5468774	2529	+	94
AT3G16140	3	5468508	5469481	973	-	22345
AT3G16150	3	5471734	5473276	1542	+	107
AT3G16160	3	5473365	5475090	1725	-	3
AT3G16170	3	5476073	5480302	4229	+	278
AT3G16175	3	5480463	5481379	916	+	90
AT3G16180	3	5481324	5485094	3770	-	181
AT3G16190	3	5489700	5491248	1548	-	457
AT3G16200	3	5491405	5493629	2224	-	303
AT3G16210	3	5494532	5495615	1083	-	1
AT3G16220	3	5497596	5499235	1639	+	711
AT3G16230	3	5500177	5503545	3368	+	788
AT3G16240	3	5505403	5507050	1647	+	9833
AT3G16250	3	5506930	5508414	1484	-	3020
AT3G16260	3	5509373	5513204	3831	+	1157
AT3G16270	3	5513272	5516932	3660	+	935
AT3G16280	3	5518330	5519246	916	+	26
AT3G16290	3	5521070	5524995	3925	-	2289
AT3G16300	3	5525490	5526207	717	-	1
AT3G16310	3	5526413	5528602	2189	-	285
AT3G16320	3	5529533	5534663	5130	+	49
AT3G16330	3	5535195	5536063	868	+	45
AT3G16340	3	5539787	5546449	6662	+	371
AT3G16350	3	5547717	5549660	1943	+	205
AT3G16360	3	5554257	5555603	1346	+	127
AT3G16370	3	5556709	5558589	1880	+	9172
AT3G16380	3	5558675	5560993	2318	-	33
AT3G16390	3	5562570	5564571	2001	+	6
AT3G16400	3	5566085	5568545	2460	+	814
AT3G16410	3	5571991	5574541	2550	+	79
AT3G16415	3	5575406	5577101	1695	+	0
AT3G16420	3	5579385	5580953	1568	+	1200
AT3G16430	3	5581662	5583187	1525	+	7
AT3G16432	3	5583942	5584128	186	+	0
AT3G16440	3	5585943	5587750	1807	+	0
AT3G16450	3	5588393	5590055	1662	+	47
AT3G16460	3	5592581	5595717	3136	+	253
AT3G16470	3	5595928	5599224	3296	-	933
AT3G16480	3	5599777	5602986	3209	+	1228
AT3G16490	3	5603899	5605697	1798	-	29
AT3G16500	3	5612499	5614410	1911	-	786
AT3G16510	3	5616991	5618294	1303	-	43
AT3G16520	3	5618439	5620873	2434	-	5092
AT3G16530	3	5624376	5625470	1094	-	445
AT3G16540	3	5626289	5628857	2568	-	3
AT3G16550	3	5629919	5632417	2498	-	0
AT3G16552	3	5632851	5632924	73	+	0
AT3G16555	3	5633425	5634542	1117	+	0
AT3G16560	3	5635595	5638482	2887	-	356
AT3G16565	3	5639838	5642737	2899	-	40
AT3G16570	3	5644697	5645414	717	+	1132
AT3G16580	3	5647375	5648746	1371	-	0
AT3G16590	3	5649931	5651056	1125	-	0
AT3G16600	3	5652838	5655670	2832	-	0
AT3G16610	3	5656370	5658335	1965	-	22
AT3G16620	3	5658316	5661963	3647	-	269
AT3G16630	3	5662383	5667803	5420	-	1507
AT3G16640	3	5669372	5670842	1470	-	18275
AT3G16650	3	5671066	5675324	4258	+	66
AT3G16660	3	5676828	5677921	1093	+	460
AT3G16670	3	5681418	5682331	913	+	1533
AT3G16680	3	5683335	5684245	910	+	1
AT3G16690	3	5684358	5686490	2132	-	61
AT3G16700	3	5687720	5689719	1999	+	118
AT3G16710	3	5690019	5691543	1524	+	70
AT3G16712	3	5691800	5692016	216	-	3
AT3G16720	3	5692737	5694127	1390	+	94
AT3G16730	3	5695409	5699167	3758	-	171
AT3G16740	3	5699332	5700826	1494	+	114
AT3G16750	3	5701010	5702541	1531	-	192
AT3G16760	3	5703012	5705313	2301	+	595
AT3G16770	3	5705661	5707023	1362	+	533
AT3G16780	3	5708924	5710579	1655	+	963
AT3G16785	3	5711081	5719023	7942	+	691
AT3G16800	3	5721019	5723185	2166	+	421
AT3G16810	3	5723248	5727620	4372	-	370
AT3G16820	3	5728015	5729174	1159	-	0
AT3G16830	3	5731533	5737772	6239	+	1196
AT3G16840	3	5737885	5743144	5259	-	707
AT3G16850	3	5748569	5751297	2728	+	2407
AT3G16851	3	5752257	5752410	153	+	0
AT3G16857	3	5755820	5759443	3623	+	871
AT3G16860	3	5759374	5762235	2861	-	59
AT3G16870	3	5763585	5764654	1069	-	207
AT3G16880	3	5766732	5767830	1098	+	0
AT3G16890	3	5768400	5770380	1980	-	106
AT3G16895	3	5770867	5771544	677	-	0
AT3G16900	3	5772105	5772849	744	+	3
AT3G16910	3	5773054	5775501	2447	-	2108
AT3G16920	3	5776485	5777889	1404	-	207
AT3G16930	3	5778875	5779363	488	+	0
AT3G16940	3	5781774	5786280	4506	+	1157
AT3G16950	3	5786384	5790525	4141	-	608
AT3G16960	3	5791811	5792264	453	-	0
AT3G16970	3	5793667	5794090	423	-	0
AT3G16980	3	5794435	5795827	1392	+	20
AT3G16990	3	5795833	5796850	1017	-	260
AT3G17000	3	5797178	5799683	2505	+	651
AT3G17010	3	5800459	5802468	2009	+	0
AT3G17020	3	5802535	5804157	1622	-	1457
AT3G17030	3	5804508	5808462	3954	-	84
AT3G17040	3	5809265	5812678	3413	-	3986
AT3G17050	3	5814747	5816592	1845	+	94
AT3G17060	3	5816671	5818498	1827	-	0
AT3G17070	3	5820960	5823199	2239	+	398
AT3G17080	3	5825288	5825867	579	+	0
AT3G17090	3	5826802	5829633	2831	+	976
AT3G17100	3	5831193	5832419	1226	+	845
AT3G17110	3	5837841	5838701	860	+	30
AT3G17120	3	5841095	5843485	2390	+	720
AT3G17130	3	5844494	5845046	552	-	83
AT3G17140	3	5846001	5846589	588	-	0
AT3G17150	3	5847257	5848195	938	+	0
AT3G17152	3	5848786	5849614	828	+	0
AT3G17155	3	5850743	5851397	654	+	0
AT3G17160	3	5852151	5853080	929	+	491
AT3G17170	3	5853058	5854906	1848	-	905
AT3G17180	3	5855860	5859157	3297	-	23
AT3G17185	3	5861490	5862437	947	+	540
AT3G17190	3	5867391	5868181	790	+	0
AT3G17200	3	5869722	5870852	1130	+	1
AT3G17203	3	5870786	5872854	2068	+	0
AT3G17205	3	5873252	5881655	8403	+	1326
AT3G17210	3	5882283	5883200	917	+	1240
AT3G17220	3	5883327	5883849	522	-	18
AT3G17225	3	5884373	5884931	558	-	33
AT3G17230	3	5886380	5889236	2856	-	4
AT3G17240	3	5889871	5892252	2381	-	1479
AT3G17250	3	5892560	5894446	1886	-	148
AT3G17260	3	5896074	5897835	1761	-	0
AT3G17261	3	5898001	5898109	108	-	0
AT3G17265	3	5899514	5900637	1123	-	0
AT3G17270	3	5902478	5902883	405	-	0
AT3G17280	3	5903452	5904613	1161	-	16
AT3G17290	3	5905051	5906716	1665	-	1
AT3G17300	3	5907233	5908893	1660	+	276
AT3G17310	3	5909000	5913242	4242	-	471
AT3G17320	3	5915426	5916656	1230	-	0
AT3G17330	3	5916939	5920188	3249	-	1050
AT3G17340	3	5920398	5926928	6530	-	628
AT3G17350	3	5934063	5935303	1240	+	168
AT3G17360	3	5936107	5946466	10359	+	312
AT3G17365	3	5946950	5948868	1918	-	178
AT3G17370	3	5949005	5949644	639	-	0
AT3G17380	3	5950199	5952235	2036	+	92
AT3G17390	3	5952186	5954084	1898	-	8330
AT3G17400	3	5954886	5955444	558	+	0
AT3G17410	3	5955908	5959106	3198	+	981
AT3G17420	3	5959211	5962179	2968	-	164
AT3G17430	3	5965922	5969233	3311	+	489
AT3G17440	3	5969563	5972502	2939	-	573
AT3G17450	3	5972670	5976118	3448	-	437
AT3G17460	3	5976948	5977545	597	-	30
AT3G17465	3	5977816	5979652	1836	-	395
AT3G17470	3	5979833	5982115	2282	+	898
AT3G17480	3	5983198	5984320	1122	+	0
AT3G17490	3	5984826	5985993	1167	+	0
AT3G17500	3	5986684	5988498	1814	+	0
AT3G17510	3	5988990	5992912	3922	-	2369
AT3G17520	3	5999288	6000370	1082	-	5
AT3G17530	3	6000859	6002282	1423	+	0
AT3G17540	3	6002782	6003973	1191	+	0
AT3G17550	3	6005113	6006004	891	-	0
AT3G17560	3	6006761	6008003	1242	+	0
AT3G17570	3	6009406	6010562	1156	+	0
AT3G17580	3	6015183	6015850	667	+	1
AT3G17590	3	6017211	6019666	2455	-	205
AT3G17600	3	6020024	6021142	1118	-	1
AT3G17609	3	6023865	6024698	833	+	389
AT3G17611	3	6024794	6026443	1649	+	177
AT3G17620	3	6026445	6027694	1249	-	0
AT3G17626	3	6027993	6028633	640	+	48
AT3G17630	3	6029200	6031773	2573	+	101
AT3G17640	3	6032392	6033583	1191	+	373
AT3G17650	3	6034197	6037229	3032	+	1436
AT3G17660	3	6037597	6039319	1722	+	42
AT3G17668	3	6039602	6040489	887	+	169
AT3G17670	3	6040819	6042588	1769	+	281
AT3G17675	3	6042243	6042850	607	-	0
AT3G17680	3	6042946	6044504	1558	-	232
AT3G17690	3	6045001	6048488	3487	+	34
AT3G17700	3	6048915	6052552	3637	+	392
AT3G17710	3	6055547	6056778	1231	+	75
AT3G17712	3	6056869	6060287	3418	+	30
AT3G17715	3	6060713	6061941	1228	+	95
AT3G17720	3	6062445	6063483	1038	+	0
AT3G17730	3	6064378	6065813	1435	+	38
AT3G17740	3	6067758	6072839	5081	-	266
AT3G17750	3	6073768	6078722	4954	+	861
AT3G17760	3	6078811	6081355	2544	-	5
AT3G17770	3	6081670	6086138	4468	-	650
AT3G17780	3	6086912	6088371	1459	+	299
AT3G17790	3	6089604	6091231	1627	+	366
AT3G17800	3	6091109	6093151	2042	-	5284
AT3G17810	3	6094097	6096566	2469	+	940
AT3G17820	3	6097413	6099595	2182	+	760
AT3G17830	3	6101788	6104650	2862	+	105
AT3G17840	3	6106027	6108675	2648	+	781
AT3G17845	3	6109202	6109325	123	-	0
AT3G17850	3	6109704	6116458	6754	-	1854
AT3G17860	3	6119766	6123019	3253	+	216
AT3G17880	3	6123408	6126281	2873	+	604
AT3G17890	3	6127040	6127874	834	+	40
AT3G17900	3	6128505	6133383	4878	+	784
AT3G17910	3	6133527	6136371	2844	+	128
AT3G17920	3	6137254	6142023	4769	+	421
AT3G17930	3	6142128	6143310	1182	-	2348
AT3G17940	3	6143518	6145337	1819	-	722
AT3G17950	3	6146240	6147348	1108	+	217
AT3G17970	3	6147961	6152018	4057	+	799
AT3G17980	3	6152120	6153434	1314	+	3
AT3G17998	3	6154362	6157551	3189	+	0
AT3G18000	3	6154362	6157552	3190	+	0
AT3G18010	3	6161136	6163272	2136	-	65
AT3G18020	3	6165448	6167515	2067	+	31
AT3G18030	3	6167639	6168948	1309	-	211
AT3G18035	3	6169089	6171724	2635	-	1844
AT3G18040	3	6174718	6178465	3747	+	593
AT3G18050	3	6180858	6182854	1996	+	2448
AT3G18060	3	6183772	6187074	3302	+	2007
AT3G18070	3	6187293	6189947	2654	+	80
AT3G18080	3	6191556	6194452	2896	+	3010
AT3G18090	3	6194563	6200237	5674	+	233
AT3G18100	3	6200523	6204644	4121	+	165
AT3G18110	3	6204841	6209691	4850	-	1016
AT3G18120	3	6210089	6210572	483	-	0
AT3G18130	3	6210903	6212433	1530	-	1055
AT3G18140	3	6212595	6214785	2190	-	1165
AT3G18145	3	6214979	6217276	2297	+	23
AT3G18150	3	6217928	6219500	1572	+	0
AT3G18160	3	6220625	6223073	2448	+	401
AT3G18165	3	6223187	6225372	2185	+	630
AT3G18170	3	6228341	6229662	1321	+	125
AT3G18180	3	6230269	6231878	1609	+	1
AT3G18190	3	6232125	6234060	1935	+	1405
AT3G18200	3	6234305	6236091	1786	-	2
AT3G18210	3	6237929	6240605	2676	-	490
AT3G18215	3	6240849	6242573	1724	+	255
AT3G18217	3	6244528	6244693	165	-	40
AT3G18220	3	6247913	6249960	2047	+	0
AT3G18230	3	6251482	6254221	2739	+	350
AT3G18235	3	6254671	6255301	630	-	0
AT3G18240	3	6255741	6258090	2349	+	196
AT3G18250	3	6258066	6258417	351	-	0
AT3G18260	3	6260240	6261591	1351	-	50
AT3G18270	3	6261904	6264309	2405	+	547
AT3G18280	3	6267048	6267643	595	+	412
AT3G18282	3	6268170	6268586	416	-	1
AT3G18290	3	6273994	6280510	6516	+	1892
AT3G18291	3	6280644	6280773	129	-	0
AT3G18295	3	6281203	6282306	1103	+	148
AT3G18300	3	6281922	6284372	2450	+	43
AT3G18310	3	6284355	6287144	2789	-	195
AT3G18320	3	6289226	6290383	1157	-	80
AT3G18330	3	6291126	6292257	1131	-	1
AT3G18340	3	6294017	6295134	1117	+	0
AT3G18350	3	6296849	6300673	3824	+	339
AT3G18360	3	6300826	6301684	858	-	2
AT3G18362	3	6302111	6303924	1813	+	0
AT3G18370	3	6305974	6310620	4646	+	911
AT3G18380	3	6310735	6313319	2584	-	328
AT3G18390	3	6313484	6317971	4487	+	4605
AT3G18400	3	6318744	6320593	1849	-	4
AT3G18410	3	6323161	6324579	1418	+	1306
AT3G18420	3	6324632	6325793	1161	-	802
AT3G18430	3	6325914	6327692	1778	+	382
AT3G18440	3	6328114	6330794	2680	+	470
AT3G18450	3	6331033	6332218	1185	-	0
AT3G18460	3	6333047	6333948	901	-	0
AT3G18470	3	6334821	6335822	1001	-	0
AT3G18480	3	6336735	6341788	5053	+	829
AT3G18485	3	6341917	6343178	1261	-	87
AT3G18490	3	6348754	6350668	1914	-	12204
AT3G18500	3	6352476	6355442	2966	+	1419
AT3G18510	3	6355663	6356153	490	+	41
AT3G18518	3	6360134	6360296	162	+	1
AT3G18520	3	6361175	6365615	4440	+	772
AT3G18524	3	6368009	6372568	4559	-	290
AT3G18530	3	6373534	6375723	2189	-	9
AT3G18535	3	6375676	6377220	1544	-	190
AT3G18550	3	6383507	6385663	2156	+	0
AT3G18560	3	6393909	6394785	876	+	42
AT3G18570	3	6395859	6396606	747	-	0
AT3G18580	3	6396930	6398190	1260	-	120
AT3G18590	3	6398669	6399337	668	+	0
AT3G18600	3	6399570	6403348	3778	-	319
AT3G18610	3	6404082	6407822	3740	-	11
AT3G18620	3	6408317	6411064	2747	+	81
AT3G18630	3	6410957	6413068	2111	-	48
AT3G18640	3	6413300	6416550	3250	-	534
AT3G18650	3	6417343	6418504	1161	-	0
AT3G18660	3	6419030	6422002	2972	-	70
AT3G18670	3	6424134	6426471	2337	-	26
AT3G18680	3	6427402	6429692	2290	+	1595
AT3G18690	3	6429533	6430514	981	-	58
AT3G18700	3	6431721	6432905	1184	-	0
AT3G18710	3	6434082	6435561	1479	-	355
AT3G18715	3	6441066	6441348	282	+	0
AT3G18720	3	6444366	6445759	1393	-	1
AT3G18730	3	6445851	6453159	7308	-	181
AT3G18740	3	6453367	6454018	651	+	2546
AT3G18750	3	6454109	6457512	3403	-	872
AT3G18760	3	6457689	6459627	1938	-	211
AT3G18770	3	6459883	6463059	3176	-	205
AT3G18773	3	6465824	6467175	1351	+	219
AT3G18777	3	6470218	6471389	1171	+	14
AT3G18779	3	6474541	6474685	144	-	0
AT3G18780	3	6474841	6477204	2363	+	7908
AT3G18790	3	6477698	6479548	1850	+	485
AT3G18800	3	6479687	6480378	691	+	191
AT3G18810	3	6480700	6483593	2893	-	0
AT3G18815	3	6483939	6484013	74	-	0
AT3G18820	3	6484067	6486247	2180	+	1286
AT3G18827	3	6488233	6488426	193	+	0
AT3G18830	3	6488861	6491273	2412	-	611
AT3G18840	3	6496197	6498234	2037	+	6
AT3G18845	3	6498512	6498816	304	-	0
AT3G18850	3	6499414	6501359	1945	-	349
AT3G18860	3	6501667	6508553	6886	+	1147
AT3G18870	3	6508384	6509343	959	-	217
AT3G18880	3	6509539	6510625	1086	+	40
AT3G18890	3	6511022	6514994	3972	+	11753
AT3G18895	3	6516217	6516290	73	+	0
AT3G18900	3	6517180	6521019	3839	+	34
AT3G18910	3	6521718	6523043	1325	+	120
AT3G18930	3	6523378	6525543	2165	-	168
AT3G18940	3	6526957	6529149	2192	-	352
AT3G18950	3	6536714	6538658	1944	+	386
AT3G18952	3	6540630	6540667	37	+	0
AT3G18955	3	6541297	6542228	931	+	0
AT3G18957	3	6541534	6541807	273	-	0
AT3G18960	3	6542508	6543676	1168	+	70
AT3G18970	3	6543317	6545432	2115	-	59
AT3G18980	3	6546462	6548062	1600	+	1030
AT3G18990	3	6548868	6551853	2985	-	378
AT3G19000	3	6553528	6555147	1619	-	401
AT3G19002	3	6554530	6555657	1127	+	1
AT3G19010	3	6556196	6558009	1813	-	413
AT3G19020	3	6558972	6562119	3147	-	123
AT3G19025	3	6562628	6563635	1007	+	0
AT3G19030	3	6563978	6564424	446	-	138
AT3G19035	3	6565948	6566053	105	+	0
AT3G19040	3	6567156	6575282	8126	-	10
AT3G19045	3	6576295	6577256	961	+	0
AT3G19050	3	6577723	6590188	12465	+	675
AT3G19055	3	6592315	6592942	627	+	0
AT3G19070	3	6593772	6594977	1205	+	0
AT3G19080	3	6595343	6598848	3505	+	191
AT3G19085	3	6599588	6600584	996	+	0
AT3G19090	3	6601465	6603709	2244	+	0
AT3G19100	3	6605475	6609295	3820	+	462
AT3G19120	3	6609411	6611059	1648	-	299
AT3G19130	3	6611197	6614044	2847	-	542
AT3G19140	3	6614909	6615335	426	-	0
AT3G19150	3	6616351	6617696	1345	-	157
AT3G19160	3	6621987	6623278	1291	-	0
AT3G19170	3	6625420	6632033	6613	-	12958
AT3G19180	3	6632675	6637224	4549	+	754
AT3G19184	3	6637442	6639278	1836	+	11
AT3G19190	3	6639710	6648857	9147	+	656
AT3G19200	3	6649227	6650077	850	-	13
AT3G19210	3	6652744	6658988	6244	-	107
AT3G19220	3	6659163	6660852	1689	+	290
AT3G19230	3	6661087	6663519	2432	-	75
AT3G19235	3	6663707	6663780	73	+	0
AT3G19240	3	6664249	6666558	2309	+	508
AT3G19250	3	6666841	6668395	1554	-	20
AT3G19260	3	6669145	6671519	2374	-	175
AT3G19270	3	6673726	6676520	2794	-	100
AT3G19274	3	6678718	6678871	153	+	0
AT3G19280	3	6681195	6683892	2697	-	210
AT3G19290	3	6687139	6690123	2984	+	689
AT3G19300	3	6690117	6693284	3167	-	104
AT3G19310	3	6694195	6696214	2019	+	9
AT3G19320	3	6696394	6698073	1679	-	3
AT3G19323	3	6698513	6699154	641	+	0
AT3G19330	3	6699322	6701300	1978	+	42
AT3G19340	3	6701272	6704226	2954	-	1238
AT3G19350	3	6705492	6706127	635	+	2
AT3G19360	3	6707240	6709028	1788	+	92
AT3G19370	3	6710719	6713650	2931	+	830
AT3G19380	3	6714391	6716099	1708	-	235
AT3G19390	3	6722988	6725027	2039	+	0
AT3G19400	3	6725467	6727000	1533	+	392
AT3G19410	3	6729584	6730706	1122	+	0
AT3G19420	3	6731375	6735623	4248	+	1956
AT3G19430	3	6736183	6738330	2147	-	1
AT3G19440	3	6740694	6743253	2559	+	68
AT3G19450	3	6744597	6747214	2617	+	3178
AT3G19460	3	6747369	6749307	1938	+	345
AT3G19470	3	6749484	6751017	1533	+	111
AT3G19480	3	6752530	6754785	2255	+	2293
AT3G19490	3	6754614	6758261	3647	-	1118
AT3G19500	3	6759015	6760939	1924	-	28
AT3G19508	3	6762126	6762720	594	-	29
AT3G19510	3	6762763	6766588	3825	-	316
AT3G19515	3	6766667	6771169	4502	-	739
AT3G19520	3	6772686	6775445	2759	+	518
AT3G19530	3	6774969	6775848	879	-	0
AT3G19540	3	6780618	6783166	2548	+	615
AT3G19550	3	6787240	6788292	1052	-	11
AT3G19553	3	6790741	6792919	2178	-	702
AT3G19560	3	6793310	6794802	1492	+	1
AT3G19570	3	6797484	6801740	4256	+	404
AT3G19580	3	6803071	6804233	1162	-	70
AT3G19590	3	6805630	6808593	2963	+	310
AT3G19595	3	6808584	6809508	924	-	0
AT3G19600	3	6810668	6811742	1074	-	0
AT3G19610	3	6812492	6814719	2227	-	0
AT3G19615	3	6814965	6815403	438	-	1
AT3G19620	3	6815612	6818308	2696	-	239
AT3G19630	3	6818386	6820743	2357	-	345
AT3G19640	3	6820925	6823306	2381	+	541
AT3G19650	3	6823507	6825261	1754	+	310
AT3G19660	3	6825520	6826006	486	-	50
AT3G19663	3	6826767	6826911	144	+	1
AT3G19670	3	6828061	6836582	8521	-	853
AT3G19680	3	6840280	6842320	2040	+	799
AT3G19690	3	6842219	6842856	637	-	0
AT3G19700	3	6843661	6847275	3614	+	0
AT3G19710	3	6846968	6849497	2529	-	3384
AT3G19720	3	6850370	6855513	5143	-	4932
AT3G19740	3	6855836	6863526	7690	-	1012
AT3G19760	3	6863712	6866593	2881	+	2377
AT3G19770	3	6866805	6869479	2674	+	362
AT3G19780	3	6870172	6874850	4678	+	420
AT3G19790	3	6874602	6875856	1254	-	172
AT3G19800	3	6876078	6877642	1564	+	2158
AT3G19810	3	6877574	6879399	1825	-	711
AT3G19820	3	6879616	6882315	2699	-	5302
AT3G19830	3	6885605	6890064	4459	-	687
AT3G19840	3	6891085	6897356	6271	+	377
AT3G19850	3	6898180	6901255	3075	-	662
AT3G19860	3	6903832	6906128	2296	+	693
AT3G19870	3	6907394	6911233	3839	+	734
AT3G19880	3	6911434	6912604	1170	-	0
AT3G19890	3	6914909	6916142	1233	-	0
AT3G19895	3	6917293	6921556	4263	-	368
AT3G19900	3	6922566	6925066	2500	-	1106
AT3G19910	3	6926307	6929567	3260	+	517
AT3G19920	3	6929710	6931806	2096	-	0
AT3G19930	3	6934772	6937120	2348	+	474
AT3G19940	3	6938210	6939975	1765	+	0
AT3G19950	3	6942768	6945224	2456	+	481
AT3G19960	3	6948773	6956966	8193	+	1264
AT3G19970	3	6958647	6961652	3005	+	241
AT3G19980	3	6961735	6965108	3373	+	598
AT3G19990	3	6965646	6967248	1602	+	435
AT3G20000	3	6967581	6970566	2985	+	874
AT3G20010	3	6971351	6976595	5244	+	380
AT3G20015	3	6978476	6980368	1892	-	135
AT3G20020	3	6983704	6988099	4395	-	214
AT3G20030	3	6990253	6991462	1209	+	0
AT3G20040	3	6994893	6998171	3278	+	105
AT3G20050	3	6998237	7002404	4167	-	2228
AT3G20060	3	7002816	7004450	1634	-	1270
AT3G20070	3	7004671	7006918	2247	-	337
AT3G20075	3	7007315	7007653	338	+	3
AT3G20080	3	7007868	7013694	5826	+	218
AT3G20083	3	7011939	7013625	1686	+	0
AT3G20085	3	7014164	7014340	176	+	0
AT3G20087	3	7014521	7015284	763	+	4
AT3G20090	3	7015796	7018360	2564	+	107
AT3G20100	3	7018994	7020901	1907	+	290
AT3G20110	3	7021331	7023279	1948	+	1
AT3G20120	3	7023310	7025923	2613	+	443
AT3G20130	3	7026928	7028836	1908	+	76
AT3G20140	3	7029174	7030787	1613	+	3
AT3G20150	3	7031331	7037010	5679	+	332
AT3G20155	3	7037134	7038375	1241	+	0
AT3G20160	3	7038994	7040029	1035	+	0
AT3G20170	3	7041726	7043341	1615	+	150
AT3G20180	3	7043384	7043841	457	-	6
AT3G20190	3	7044942	7047390	2448	+	10
AT3G20200	3	7047580	7051342	3762	+	203
AT3G20210	3	7052381	7055452	3071	+	0
AT3G20220	3	7054827	7055456	629	+	0
AT3G20230	3	7055352	7056758	1406	-	1497
AT3G20240	3	7057010	7058891	1881	+	289
AT3G20250	3	7058901	7063240	4339	-	529
AT3G20260	3	7064053	7066503	2450	-	305
AT3G20270	3	7067056	7070946	3890	+	446
AT3G20280	3	7071192	7074641	3449	+	170
AT3G20290	3	7074816	7078871	4055	-	1276
AT3G20300	3	7079616	7081921	2305	-	429
AT3G20310	3	7084805	7086805	2000	-	616
AT3G20320	3	7087470	7089862	2392	-	973
AT3G20330	3	7090105	7092670	2565	-	501
AT3G20340	3	7092899	7093501	602	-	2
AT3G20350	3	7096347	7099767	3420	+	291
AT3G20360	3	7099770	7101636	1866	-	1
AT3G20362	3	7103816	7104250	434	+	0
AT3G20365	3	7104308	7104392	84	+	0
AT3G20370	3	7105370	7107225	1855	+	54
AT3G20380	3	7108096	7109914	1818	+	7
AT3G20390	3	7109948	7111824	1876	-	3833
AT3G20395	3	7111947	7113870	1923	-	4
AT3G20400	3	7114402	7114714	312	+	0
AT3G20410	3	7116200	7119121	2921	+	498
AT3G20420	3	7119281	7120919	1638	-	113
AT3G20430	3	7121101	7123173	2072	+	179
AT3G20440	3	7123196	7130477	7281	-	200
AT3G20450	3	7130626	7131274	648	-	64
AT3G20460	3	7135049	7139472	4423	+	28
AT3G20470	3	7140439	7141228	789	-	336
AT3G20475	3	7143453	7151014	7561	+	48
AT3G20480	3	7151386	7153398	2012	-	67
AT3G20490	3	7153538	7156536	2998	-	107
AT3G20500	3	7157905	7160417	2512	+	486
AT3G20510	3	7160676	7162206	1530	+	255
AT3G20520	3	7162827	7165859	3032	+	2
AT3G20530	3	7166046	7167929	1883	+	3
AT3G20540	3	7168131	7173617	5486	+	657
AT3G20541	3	7173676	7174331	655	+	0
AT3G20550	3	7174463	7177942	3479	-	397
AT3G20555	3	7178199	7178614	415	-	0
AT3G20557	3	7180036	7181079	1043	+	0
AT3G20560	3	7182034	7186567	4533	+	296
AT3G20570	3	7186521	7187521	1000	-	307
AT3G20580	3	7187855	7190562	2707	-	1
AT3G20590	3	7191685	7192453	768	+	0
AT3G20600	3	7194845	7195736	891	+	109
AT3G20610	3	7196722	7197391	669	+	0
AT3G20620	3	7198453	7202489	4036	-	341
AT3G20630	3	7202772	7208402	5630	-	826
AT3G20640	3	7210406	7213299	2893	-	157
AT3G20650	3	7220798	7224090	3292	-	319
AT3G20655	3	7224217	7224290	73	-	0
AT3G20660	3	7225134	7228595	3461	-	47
AT3G20670	3	7229406	7230146	740	+	597
AT3G20680	3	7230067	7231194	1127	-	884
AT3G20690	3	7231569	7232682	1113	-	0
AT3G20700	3	7233524	7234505	981	-	0
AT3G20705	3	7235947	7237084	1137	-	0
AT3G20710	3	7237910	7238999	1089	-	0
AT3G20720	3	7239907	7247005	7098	+	849
AT3G20730	3	7247094	7249145	2051	+	8
AT3G20740	3	7248808	7252452	3644	-	319
AT3G20750	3	7254738	7256140	1402	+	0
AT3G20760	3	7256655	7259854	3199	-	0
AT3G20770	3	7260431	7263352	2921	-	2212
AT3G20780	3	7263899	7268572	4673	-	239
AT3G20790	3	7268751	7271287	2536	+	1049
AT3G20800	3	7271136	7273947	2811	-	359
AT3G20810	3	7275673	7278379	2706	+	41
AT3G20820	3	7280877	7282177	1300	+	3271
AT3G20830	3	7284962	7286260	1298	-	124
AT3G20840	3	7300674	7303693	3019	+	0
AT3G20850	3	7304156	7304561	405	+	0
AT3G20860	3	7306146	7308434	2288	+	162
AT3G20865	3	7308503	7308962	459	-	24
AT3G20870	3	7309278	7312752	3474	-	612
AT3G20880	3	7313537	7315883	2346	-	0
AT3G20885	3	7319576	7319658	82	-	0
AT3G20890	3	7319847	7321054	1207	+	160
AT3G20898	3	7323682	7324634	952	+	45
AT3G20900	3	7323983	7324670	687	-	0
AT3G20910	3	7326381	7328576	2195	+	169
AT3G20920	3	7328575	7330751	2176	-	499
AT3G20930	3	7331720	7334029	2309	+	868
AT3G20935	3	7334769	7335912	1143	+	5
AT3G20940	3	7339716	7341655	1939	+	1
AT3G20950	3	7342674	7344744	2070	+	0
AT3G20960	3	7345435	7347104	1669	+	22
AT3G20966	3	7347785	7347935	150	+	0
AT3G20970	3	7348196	7350305	2109	+	440
AT3G20975	3	7350576	7355332	4756	+	1
AT3G20978	3	7353906	7355339	1433	-	0
AT3G20980	3	7355962	7357966	2004	+	0
AT3G20990	3	7358839	7360154	1315	+	0
AT3G20993	3	7360558	7360897	339	-	0
AT3G20997	3	7362742	7363081	339	-	0
AT3G21000	3	7363920	7365138	1218	+	1
AT3G21010	3	7366209	7367748	1539	+	54
AT3G21020	3	7368266	7369526	1260	+	21
AT3G21030	3	7370167	7371403	1236	+	2
AT3G21040	3	7372759	7374364	1605	+	4
AT3G21050	3	7375157	7376420	1263	+	96
AT3G21055	3	7376634	7377186	552	-	35366
AT3G21060	3	7377433	7380213	2780	+	300
AT3G21070	3	7380190	7383980	3790	-	386
AT3G21080	3	7388366	7389974	1608	-	5
AT3G21090	3	7391437	7395041	3604	-	56
AT3G21100	3	7399150	7402436	3286	+	232
AT3G21110	3	7402480	7405641	3161	-	535
AT3G21120	3	7406325	7407429	1104	+	0
AT3G21130	3	7408245	7409349	1104	+	0
AT3G21140	3	7409441	7412225	2784	-	303
AT3G21150	3	7412635	7413539	904	-	135
AT3G21160	3	7413846	7418410	4564	-	522
AT3G21170	3	7419975	7421160	1185	+	0
AT3G21175	3	7422035	7424905	2870	+	279
AT3G21180	3	7425518	7432200	6682	+	1
AT3G21190	3	7432298	7434665	2367	-	907
AT3G21200	3	7436025	7438011	1986	+	2013
AT3G21210	3	7437963	7440826	2863	-	30
AT3G21215	3	7441834	7445303	3469	-	917
AT3G21220	3	7445756	7447351	1595	+	371
AT3G21230	3	7448039	7452000	3961	-	366
AT3G21240	3	7454268	7457379	3111	-	264
AT3G21250	3	7457432	7463525	6093	-	1836
AT3G21260	3	7464019	7465785	1766	-	262
AT3G21270	3	7474678	7475757	1079	+	383
AT3G21280	3	7477986	7482070	4084	-	308
AT3G21290	3	7482130	7488935	6805	+	541
AT3G21295	3	7489235	7492602	3367	+	189
AT3G21300	3	7493438	7496289	2851	-	385
AT3G21310	3	7497289	7499152	1863	+	32
AT3G21320	3	7499052	7501841	2789	-	6
AT3G21330	3	7507239	7509175	1936	+	17
AT3G21338	3	7511467	7511620	153	+	0
AT3G21340	3	7511786	7515937	4151	-	0
AT3G21350	3	7517069	7518744	1675	+	303
AT3G21351	3	7518923	7519477	554	+	5
AT3G21352	3	7519975	7520360	385	+	1
AT3G21360	3	7522803	7524580	1777	+	420
AT3G21370	3	7524053	7527652	3599	-	0
AT3G21371	3	7527703	7527910	207	+	0
AT3G21380	3	7528183	7530677	2494	+	0
AT3G21390	3	7531401	7534544	3143	+	738
AT3G21400	3	7534632	7536509	1877	-	145
AT3G21410	3	7536718	7537951	1233	-	0
AT3G21420	3	7541476	7543518	2042	+	50
AT3G21430	3	7544627	7553579	8952	-	583
AT3G21450	3	7553964	7555236	1272	-	0
AT3G21460	3	7557383	7557958	575	-	151
AT3G21465	3	7560719	7563466	2747	+	263
AT3G21470	3	7563502	7565074	1572	+	12
AT3G21475	3	7567393	7567465	72	-	0
AT3G21480	3	7567729	7572161	4432	+	219
AT3G21481	3	7572231	7572483	252	-	0
AT3G21490	3	7573064	7573669	605	+	0
AT3G21500	3	7573633	7576623	2990	-	0
AT3G21510	3	7578174	7579599	1425	-	42
AT3G21520	3	7581958	7582793	835	+	1
AT3G21530	3	7582739	7584583	1844	-	146
AT3G21540	3	7585945	7590856	4911	-	209
AT3G21550	3	7591482	7592322	840	-	290
AT3G21560	3	7595805	7597577	1772	+	841
AT3G21570	3	7600149	7600883	734	-	0
AT3G21580	3	7601968	7603885	1917	-	479
AT3G21590	3	7604550	7605789	1239	-	0
AT3G21600	3	7606506	7608407	1901	-	107
AT3G21610	3	7609142	7610717	1575	-	281
AT3G21620	3	7610957	7614461	3504	-	9
AT3G21630	3	7615384	7618581	3197	-	504
AT3G21640	3	7618929	7621477	2548	-	325
AT3G21650	3	7621568	7624076	2508	-	324
AT3G21660	3	7624494	7626654	2160	-	3
AT3G21670	3	7626756	7629151	2395	-	3294
AT3G21680	3	7633493	7633853	360	-	2
AT3G21690	3	7638662	7642205	3543	+	1508
AT3G21700	3	7644349	7646383	2034	+	217
AT3G21710	3	7648341	7649799	1458	+	8
AT3G21720	3	7652486	7656011	3525	-	0
AT3G21730	3	7659555	7661232	1677	-	0
AT3G21740	3	7662360	7664010	1650	-	82
AT3G21750	3	7664344	7666195	1851	+	917
AT3G21755	3	7666807	7668565	1758	-	13
AT3G21760	3	7667026	7668724	1698	+	39
AT3G21770	3	7673275	7674839	1564	+	125
AT3G21780	3	7675003	7676494	1491	-	10
AT3G21781	3	7676053	7676384	331	+	0
AT3G21790	3	7676926	7678414	1488	-	515
AT3G21791	3	7678714	7679271	557	-	0
AT3G21800	3	7680105	7681685	1580	-	0
AT3G21805	3	7682361	7682452	91	+	6
AT3G21810	3	7684429	7688616	4187	+	234
AT3G21820	3	7688433	7691504	3071	-	352
AT3G21830	3	7693480	7693939	459	-	0
AT3G21840	3	7695227	7695936	709	-	0
AT3G21850	3	7697088	7697550	462	-	0
AT3G21860	3	7699776	7700235	459	-	0
AT3G21865	3	7701024	7703385	2361	-	838
AT3G21870	3	7703865	7704829	964	-	329
AT3G21880	3	7706747	7708093	1346	+	2
AT3G21890	3	7709112	7709733	621	-	128
AT3G21900	3	7715392	7716343	951	+	0
AT3G21910	3	7717371	7718405	1034	+	0
AT3G21920	3	7720638	7721744	1106	+	0
AT3G21930	3	7723222	7724338	1116	+	0
AT3G21933	3	7725509	7726493	984	+	0
AT3G21937	3	7727542	7728522	980	+	0
AT3G21940	3	7729805	7731171	1366	+	0
AT3G21945	3	7732457	7733294	837	+	0
AT3G21950	3	7734395	7736394	1999	+	292
AT3G21960	3	7737155	7739542	2387	+	1
AT3G21965	3	7740233	7741147	914	+	0
AT3G21970	3	7742458	7743601	1143	+	0
AT3G21980	3	7745142	7746161	1019	+	0
AT3G21985	3	7746952	7748137	1185	+	0
AT3G21990	3	7749246	7750419	1173	+	0
AT3G22000	3	7751843	7753124	1281	+	0
AT3G22010	3	7754310	7755762	1452	+	0
AT3G22020	3	7756576	7757491	915	+	0
AT3G22022	3	7757828	7758032	204	+	0
AT3G22030	3	7759316	7760738	1422	+	0
AT3G22040	3	7761806	7762675	869	+	0
AT3G22050	3	7764130	7765143	1013	+	0
AT3G22053	3	7767432	7768526	1094	+	0
AT3G22057	3	7769345	7770261	916	+	0
AT3G22060	3	7771015	7772340	1325	+	356
AT3G22070	3	7775328	7776109	781	-	4
AT3G22072	3	7775328	7776207	879	+	3
AT3G22080	3	7777817	7781718	3901	-	0
AT3G22090	3	7782911	7783561	650	+	5
AT3G22100	3	7783710	7784469	759	-	34
AT3G22104	3	7789375	7792380	3005	+	691
AT3G22110	3	7792637	7794165	1528	-	2355
AT3G22120	3	7794956	7796310	1354	-	1755
AT3G22121	3	7795605	7796327	722	+	0
AT3G22133	3	7799041	7800000	959	+	0
AT3G22136	3	7801743	7802408	665	-	0
AT3G22142	3	7803603	7808046	4443	-	298
AT3G22150	3	7812943	7815928	2985	+	1177
AT3G22160	3	7817856	7818985	1129	-	4
AT3G22170	3	7822017	7826085	4068	-	1249
AT3G22180	3	7827035	7830813	3778	+	161
AT3G22183	3	7831128	7831371	243	+	0
AT3G22190	3	7830904	7834049	3145	-	381
AT3G22200	3	7835143	7839061	3918	+	1925
AT3G22210	3	7838783	7839467	684	-	1185
AT3G22220	3	7839554	7842874	3320	-	449
AT3G22230	3	7843966	7844597	631	-	1803
AT3G22231	3	7845822	7846605	783	-	1186
AT3G22232	3	7849840	7850289	449	+	0
AT3G22234	3	7852902	7853476	574	+	0
AT3G22235	3	7854418	7855814	1396	-	476
AT3G22237	3	7859876	7860331	455	+	0
AT3G22238	3	7861994	7862568	574	+	0
AT3G22240	3	7863615	7864819	1204	-	6
AT3G22250	3	7867752	7870229	2477	+	1
AT3G22260	3	7870891	7873548	2657	+	125
AT3G22270	3	7874144	7878468	4324	+	744
AT3G22275	3	7878981	7879808	827	-	0
AT3G22290	3	7881560	7885579	4019	+	496
AT3G22300	3	7885667	7886820	1153	+	313
AT3G22310	3	7887285	7890019	2734	+	307
AT3G22320	3	7890863	7892347	1484	-	896
AT3G22330	3	7892536	7895366	2830	+	653
AT3G22340	3	7897483	7898398	915	+	0
AT3G22345	3	7899214	7900514	1300	+	0
AT3G22350	3	7901904	7903041	1137	+	0
AT3G22360	3	7904155	7905384	1229	+	0
AT3G22370	3	7906790	7908740	1950	+	1063
AT3G22380	3	7912904	7919510	6606	+	5136
AT3G22400	3	7926878	7931351	4473	+	140
AT3G22410	3	7933166	7935808	2642	-	84
AT3G22415	3	7941013	7941564	551	+	10
AT3G22420	3	7946525	7949096	2571	+	1076
AT3G22421	3	7949115	7950396	1281	-	0
AT3G22425	3	7951054	7953223	2169	+	577
AT3G22430	3	7953259	7957884	4625	+	169
AT3G22436	3	7957897	7958020	123	-	0
AT3G22440	3	7959753	7962200	2447	+	4313
AT3G22450	3	7962442	7963378	936	+	14
AT3G22460	3	7963536	7965907	2371	+	39
AT3G22470	3	7965953	7967990	2037	-	95
AT3G22480	3	7968077	7969705	1628	+	416
AT3G22490	3	7969680	7970843	1163	-	0
AT3G22492	3	7971070	7971575	505	+	0
AT3G22500	3	7971624	7972907	1283	-	0
AT3G22510	3	7973428	7974292	864	+	0
AT3G22520	3	7974761	7977590	2829	+	765
AT3G22530	3	7977603	7978635	1032	-	664
AT3G22540	3	7984075	7984627	552	-	79
AT3G22550	3	7991645	7993454	1809	-	877
AT3G22555	3	7995485	7996636	1151	+	4
AT3G22560	3	7998856	7999533	677	-	31
AT3G22570	3	8000514	8001238	724	-	0
AT3G22580	3	8002761	8003145	384	-	0
AT3G22590	3	8003933	8005579	1646	+	268
AT3G22600	3	8006507	8007471	964	-	39
AT3G22620	3	8008533	8009590	1057	+	20
AT3G22630	3	8009539	8010844	1305	-	731
AT3G22640	3	8011723	8013902	2179	-	0
AT3G22650	3	8014808	8015960	1152	+	0
AT3G22660	3	8016050	8017508	1458	-	295
AT3G22670	3	8017770	8019459	1689	-	65
AT3G22680	3	8019707	8020508	801	+	154
AT3G22690	3	8021228	8024534	3306	-	37
AT3G22700	3	8024797	8025814	1017	-	0
AT3G22710	3	8026201	8027274	1073	-	0
AT3G22720	3	8028960	8030097	1137	-	0
AT3G22723	3	8030473	8030629	156	+	0
AT3G22730	3	8031340	8032459	1119	-	0
AT3G22740	3	8032958	8035809	2851	-	271
AT3G22750	3	8037215	8039903	2688	-	231
AT3G22760	3	8044454	8047530	3076	+	482
AT3G22770	3	8047683	8048667	984	-	0
AT3G22780	3	8048801	8052260	3459	+	819
AT3G22790	3	8052317	8058764	6447	-	771
AT3G22800	3	8062887	8064556	1669	-	0
AT3G22810	3	8068515	8071559	3044	+	157
AT3G22820	3	8073270	8074138	868	-	20
AT3G22830	3	8078819	8081051	2232	+	0
AT3G22840	3	8084446	8085560	1114	-	853
AT3G22845	3	8087306	8088747	1441	+	837
AT3G22850	3	8089002	8090470	1468	+	426
AT3G22860	3	8090653	8093248	2595	-	0
AT3G22870	3	8096229	8097471	1242	+	0
AT3G22880	3	8097686	8100820	3134	-	242
AT3G22886	3	8108020	8108622	602	+	12
AT3G22890	3	8112722	8114992	2270	+	13078
AT3G22900	3	8115176	8116253	1077	+	39
AT3G22910	3	8116334	8119388	3054	-	53
AT3G22920	3	8122712	8123411	699	-	0
AT3G22930	3	8124082	8125931	1849	-	11
AT3G22937	3	8130268	8130907	639	-	0
AT3G22940	3	8131467	8132706	1239	+	0
AT3G22942	3	8134189	8136204	2015	+	65
AT3G22945	3	8135876	8136084	208	+	0
AT3G22950	3	8136180	8138084	1904	-	461
AT3G22955	3	8138496	8138965	469	+	0
AT3G22960	3	8139234	8141985	2751	+	5389
AT3G22961	3	8142137	8142809	672	+	9
AT3G22968	3	8152037	8154149	2112	+	0
AT3G22970	3	8152037	8154149	2112	+	0
AT3G22980	3	8160155	8163316	3161	-	245
AT3G22990	3	8163949	8166345	2396	+	522
AT3G23000	3	8172596	8174131	1535	+	2691
AT3G23010	3	8174857	8176645	1788	+	42
AT3G23020	3	8177214	8179743	2529	-	70
AT3G23030	3	8180767	8181800	1033	-	764
AT3G23040	3	8186079	8186890	811	+	0
AT3G23050	3	8194678	8197153	2475	+	2005
AT3G23060	3	8200635	8203233	2598	+	0
AT3G23070	3	8203468	8207419	3951	+	1410
AT3G23080	3	8207286	8209329	2043	-	1619
AT3G23085	3	8209763	8211155	1392	-	0
AT3G23090	3	8214300	8217087	2787	-	195
AT3G23100	3	8220681	8226400	5719	+	136
AT3G23109	3	8226790	8227003	213	+	4
AT3G23110	3	8222363	8224871	2508	-	344
AT3G23120	3	8227221	8229576	2355	-	169
AT3G23125	3	8236160	8236246	86	+	1
AT3G23130	3	8242301	8243372	1071	+	0
AT3G23140	3	8250578	8251097	519	+	0
AT3G23145	3	8252137	8253196	1059	+	0
AT3G23150	3	8254662	8257735	3073	+	20
AT3G23160	3	8259854	8262028	2174	-	188
AT3G23165	3	8264649	8265060	411	-	0
AT3G23167	3	8266217	8266585	368	-	0
AT3G23170	3	8267941	8268735	794	-	165
AT3G23171	3	8269715	8269859	144	-	0
AT3G23172	3	8272137	8272657	520	-	0
AT3G23175	3	8273999	8275470	1471	-	4
AT3G23180	3	8277036	8278396	1360	+	2
AT3G23190	3	8279288	8280912	1624	+	7
AT3G23200	3	8281362	8282778	1416	+	97
AT3G23210	3	8283089	8285081	1992	-	305
AT3G23220	3	8287949	8288388	439	+	0
AT3G23230	3	8289646	8290066	420	-	14
AT3G23240	3	8295643	8296604	961	+	0
AT3G23245	3	8300380	8300833	453	-	0
AT3G23250	3	8309208	8310826	1618	+	4
AT3G23255	3	8311721	8313125	1404	+	169
AT3G23260	3	8313333	8314422	1089	+	32
AT3G23270	3	8316435	8320337	3902	+	1
AT3G23280	3	8321349	8324428	3079	+	925
AT3G23290	3	8326824	8328132	1308	+	390
AT3G23300	3	8333024	8336146	3122	+	1170
AT3G23310	3	8338899	8343632	4733	+	876
AT3G23320	3	8344628	8345204	576	+	0
AT3G23325	3	8345770	8347062	1292	+	276
AT3G23326	3	8346392	8346639	247	+	0
AT3G23330	3	8347199	8349347	2148	+	47
AT3G23340	3	8350802	8353959	3157	+	424
AT3G23350	3	8354103	8355201	1098	+	0
AT3G23360	3	8355256	8356381	1125	-	0
AT3G23370	3	8357584	8360865	3281	+	20
AT3G23380	3	8373946	8374708	762	+	0
AT3G23390	3	8375371	8376392	1021	+	1862
AT3G23400	3	8376443	8378305	1862	-	6733
AT3G23410	3	8382804	8386148	3344	+	841
AT3G23420	3	8386272	8387324	1052	-	0
AT3G23430	3	8387507	8393296	5789	-	735
AT3G23440	3	8404357	8404684	327	-	14
AT3G23450	3	8410432	8412193	1761	+	914
AT3G23460	3	8412318	8414319	2001	+	0
AT3G23470	3	8414709	8418165	3456	+	0
AT3G23480	3	8418800	8422916	4116	+	238
AT3G23490	3	8423010	8424652	1642	-	1601
AT3G23510	3	8427659	8433314	5655	+	144
AT3G23530	3	8436670	8442846	6176	+	1450
AT3G23540	3	8443444	8448070	4626	+	567
AT3G23550	3	8448272	8450697	2425	-	15
AT3G23560	3	8454115	8456681	2566	-	154
AT3G23570	3	8457777	8459691	1914	-	1064
AT3G23580	3	8460044	8462815	2771	+	693
AT3G23590	3	8467448	8473627	6179	+	1084
AT3G23600	3	8473774	8475888	2114	+	2834
AT3G23605	3	8476570	8477392	822	+	67
AT3G23610	3	8478121	8479857	1736	+	104
AT3G23620	3	8480024	8482157	2133	+	517
AT3G23630	3	8488694	8490210	1516	+	8
AT3G23633	3	8496439	8497281	842	-	0
AT3G23635	3	8497940	8498072	132	-	4
AT3G23637	3	8499726	8499888	162	-	0
AT3G23640	3	8501809	8509584	7775	+	1706
AT3G23645	3	8509761	8510165	404	-	0
AT3G23650	3	8510688	8511196	508	-	0
AT3G23660	3	8513456	8517790	4334	-	816
AT3G23670	3	8519163	8525289	6126	+	306
AT3G23680	3	8526365	8527173	808	-	0
AT3G23685	3	8527238	8528317	1079	+	0
AT3G23690	3	8528631	8531012	2381	-	810
AT3G23700	3	8531428	8533788	2360	-	4991
AT3G23710	3	8534031	8536374	2343	+	229
AT3G23715	3	8536849	8537273	424	+	0
AT3G23720	3	8537364	8537610	246	+	0
AT3G23725	3	8538451	8542993	4542	+	0
AT3G23727	3	8544862	8545355	493	+	0
AT3G23730	3	8550109	8551335	1226	+	417
AT3G23740	3	8551771	8554745	2974	-	141
AT3G23750	3	8558331	8561428	3097	+	1043
AT3G23760	3	8562828	8564670	1842	-	375
AT3G23770	3	8565493	8567496	2003	+	0
AT3G23780	3	8567724	8574209	6485	-	563
AT3G23790	3	8575166	8581112	5946	+	239
AT3G23800	3	8581653	8583835	2182	+	2
AT3G23805	3	8586381	8587056	675	+	392
AT3G23810	3	8587663	8589713	2050	-	6764
AT3G23820	3	8603443	8605462	2019	+	4492
AT3G23830	3	8606476	8608083	1607	-	331
AT3G23840	3	8611125	8612690	1565	+	494
AT3G23850	3	8615563	8616533	970	+	0
AT3G23860	3	8616952	8617645	693	-	0
AT3G23870	3	8619191	8621907	2716	+	23
AT3G23880	3	8621985	8623162	1177	-	189
AT3G23890	3	8624749	8631327	6578	+	889
AT3G23900	3	8631583	8636059	4476	-	994
AT3G23910	3	8636426	8639442	3016	-	136
AT3G23920	3	8641568	8644449	2881	+	2802
AT3G23930	3	8646891	8647908	1017	+	77
AT3G23940	3	8648673	8652605	3932	+	1816
AT3G23950	3	8652907	8654164	1257	-	0
AT3G23955	3	8655022	8657439	2417	-	2
AT3G23960	3	8657735	8658944	1209	+	3
AT3G23970	3	8660446	8661688	1242	-	0
AT3G23980	3	8662432	8667752	5320	-	825
AT3G23990	3	8668917	8672578	3661	+	1636
AT3G24000	3	8672773	8674881	2108	+	36
AT3G24005	3	8675259	8675746	487	+	0
AT3G24010	3	8675955	8678220	2265	-	354
AT3G24020	3	8678737	8679656	919	+	26
AT3G24030	3	8679551	8680824	1273	-	427
AT3G24040	3	8680876	8683289	2413	-	577
AT3G24050	3	8685872	8687677	1805	+	959
AT3G24060	3	8689588	8690032	444	-	0
AT3G24065	3	8690736	8691144	408	-	8
AT3G24068	3	8692190	8692676	486	-	0
AT3G24070	3	8693084	8694709	1625	+	318
AT3G24080	3	8694904	8697124	2220	-	754
AT3G24090	3	8697837	8700971	3134	-	97
AT3G24093	3	8701321	8702466	1145	-	0
AT3G24100	3	8703285	8704228	943	+	607
AT3G24110	3	8704428	8705413	985	-	38
AT3G24120	3	8705635	8708315	2680	-	412
AT3G24130	3	8711662	8713424	1762	-	0
AT3G24140	3	8715235	8718211	2976	-	360
AT3G24150	3	8724158	8725912	1754	-	304
AT3G24160	3	8726121	8729389	3268	+	3661
AT3G24170	3	8729509	8734562	5053	-	3984
AT3G24180	3	8734633	8741725	7092	-	1329
AT3G24190	3	8743252	8747901	4649	+	4642
AT3G24200	3	8747830	8751634	3804	-	581
AT3G24210	3	8753473	8756065	2592	-	0
AT3G24216	3	8759712	8759814	102	-	0
AT3G24220	3	8761433	8763172	1739	+	0
AT3G24225	3	8768845	8769172	327	+	0
AT3G24230	3	8774615	8777407	2792	+	9
AT3G24240	3	8780423	8784368	3945	+	2
AT3G24250	3	8786688	8787391	703	+	0
AT3G24255	3	8788852	8793371	4519	+	21
AT3G24260	3	8793836	8794961	1125	-	0
AT3G24270	3	8796540	8797031	491	-	0
AT3G24280	3	8798933	8799401	468	-	0
AT3G24290	3	8801399	8802890	1491	-	0
AT3G24300	3	8805630	8807388	1758	-	4
AT3G24310	3	8811130	8812364	1234	-	0
AT3G24315	3	8820454	8822820	2366	-	300
AT3G24320	3	8822978	8829694	6716	-	236
AT3G24330	3	8830335	8831838	1503	+	0
AT3G24332	3	8830335	8831838	1503	-	0
AT3G24340	3	8832084	8835722	3638	-	31
AT3G24350	3	8837607	8839702	2095	+	482
AT3G24360	3	8839727	8842831	3104	-	40
AT3G24365	3	8843712	8848114	4402	+	0
AT3G24370	3	8848780	8849344	564	-	0
AT3G24380	3	8850137	8850830	693	-	0
AT3G24385	3	8851745	8852437	692	-	0
AT3G24390	3	8852802	8857631	4829	-	0
AT3G24400	3	8858483	8861822	3339	-	5
AT3G24420	3	8862839	8864914	2075	-	617
AT3G24430	3	8868582	8872201	3619	-	4694
AT3G24440	3	8876026	8878171	2145	-	341
AT3G24450	3	8880064	8881722	1658	-	37
AT3G24460	3	8885817	8893050	7233	-	2952
AT3G24465	3	8894876	8895140	264	-	0
AT3G24480	3	8901153	8902638	1485	-	1247
AT3G24490	3	8910769	8912196	1427	+	451
AT3G24495	3	8912342	8918146	5804	-	229
AT3G24500	3	8918678	8919683	1005	+	340
AT3G24503	3	8919559	8923073	3514	-	2072
AT3G24506	3	8928168	8929329	1161	-	406
AT3G24508	3	8930155	8930544	389	+	0
AT3G24510	3	8931976	8932708	732	+	0
AT3G24513	3	8933919	8934390	471	+	0
AT3G24515	3	8934471	8936279	1808	-	74
AT3G24516	3	8937587	8937776	189	-	0
AT3G24517	3	8938105	8938641	536	-	0
AT3G24518	3	8938259	8942488	4229	-	11
AT3G24520	3	8941065	8942874	1809	+	35
AT3G24530	3	8945424	8947938	2514	-	536
AT3G24535	3	8952005	8952572	567	+	21
AT3G24540	3	8952902	8955621	2719	+	0
AT3G24542	3	8956256	8957667	1411	+	0
AT3G24550	3	8960257	8963568	3311	+	1074
AT3G24560	3	8963769	8966616	2847	+	270
AT3G24570	3	8966520	8968657	2137	-	514
AT3G24580	3	8969161	8970298	1137	+	0
AT3G24590	3	8970671	8972168	1497	+	1158
AT3G24600	3	8972194	8974867	2673	-	4
AT3G24610	3	8975365	8978102	2737	-	2
AT3G24612	3	8979066	8979153	87	-	0
AT3G24614	3	8979283	8979423	140	-	0
AT3G24615	3	8979503	8979605	102	-	1
AT3G24620	3	8980694	8982793	2099	-	0
AT3G24630	3	8988054	8990873	2819	+	148
AT3G24640	3	8992264	8992910	646	+	0
AT3G24650	3	8997369	9001063	3694	+	0
AT3G24660	3	9003575	9005943	2368	+	231
AT3G24670	3	9005938	9008801	2863	-	152
AT3G24675	3	9011348	9015500	4152	-	7
AT3G24680	3	9015499	9016963	1464	-	0
AT3G24690	3	9020650	9021491	841	+	0
AT3G24700	3	9022280	9023030	750	+	0
AT3G24710	3	9024166	9024367	201	-	0
AT3G24715	3	9025848	9029948	4100	+	133
AT3G24730	3	9030005	9030894	889	-	129
AT3G24740	3	9031095	9033796	2701	+	612
AT3G24750	3	9036267	9037757	1490	+	26
AT3G24760	3	9040087	9041834	1747	+	197
AT3G24770	3	9046532	9047463	931	+	771
AT3G24780	3	9049445	9051593	2148	+	54
AT3G24790	3	9052981	9054531	1550	+	1
AT3G24800	3	9055508	9057998	2490	+	341
AT3G24810	3	9060895	9061998	1103	+	43
AT3G24820	3	9062364	9064378	2014	-	154
AT3G24830	3	9064531	9066089	1558	+	4494
AT3G24840	3	9066839	9070626	3787	+	170
AT3G24850	3	9071104	9072184	1080	+	0
AT3G24860	3	9073622	9074682	1060	+	138
AT3G24870	3	9074664	9085048	10384	-	225
AT3G24880	3	9086241	9095537	9296	-	130
AT3G24890	3	9097513	9098945	1432	+	80
AT3G24900	3	9099182	9101837	2655	-	2
AT3G24927	3	9103086	9103989	903	+	229
AT3G24929	3	9104494	9105648	1154	+	44
AT3G24982	3	9105999	9108937	2938	-	58
AT3G25010	3	9110102	9112748	2646	-	108
AT3G25011	3	9113167	9113281	114	-	6
AT3G25013	3	9113874	9116188	2314	+	49
AT3G25014	3	9114545	9114707	162	-	5
AT3G25020	3	9116867	9119540	2673	-	122
AT3G25030	3	9122196	9123502	1306	+	185
AT3G25040	3	9124303	9126298	1995	+	811
AT3G25050	3	9126850	9128416	1566	+	0
AT3G25060	3	9128515	9130321	1806	+	4
AT3G25070	3	9132309	9134030	1721	+	660
AT3G25080	3	9136630	9138052	1422	+	0
AT3G25090	3	9140038	9141094	1056	-	0
AT3G25099	3	9143782	9143890	108	-	0
AT3G25100	3	9143998	9146209	2211	+	117
AT3G25110	3	9146270	9148486	2216	-	251
AT3G25120	3	9149543	9151123	1580	-	306
AT3G25130	3	9152403	9153871	1468	+	122
AT3G25140	3	9154710	9156845	2135	+	1443
AT3G25150	3	9156956	9160100	3144	-	998
AT3G25160	3	9160167	9162067	1900	-	0
AT3G25165	3	9163339	9163893	554	-	0
AT3G25170	3	9165743	9166253	510	-	0
AT3G25180	3	9167283	9169282	1999	-	0
AT3G25182	3	9171055	9172204	1149	-	0
AT3G25190	3	9174456	9175776	1320	+	121
AT3G25200	3	9176931	9178268	1337	+	0
AT3G25210	3	9180347	9181839	1492	+	107
AT3G25220	3	9182615	9184679	2064	+	744
AT3G25221	3	9184687	9184792	105	+	1
AT3G25225	3	9184969	9186171	1202	+	0
AT3G25230	3	9188180	9191419	3239	+	1669
AT3G25233	3	9191831	9191924	93	-	0
AT3G25240	3	9192539	9193385	846	+	0
AT3G25250	3	9195502	9197124	1622	+	4
AT3G25260	3	9199437	9202000	2563	+	0
AT3G25265	3	9202879	9203623	744	-	0
AT3G25270	3	9203933	9204965	1032	-	0
AT3G25280	3	9206182	9208036	1854	+	0
AT3G25290	3	9208936	9210599	1663	+	97
AT3G25400	3	9213155	9214281	1126	+	75
AT3G25410	3	9214338	9216490	2152	-	956
AT3G25420	3	9217831	9220925	3094	+	0
AT3G25430	3	9221185	9223770	2585	+	169
AT3G25440	3	9223966	9225710	1744	+	120
AT3G25450	3	9226963	9231109	4146	+	0
AT3G25460	3	9231580	9232666	1086	-	0
AT3G25470	3	9232918	9235213	2295	+	1479
AT3G25480	3	9235195	9236607	1412	-	1226
AT3G25485	3	9236886	9240548	3662	-	0
AT3G25490	3	9241724	9243485	1761	+	1
AT3G25495	3	9244324	9250768	6444	+	400
AT3G25500	3	9251092	9255002	3910	-	1007
AT3G25510	3	9260837	9268797	7960	-	23
AT3G25520	3	9269292	9271400	2108	-	7981
AT3G25530	3	9271799	9273615	1816	-	3453
AT3G25540	3	9274334	9276685	2351	+	544
AT3G25545	3	9276844	9278629	1785	+	270
AT3G25550	3	9278877	9279587	710	+	0
AT3G25560	3	9279512	9282860	3348	-	831
AT3G25570	3	9287177	9289338	2161	-	0
AT3G25572	3	9287262	9289338	2076	-	0
AT3G25573	3	9290312	9290810	498	+	0
AT3G25577	3	9291685	9292092	407	+	1
AT3G25580	3	9292484	9294347	1863	+	294
AT3G25585	3	9295308	9298746	3438	+	1193
AT3G25590	3	9302009	9303615	1606	+	232
AT3G25597	3	9305921	9306766	845	+	20
AT3G25600	3	9307253	9307967	714	+	88
AT3G25610	3	9308941	9313353	4412	-	117
AT3G25620	3	9316073	9319571	3498	-	174
AT3G25630	3	9331655	9332465	810	-	0
AT3G25640	3	9333718	9334804	1086	+	35
AT3G25650	3	9335875	9336459	584	-	0
AT3G25655	3	9337531	9338065	534	-	0
AT3G25660	3	9339422	9342204	2782	-	3795
AT3G25670	3	9344531	9346301	1770	-	155
AT3G25680	3	9349611	9352427	2816	+	484
AT3G25690	3	9353009	9357953	4944	+	11982
AT3G25700	3	9358718	9360463	1745	+	245
AT3G25710	3	9369518	9371394	1876	+	237
AT3G25715	3	9372373	9372447	74	-	0
AT3G25716	3	9373117	9373413	296	-	0
AT3G25717	3	9375101	9375671	570	-	661
AT3G25719	3	9379915	9380068	153	-	0
AT3G25720	3	9380233	9381405	1172	+	0
AT3G25725	3	9388312	9393066	4754	+	0
AT3G25727	3	9393510	9394334	824	-	0
AT3G25730	3	9396419	9397747	1328	+	20
AT3G25740	3	9397785	9399762	1977	+	532
AT3G25750	3	9400954	9402088	1134	+	0
AT3G25760	3	9403882	9405250	1368	+	442
AT3G25770	3	9406872	9407955	1083	+	1137
AT3G25780	3	9409289	9410567	1278	+	15
AT3G25790	3	9413126	9415003	1877	+	0
AT3G25795	3	9417550	9418705	1155	-	4
AT3G25800	3	9422587	9426044	3457	-	1269
AT3G25805	3	9426275	9428192	1917	-	720
AT3G25810	3	9430766	9433844	3078	+	0
AT3G25815	3	9434958	9438429	3471	-	0
AT3G25820	3	9439245	9442507	3262	+	0
AT3G25826	3	9444550	9446811	2261	-	0
AT3G25830	3	9447507	9450420	2913	+	0
AT3G25840	3	9451860	9457554	5694	-	1572
AT3G25850	3	9458177	9458954	777	-	0
AT3G25855	3	9459420	9460295	875	-	11
AT3G25860	3	9460559	9462787	2228	+	1963
AT3G25870	3	9463315	9464283	968	-	84
AT3G25880	3	9469712	9470033	321	-	11
AT3G25882	3	9470416	9470950	534	-	14
AT3G25890	3	9475349	9477460	2111	+	319
AT3G25900	3	9480824	9482926	2102	+	106
AT3G25905	3	9486167	9486771	604	-	37
AT3G25910	3	9489220	9491130	1910	+	735
AT3G25920	3	9491054	9492635	1581	-	12065
AT3G25930	3	9492844	9493953	1109	-	0
AT3G25940	3	9494696	9496092	1396	+	101
AT3G25950	3	9496101	9497271	1170	+	0
AT3G25960	3	9498438	9499932	1494	+	0
AT3G25970	3	9500115	9502221	2106	-	15
AT3G25980	3	9503055	9504680	1625	+	226
AT3G25990	3	9504676	9506787	2111	-	12
AT3G26000	3	9506777	9509258	2481	-	1182
AT3G26010	3	9511900	9513316	1416	+	0
AT3G26020	3	9513695	9516869	3174	+	448
AT3G26030	3	9517312	9519559	2247	+	1443
AT3G26040	3	9519740	9521070	1330	+	27
AT3G26050	3	9521781	9524552	2771	+	73
AT3G26060	3	9524724	9526407	1683	+	13145
AT3G26070	3	9526713	9528583	1870	+	5714
AT3G26080	3	9528773	9530496	1723	+	689
AT3G26085	3	9530594	9532613	2019	+	1116
AT3G26090	3	9532747	9535629	2882	+	147
AT3G26100	3	9536922	9540453	3531	+	1534
AT3G26110	3	9541482	9542114	632	+	0
AT3G26115	3	9542277	9544377	2100	+	177
AT3G26120	3	9546397	9549453	3056	+	0
AT3G26125	3	9551811	9553437	1626	+	26
AT3G26130	3	9553707	9555611	1904	-	1
AT3G26134	3	9557435	9557799	364	-	7
AT3G26140	3	9559681	9563070	3389	-	0
AT3G26147	3	9565082	9565250	168	-	0
AT3G26150	3	9565626	9567226	1600	-	0
AT3G26160	3	9568279	9569886	1607	-	0
AT3G26165	3	9570417	9571979	1562	-	550
AT3G26170	3	9573359	9575148	1789	-	192
AT3G26180	3	9578216	9580086	1870	-	1340
AT3G26190	3	9583464	9585109	1645	-	0
AT3G26200	3	9589281	9591179	1898	+	34
AT3G26210	3	9593131	9595243	2112	-	120
AT3G26220	3	9596076	9597833	1757	-	71
AT3G26230	3	9598004	9599959	1955	-	374
AT3G26235	3	9602004	9602773	769	+	6
AT3G26240	3	9603888	9607192	3304	-	399
AT3G26250	3	9611695	9613168	1473	-	0
AT3G26260	3	9613764	9618497	4733	+	0
AT3G26265	3	9620522	9624054	3532	-	0
AT3G26270	3	9627561	9629200	1639	-	0
AT3G26280	3	9630199	9632009	1810	-	1475
AT3G26290	3	9632681	9634470	1789	-	2325
AT3G26295	3	9636700	9638348	1648	-	0
AT3G26300	3	9639198	9640866	1668	-	841
AT3G26310	3	9641088	9642779	1691	-	594
AT3G26320	3	9644382	9646064	1682	-	81
AT3G26330	3	9646804	9648584	1780	-	47
AT3G26340	3	9650416	9652897	2481	-	370
AT3G26350	3	9653659	9654730	1071	-	21
AT3G26360	3	9655656	9656545	889	-	286
AT3G26370	3	9656743	9659935	3192	+	746
AT3G26380	3	9660064	9663298	3234	+	704
AT3G26390	3	9663449	9663950	501	-	0
AT3G26400	3	9666615	9669162	2547	+	470
AT3G26410	3	9669415	9671348	1933	-	111
AT3G26420	3	9671516	9676005	4489	+	3
AT3G26430	3	9671516	9675927	4411	+	28
AT3G26440	3	9676563	9679900	3337	+	28
AT3G26445	3	9680119	9680746	627	-	77
AT3G26450	3	9681297	9683434	2137	-	2633
AT3G26460	3	9683872	9684657	785	-	20
AT3G26470	3	9686097	9687642	1545	+	29
AT3G26480	3	9687272	9690827	3555	-	37
AT3G26483	3	9692368	9697032	4664	-	0
AT3G26486	3	9697582	9697898	316	+	0
AT3G26490	3	9704141	9706161	2020	+	157
AT3G26500	3	9708108	9709964	1856	-	13
AT3G26510	3	9710336	9712660	2324	-	1432
AT3G26511	3	9713087	9713186	99	-	0
AT3G26520	3	9722442	9723815	1373	-	24337
AT3G26525	3	9725746	9729098	3352	+	0
AT3G26530	3	9731099	9735541	4442	-	0
AT3G26539	3	9743728	9743842	114	-	6
AT3G26540	3	9744541	9746644	2103	-	60
AT3G26550	3	9746894	9749046	2152	-	9
AT3G26560	3	9749903	9753772	3869	-	1271
AT3G26561	3	9753911	9754118	207	-	0
AT3G26570	3	9756190	9758633	2443	+	13043
AT3G26580	3	9758886	9760544	1658	+	1703
AT3G26590	3	9761699	9765315	3616	-	478
AT3G26600	3	9769743	9772035	2292	+	376
AT3G26605	3	9773017	9773500	483	+	0
AT3G26610	3	9776959	9780499	3540	+	0
AT3G26612	3	9781982	9783412	1430	+	149
AT3G26614	3	9784889	9787571	2682	-	19
AT3G26616	3	9787573	9788141	568	-	4
AT3G26618	3	9788604	9790351	1747	+	646
AT3G26620	3	9790627	9791117	490	+	0
AT3G26630	3	9791370	9792985	1615	-	639
AT3G26640	3	9793219	9794457	1238	+	252
AT3G26650	3	9795070	9797045	1975	+	96698
AT3G26660	3	9797128	9797620	492	-	1
AT3G26670	3	9797985	9801169	3184	-	585
AT3G26680	3	9801213	9804282	3069	+	149
AT3G26690	3	9804252	9805715	1463	-	97
AT3G26700	3	9809949	9812664	2715	+	313
AT3G26710	3	9813370	9814750	1380	+	3156
AT3G26720	3	9816580	9823186	6606	+	1250
AT3G26730	3	9823684	9827438	3754	+	1801
AT3G26740	3	9827800	9828680	880	+	3997
AT3G26742	3	9831035	9831858	823	+	8
AT3G26744	3	9832688	9835247	2559	-	1431
AT3G26747	3	9839183	9839257	74	+	0
AT3G26750	3	9839975	9842079	2104	-	82
AT3G26760	3	9843590	9845176	1586	+	40
AT3G26770	3	9845395	9847148	1753	+	16
AT3G26775	3	9847231	9848665	1434	-	0
AT3G26780	3	9848627	9850472	1845	+	859
AT3G26782	3	9850569	9852864	2295	+	44
AT3G26790	3	9853827	9855989	2162	-	13
AT3G26800	3	9862172	9862778	606	+	0
AT3G26805	3	9863073	9863900	827	-	0
AT3G26810	3	9867844	9870640	2796	+	950
AT3G26812	3	9871959	9872165	206	-	3
AT3G26813	3	9872332	9872553	221	-	0
AT3G26815	3	9875524	9875737	213	-	19
AT3G26816	3	9875892	9876103	211	-	2
AT3G26818	3	9878167	9878379	212	-	8
AT3G26819	3	9878539	9878754	215	-	0
AT3G26820	3	9881127	9885067	3940	+	0
AT3G26830	3	9887947	9889705	1758	+	27
AT3G26840	3	9892793	9896337	3544	+	159
AT3G26850	3	9895541	9898006	2465	-	188
AT3G26855	3	9898679	9899350	671	-	1
AT3G26860	3	9901515	9901884	369	-	0
AT3G26870	3	9903287	9903680	393	-	0
AT3G26872	3	9904306	9904684	378	-	0
AT3G26880	3	9906333	9906735	402	-	0
AT3G26890	3	9907233	9911933	4700	-	1459
AT3G26900	3	9911872	9914514	2642	-	2149
AT3G26910	3	9915110	9918784	3674	-	127
AT3G26920	3	9920434	9922612	2178	+	237
AT3G26922	3	9922798	9924615	1817	+	98
AT3G26930	3	9925753	9927393	1640	+	3
AT3G26932	3	9930269	9932120	1851	-	468
AT3G26934	3	9928156	9929123	967	-	1
AT3G26935	3	9932599	9935499	2900	-	874
AT3G26940	3	9936581	9939269	2688	-	0
AT3G26950	3	9941137	9943480	2343	-	872
AT3G26960	3	9944667	9945579	912	-	484
AT3G26980	3	9946165	9948040	1875	-	323
AT3G26990	3	9948222	9952041	3819	-	284
AT3G27000	3	9952562	9955941	3379	-	161
AT3G27010	3	9957375	9958898	1523	-	123
AT3G27020	3	9961318	9964597	3279	-	1680
AT3G27025	3	9969704	9971268	1564	+	37
AT3G27027	3	9971920	9972130	210	+	20
AT3G27030	3	9972507	9974225	1718	-	172
AT3G27040	3	9974911	9977927	3016	-	0
AT3G27050	3	9978094	9979699	1605	-	1199
AT3G27060	3	9979865	9981295	1430	-	1347
AT3G27070	3	9982986	9984744	1758	-	2
AT3G27080	3	9985078	9986629	1551	-	581
AT3G27090	3	9989539	9991826	2287	+	3284
AT3G27095	3	9991971	9994181	2210	-	0
AT3G27100	3	9994544	9996025	1481	-	239
AT3G27110	3	9997894	10000230	2336	+	939
AT3G27120	3	9999693	10003314	3621	-	29
AT3G27130	3	10002658	10004281	1623	-	11
AT3G27140	3	10006890	10008174	1284	-	0
AT3G27150	3	10009441	10011641	2200	-	11
AT3G27160	3	10017475	10019090	1615	+	7847
AT3G27170	3	10024016	10027198	3182	+	188
AT3G27180	3	10026836	10030069	3233	-	439
AT3G27190	3	10039233	10043066	3833	-	109
AT3G27200	3	10043521	10044373	852	-	102
AT3G27210	3	10045185	10047343	2158	-	78
AT3G27220	3	10051611	10053678	2067	-	147
AT3G27230	3	10053928	10055695	1767	+	670
AT3G27240	3	10055788	10058716	2928	-	2120
AT3G27250	3	10061544	10062731	1187	+	356
AT3G27260	3	10067528	10072672	5144	+	1320
AT3G27270	3	10073279	10074160	881	+	58
AT3G27280	3	10076818	10078608	1790	+	306
AT3G27283	3	10078589	10078820	231	-	0
AT3G27290	3	10079559	10081533	1974	-	20
AT3G27300	3	10083048	10086696	3648	-	688
AT3G27310	3	10087200	10089101	1901	-	484
AT3G27320	3	10090064	10092791	2727	+	423
AT3G27321	3	10092858	10093129	271	-	0
AT3G27325	3	10095088	10102229	7141	+	759
AT3G27327	3	10106738	10110813	4075	+	0
AT3G27328	3	10111641	10111794	153	+	0
AT3G27329	3	10114191	10114560	369	+	0
AT3G27330	3	10116949	10120645	3696	-	84
AT3G27331	3	10115540	10116278	738	+	0
AT3G27340	3	10121233	10122951	1718	+	391
AT3G27350	3	10125658	10127992	2334	+	861
AT3G27360	3	10129104	10129937	833	-	220
AT3G27380	3	10129609	10132760	3151	-	939
AT3G27390	3	10133195	10136630	3435	-	753
AT3G27400	3	10140322	10143225	2903	+	120
AT3G27410	3	10145243	10145642	399	-	1
AT3G27415	3	10147065	10147992	927	+	0
AT3G27416	3	10147312	10147984	672	-	0
AT3G27420	3	10148584	10150301	1717	+	182
AT3G27425	3	10151057	10151375	318	+	0
AT3G27430	3	10152478	10155342	2864	+	1923
AT3G27440	3	10155554	10157931	2377	+	2
AT3G27450	3	10158313	10159194	881	-	1
AT3G27460	3	10159292	10162259	2967	-	148
AT3G27470	3	10163048	10166907	3859	+	327
AT3G27473	3	10169241	10171230	1989	-	1
AT3G27480	3	10173219	10175555	2336	-	1
AT3G27490	3	10178099	10180148	2049	-	0
AT3G27500	3	10182832	10185081	2249	-	18
AT3G27503	3	10185764	10186537	773	-	0
AT3G27510	3	10188220	10190343	2123	-	3
AT3G27520	3	10192421	10193499	1078	+	75
AT3G27530	3	10193568	10200013	6445	-	1228
AT3G27540	3	10205307	10207306	1999	+	243
AT3G27550	3	10207780	10209899	2119	-	62
AT3G27555	3	10210327	10210399	72	+	0
AT3G27560	3	10210430	10213004	2574	-	206
AT3G27570	3	10213995	10216736	2741	-	1035
AT3G27580	3	10217416	10219976	2560	-	145
AT3G27590	3	10220325	10221857	1532	+	0
AT3G27600	3	10223742	10224948	1206	-	0
AT3G27610	3	10225524	10228192	2668	-	221
AT3G27620	3	10229044	10230702	1658	-	8
AT3G27630	3	10231115	10231418	303	-	4
AT3G27640	3	10232247	10235621	3374	+	81
AT3G27650	3	10238545	10240611	2066	+	79
AT3G27660	3	10243754	10245023	1269	+	32
AT3G27670	3	10245133	10253293	8160	+	782
AT3G27680	3	10254885	10255290	405	-	0
AT3G27690	3	10255946	10257011	1065	+	64731
AT3G27700	3	10257116	10261974	4858	-	556
AT3G27710	3	10269205	10271065	1860	+	1
AT3G27720	3	10271875	10273621	1746	+	2
AT3G27730	3	10273800	10280362	6562	-	24
AT3G27740	3	10281260	10283866	2606	-	1533
AT3G27750	3	10284807	10285874	1067	+	381
AT3G27770	3	10285656	10287775	2119	-	1268
AT3G27785	3	10288602	10290934	2332	-	0
AT3G27800	3	10301927	10302201	274	-	0
AT3G27809	3	10307416	10308403	987	-	0
AT3G27810	3	10307420	10310308	2888	+	0
AT3G27820	3	10315113	10318056	2943	+	4488
AT3G27825	3	10318261	10318333	72	+	0
AT3G27830	3	10318504	10319432	928	+	7780
AT3G27831	3	10319480	10320092	612	-	6
AT3G27835	3	10321740	10322306	566	-	0
AT3G27840	3	10323353	10323950	597	+	0
AT3G27845	3	10324638	10324710	72	+	0
AT3G27850	3	10324838	10325713	875	+	6925
AT3G27860	3	10326127	10328086	1959	+	31
AT3G27865	3	10328509	10328601	92	+	9
AT3G27870	3	10330949	10335305	4356	+	280
AT3G27880	3	10338211	10339436	1225	+	65
AT3G27883	3	10339966	10345348	5382	+	0
AT3G27884	3	10346154	10348282	2128	-	0
AT3G27886	3	10348686	10349575	889	+	0
AT3G27890	3	10350655	10352033	1378	-	1231
AT3G27895	3	10352127	10352401	274	-	6
AT3G27900	3	10352904	10353639	735	-	19
AT3G27906	3	10355512	10356437	925	-	206
AT3G27910	3	10357231	10358116	885	-	0
AT3G27920	3	10361944	10363506	1562	-	22
AT3G27925	3	10366370	10368905	2535	-	4836
AT3G27930	3	10369298	10372441	3143	-	232
AT3G27940	3	10373250	10376461	3211	+	29
AT3G27950	3	10378047	10379896	1849	+	0
AT3G27960	3	10380379	10383092	2713	-	263
AT3G27965	3	10385050	10385625	575	-	0
AT3G27968	3	10388714	10388885	171	-	0
AT3G27970	3	10389608	10391544	1936	+	6
AT3G27980	3	10393903	10395861	1958	+	18
AT3G27990	3	10392674	10398175	5501	-	256
AT3G27997	3	10400132	10401382	1250	-	108
AT3G27999	3	10402871	10403511	640	+	0
AT3G28005	3	10406446	10407217	771	-	0
AT3G28007	3	10408091	10409745	1654	-	65
AT3G28010	3	10414327	10415113	786	-	0
AT3G28020	3	10417905	10419149	1244	-	0
AT3G28030	3	10424252	10431204	6952	+	411
AT3G28040	3	10435056	10438391	3335	+	2727
AT3G28050	3	10442813	10445398	2585	+	1649
AT3G28060	3	10445859	10446846	987	+	7
AT3G28070	3	10447921	10451034	3113	+	1168
AT3G28080	3	10451485	10455267	3782	+	841
AT3G28100	3	10456098	10460965	4867	+	286
AT3G28110	3	10461762	10462827	1065	+	0
AT3G28120	3	10463793	10464000	207	-	1
AT3G28130	3	10465515	10468911	3396	+	738
AT3G28140	3	10470400	10471388	988	+	195
AT3G28150	3	10471841	10473754	1913	-	60
AT3G28153	3	10478205	10483699	5494	-	19
AT3G28155	3	10485300	10485991	691	-	2
AT3G28157	3	10493153	10493681	528	+	0
AT3G28160	3	10494655	10496791	2136	+	240
AT3G28170	3	10498360	10500360	2000	+	5
AT3G28180	3	10505828	10509239	3411	+	1410
AT3G28190	3	10512234	10513057	823	+	0
AT3G28193	3	10514633	10514762	129	-	0
AT3G28200	3	10518069	10519166	1097	+	457
AT3G28210	3	10520508	10521532	1024	+	20
AT3G28216	3	10523277	10523424	147	-	0
AT3G28220	3	10524403	10526728	2325	+	510
AT3G28223	3	10527476	10528961	1485	-	0
AT3G28230	3	10529214	10530199	985	+	0
AT3G28240	3	10530924	10531851	927	-	0
AT3G28243	3	10532388	10532502	114	-	0
AT3G28250	3	10533323	10533689	366	+	0
AT3G28260	3	10534539	10536144	1605	+	0
AT3G28270	3	10538104	10540024	1920	+	2768
AT3G28280	3	10540645	10541571	926	-	0
AT3G28290	3	10547503	10549367	1864	+	0
AT3G28291	3	10550926	10551106	180	+	0
AT3G28295	3	10561579	10562089	510	+	0
AT3G28300	3	10565736	10567600	1864	+	0
AT3G28310	3	10576960	10577375	415	+	1
AT3G28315	3	10577486	10581488	4002	-	1
AT3G28320	3	10581703	10583000	1297	+	1
AT3G28321	3	10583133	10583277	144	-	0
AT3G28330	3	10586565	10587712	1147	-	0
AT3G28340	3	10588946	10590552	1606	-	35
AT3G28345	3	10593752	10598775	5023	-	234
AT3G28350	3	10608358	10610924	2566	+	14
AT3G28360	3	10611023	10616361	5338	-	2
AT3G28370	3	10620626	10623259	2633	+	63
AT3G28380	3	10623741	10628201	4460	-	4
AT3G28390	3	10629424	10633967	4543	-	0
AT3G28400	3	10635917	10637945	2028	-	0
AT3G28410	3	10640151	10642071	1920	-	0
AT3G28412	3	10643771	10645328	1557	-	0
AT3G28415	3	10647122	10651540	4418	-	0
AT3G28420	3	10654469	10655388	919	-	44
AT3G28430	3	10657030	10662766	5736	-	550
AT3G28440	3	10665021	10665150	129	-	0
AT3G28450	3	10667261	10669377	2116	+	370
AT3G28455	3	10669887	10671163	1276	-	122
AT3G28460	3	10672040	10674395	2355	-	571
AT3G28470	3	10674507	10675724	1217	-	0
AT3G28480	3	10676032	10678388	2356	-	363
AT3G28490	3	10679048	10680654	1606	-	0
AT3G28500	3	10682096	10682731	635	+	11
AT3G28510	3	10685523	10687364	1841	+	0
AT3G28520	3	10688322	10689759	1437	+	0
AT3G28530	3	10690636	10690714	78	+	0
AT3G28540	3	10694443	10696123	1680	+	493
AT3G28550	3	10700706	10703929	3223	-	5
AT3G28560	3	10707095	10708479	1384	+	5
AT3G28570	3	10710533	10711889	1356	+	6
AT3G28580	3	10715622	10717329	1707	+	6
AT3G28590	3	10718319	10718682	363	+	0
AT3G28600	3	10722436	10723995	1559	+	0
AT3G28610	3	10724989	10726414	1425	+	2
AT3G28611	3	10726554	10727331	777	-	2
AT3G28620	3	10727825	10728461	636	+	5
AT3G28630	3	10728950	10730849	1899	+	10
AT3G28640	3	10731517	10733032	1515	-	16
AT3G28650	3	10735728	10737726	1998	+	0
AT3G28660	3	10738714	10740930	2216	-	28
AT3G28670	3	10743822	10747163	3341	+	394
AT3G28674	3	10747817	10747994	177	-	0
AT3G28680	3	10748750	10749734	984	-	0
AT3G28685	3	10752430	10752503	73	+	0
AT3G28690	3	10755038	10757868	2830	+	806
AT3G28695	3	10759392	10759465	73	-	0
AT3G28700	3	10759558	10762114	2556	+	196
AT3G28705	3	10767372	10772669	5297	-	0
AT3G28710	3	10772902	10775727	2825	-	1923
AT3G28715	3	10777836	10780633	2797	+	1481
AT3G28720	3	10782275	10784447	2172	+	588
AT3G28730	3	10784888	10788729	3841	+	1174
AT3G28740	3	10788697	10790553	1856	-	4
AT3G28750	3	10791590	10792844	1254	-	2
AT3G28760	3	10792954	10795312	2358	-	525
AT3G28770	3	10796715	10803237	6522	+	104
AT3G28780	3	10805910	10808458	2548	-	1
AT3G28790	3	10813330	10815699	2369	-	0
AT3G28800	3	10817052	10818113	1061	-	0
AT3G28810	3	10822470	10823941	1471	-	0
AT3G28820	3	10827646	10829396	1750	+	0
AT3G28830	3	10831167	10833284	2117	+	14
AT3G28840	3	10838408	10839946	1538	+	121
AT3G28850	3	10848668	10850122	1454	+	43
AT3G28855	3	10853865	10854553	688	-	0
AT3G28857	3	10855631	10856624	993	-	12
AT3G28860	3	10870037	10877506	7469	-	2854
AT3G28865	3	10880167	10889469	9302	-	0
AT3G28870	3	10890354	10891839	1485	+	0
AT3G28880	3	10892434	10896074	3640	+	11
AT3G28890	3	10895976	10898841	2865	-	15
AT3G28899	3	10902326	10902515	189	+	0
AT3G28900	3	10902646	10904458	1812	-	1284
AT3G28910	3	10911156	10913190	2034	+	223
AT3G28915	3	10917550	10922630	5080	-	81
AT3G28917	3	10924816	10925640	824	+	0
AT3G28918	3	10932965	10933058	93	+	0
AT3G28920	3	10940445	10941833	1388	-	987
AT3G28923	3	10954201	10954708	507	+	0
AT3G28925	3	10957886	10959581	1695	+	0
AT3G28930	3	10959685	10960808	1123	-	527
AT3G28940	3	10968099	10969387	1288	-	2313
AT3G28945	3	10970272	10975947	5675	-	31
AT3G28950	3	10976107	10977492	1385	-	225
AT3G28955	3	10978067	10978935	868	-	1
AT3G28956	3	10980699	10982244	1545	-	78
AT3G28958	3	10982705	10983532	827	+	3
AT3G28960	3	10984244	10985767	1523	-	68
AT3G28970	3	10987786	10989921	2135	-	368
AT3G28980	3	10993189	10995002	1813	-	0
AT3G28985	3	10998026	10998339	313	+	0
AT3G28990	3	11002350	11003072	722	-	0
AT3G29000	3	11005778	11006414	636	+	17
AT3G29010	3	11006752	11007977	1225	+	39
AT3G29020	3	11008116	11009456	1340	-	1
AT3G29030	3	11011307	11013358	2051	-	1660
AT3G29032	3	11016130	11020822	4692	+	0
AT3G29033	3	11024006	11024889	883	+	0
AT3G29034	3	11030063	11030633	570	-	4
AT3G29035	3	11033664	11035308	1644	+	27
AT3G29036	3	11028474	11028585	111	-	0
AT3G29037	3	11027794	11028197	403	-	0
AT3G29040	3	11037460	11038440	980	+	0
AT3G29050	3	11039508	11040701	1193	-	0
AT3G29060	3	11044989	11048465	3476	-	2
AT3G29070	3	11050129	11051153	1024	+	0
AT3G29075	3	11051488	11052694	1206	-	621
AT3G29076	3	11056623	11061530	4907	-	0
AT3G29077	3	11063492	11063884	392	+	0
AT3G29078	3	11065642	11069288	3646	-	0
AT3G29080	3	11069351	11071376	2025	+	0
AT3G29090	3	11073702	11075478	1776	+	301
AT3G29095	3	11075577	11075649	72	+	0
AT3G29100	3	11075822	11077540	1718	-	107
AT3G29105	3	11081009	11081545	536	+	0
AT3G29110	3	11082151	11085891	3740	-	0
AT3G29120	3	11098504	11099198	694	+	31
AT3G29130	3	11102271	11103906	1635	-	188
AT3G29140	3	11105804	11106144	340	+	19
AT3G29150	3	11108312	11109194	882	-	1
AT3G29152	3	11114051	11114491	440	-	0
AT3G29153	3	11116076	11120577	4501	-	0
AT3G29156	3	11122867	11127592	4725	-	7
AT3G29160	3	11128624	11132076	3452	-	871
AT3G29170	3	11136005	11137849	1844	-	124
AT3G29175	3	11142519	11147668	5149	-	0
AT3G29180	3	11148214	11151560	3346	+	720
AT3G29185	3	11154928	11157226	2298	-	1815
AT3G29187	3	11157909	11158916	1007	-	0
AT3G29190	3	11159372	11163336	3964	-	1
AT3G29195	3	11163556	11163724	168	-	0
AT3G29200	3	11164392	11166416	2024	-	1149
AT3G29205	3	11170645	11175547	4902	-	0
AT3G29210	3	11177289	11179972	2683	+	0
AT3G29220	3	11185677	11186271	594	+	0
AT3G29225	3	11186824	11188002	1178	+	0
AT3G29230	3	11188802	11190605	1803	+	663
AT3G29240	3	11191490	11192986	1496	+	4473
AT3G29250	3	11193658	11194993	1335	-	3
AT3G29252	3	11198725	11198975	250	-	0
AT3G29255	3	11209585	11213909	4324	+	0
AT3G29260	3	11215951	11216866	915	-	0
AT3G29265	3	11231711	11232422	711	+	0
AT3G29270	3	11234241	11236458	2217	+	338
AT3G29280	3	11236609	11237995	1386	-	132
AT3G29290	3	11238110	11240287	2177	+	915
AT3G29300	3	11247010	11247652	642	+	0
AT3G29305	3	11248671	11249491	820	-	0
AT3G29310	3	11249651	11251820	2169	+	351
AT3G29320	3	11252806	11257814	5008	+	6086
AT3G29330	3	11257683	11259055	1372	-	61
AT3G29340	3	11259586	11262440	2854	-	0
AT3G29350	3	11264146	11265532	1386	-	848
AT3G29360	3	11267090	11269229	2139	-	2204
AT3G29365	3	11274126	11274967	841	+	0
AT3G29370	3	11278588	11279108	520	+	7
AT3G29375	3	11280150	11281894	1744	+	330
AT3G29380	3	11282406	11283524	1118	-	1
AT3G29385	3	11284394	11285402	1008	-	0
AT3G29390	3	11289612	11294774	5162	+	1179
AT3G29400	3	11297282	11299620	2338	-	400
AT3G29410	3	11302430	11305136	2706	-	15
AT3G29420	3	11307006	11308078	1072	+	0
AT3G29430	3	11311355	11312792	1437	+	0
AT3G29431	3	11313002	11313140	138	-	0
AT3G29440	3	11321694	11322100	406	-	0
AT3G29450	3	11322668	11324582	1914	+	0
AT3G29460	3	11324940	11326338	1398	-	0
AT3G29470	3	11326619	11327360	741	-	0
AT3G29480	3	11329728	11333533	3805	+	0
AT3G29510	3	11336744	11341397	4653	+	0
AT3G29515	3	11341765	11346095	4330	-	0
AT3G29520	3	11351104	11351578	474	-	0
AT3G29525	3	11353721	11354141	420	-	0
AT3G29540	3	11354326	11354735	409	+	0
AT3G29545	3	11355481	11355629	148	-	0
AT3G29550	3	11355654	11356974	1320	+	0
AT3G29560	3	11359511	11360208	697	-	0
AT3G29570	3	11363805	11364789	984	-	0
AT3G29572	3	11371116	11372459	1343	-	0
AT3G29575	3	11382213	11384004	1791	-	168
AT3G29577	3	11389497	11391907	2410	+	0
AT3G29578	3	11392689	11393979	1290	-	0
AT3G29580	3	11394674	11395871	1197	-	1
AT3G29590	3	11398916	11400266	1350	-	119
AT3G29595	3	11405080	11406287	1207	+	0
AT3G29600	3	11407408	11408067	659	-	0
AT3G29610	3	11409601	11410090	489	+	0
AT3G29612	3	11410572	11412365	1793	-	0
AT3G29615	3	11416486	11424660	8174	+	0
AT3G29618	3	11433298	11434653	1355	+	0
AT3G29620	3	11444216	11444885	669	+	0
AT3G29630	3	11447027	11448609	1582	-	0
AT3G29632	3	11495186	11495699	513	+	0
AT3G29633	3	11452941	11453037	96	-	6
AT3G29634	3	11454658	11461849	7191	-	0
AT3G29635	3	11465850	11467227	1377	-	0
AT3G29636	3	11467963	11468857	894	-	0
AT3G29638	3	11473583	11475559	1976	+	2
AT3G29639	3	11478731	11479749	1018	-	9
AT3G29640	3	11488045	11488561	516	+	0
AT3G29641	3	11490748	11493971	3223	-	0
AT3G29642	3	11497887	11499349	1462	+	1
AT3G29643	3	11504662	11508363	3701	+	0
AT3G29644	3	11499198	11501366	2168	-	51
AT3G29647	3	11508518	11509043	525	+	0
AT3G29648	3	11514935	11517766	2831	+	0
AT3G29650	3	11517825	11521441	3616	+	0
AT3G29660	3	11522523	11524134	1611	+	0
AT3G29670	3	11527871	11529350	1479	+	183
AT3G29680	3	11531441	11532825	1384	-	102
AT3G29690	3	11540769	11541549	780	-	0
AT3G29695	3	11542026	11544471	2445	+	0
AT3G29700	3	11545356	11545932	576	+	0
AT3G29710	3	11546269	11549066	2797	-	0
AT3G29720	3	11549417	11551369	1952	-	0
AT3G29725	3	11554629	11555987	1358	-	0
AT3G29727	3	11558896	11560688	1792	-	0
AT3G29730	3	11561513	11564092	2579	-	0
AT3G29732	3	11565142	11568987	3845	-	0
AT3G29734	3	11570474	11573321	2847	+	0
AT3G29736	3	11573557	11575204	1647	+	0
AT3G29738	3	11575433	11575640	207	-	0
AT3G29739	3	11575682	11577116	1434	+	1
AT3G29740	3	11578467	11578847	380	+	0
AT3G29750	3	11579124	11580600	1476	-	0
AT3G29755	3	11581315	11585251	3936	+	0
AT3G29760	3	11589504	11591833	2329	-	600
AT3G29762	3	11593202	11593470	268	-	0
AT3G29763	3	11593923	11595441	1518	-	0
AT3G29764	3	11601685	11602012	327	-	0
AT3G29765	3	11595466	11597077	1611	-	0
AT3G29766	3	11597404	11599821	2417	-	0
AT3G29767	3	11604026	11606698	2672	-	0
AT3G29768	3	11608199	11610741	2542	-	0
AT3G29769	3	11634014	11637053	3039	+	0
AT3G29770	3	11648340	11650839	2499	+	158
AT3G29771	3	11618420	11619305	885	+	0
AT3G29772	3	11619997	11621219	1222	+	1
AT3G29773	3	11627224	11630679	3455	+	0
AT3G29774	3	11639506	11640914	1408	+	0
AT3G29775	3	11665355	11669402	4047	+	0
AT3G29776	3	11653005	11657482	4477	+	106
AT3G29777	3	11658756	11659845	1089	-	0
AT3G29778	3	11660601	11663681	3080	+	0
AT3G29779	3	11669829	11670426	597	+	0
AT3G29780	3	11671740	11672189	449	+	0
AT3G29781	3	11676198	11678062	1864	+	0
AT3G29782	3	11684239	11688370	4131	+	0
AT3G29783	3	11679181	11683251	4070	+	2
AT3G29784	3	11690058	11691067	1009	+	0
AT3G29785	3	11612356	11612686	330	-	0
AT3G29786	3	11651648	11652437	789	+	0
AT3G29787	3	11691623	11692551	928	+	0
AT3G29788	3	11602027	11603824	1797	-	24
AT3G29789	3	11611246	11611576	330	-	0
AT3G29790	3	11693094	11693622	528	-	0
AT3G29791	3	11695755	11696771	1016	+	0
AT3G29792	3	11697577	11702083	4506	+	0
AT3G29796	3	11708560	11713028	4468	+	0
AT3G29797	3	11717612	11718083	471	+	0
AT3G29798	3	11719127	11719512	385	-	7
AT3G29800	3	11720095	11722103	2008	+	0
AT3G29805	3	11726639	11727261	622	-	0
AT3G29810	3	11728112	11730239	2127	+	83
AT3G29820	3	11733307	11734816	1509	+	0
AT3G29830	3	11737048	11738847	1799	+	0
AT3G29970	3	11745210	11746570	1360	+	1
AT3G30110	3	11746724	11748496	1772	-	3
AT3G30120	3	11752004	11756485	4481	-	5
AT3G30122	3	11758490	11760858	2368	-	84
AT3G30145	3	11767112	11772223	5111	-	0
AT3G30147	3	11777210	11778152	942	-	0
AT3G30150	3	11782155	11783112	957	-	0
AT3G30160	3	11783649	11785377	1728	-	0
AT3G30170	3	11793901	11797216	3315	+	0
AT3G30180	3	11810736	11813765	3029	+	649
AT3G30183	3	11815718	11816978	1260	+	0
AT3G30187	3	11819876	11820755	879	-	0
AT3G30190	3	11821273	11822341	1068	+	0
AT3G30200	3	11827751	11834262	6511	-	2
AT3G30210	3	11838362	11840502	2140	+	0
AT3G30211	3	11841551	11845610	4059	-	0
AT3G30212	3	11845991	11847428	1437	+	0
AT3G30213	3	11854478	11857261	2783	+	1
AT3G30214	3	11860799	11861666	867	-	24
AT3G30216	3	11865713	11866320	607	+	0
AT3G30218	3	11867789	11871278	3489	+	0
AT3G30219	3	11871570	11876783	5213	+	0
AT3G30220	3	11877865	11878458	593	-	0
AT3G30222	3	11878631	11878907	276	-	0
AT3G30230	3	11879234	11881788	2554	-	0
AT3G30235	3	11882265	11883625	1360	+	0
AT3G30240	3	11883824	11884487	663	+	0
AT3G30245	3	11887093	11887485	392	+	0
AT3G30247	3	11888175	11888712	537	-	0
AT3G30250	3	11890758	11891432	674	-	0
AT3G30260	3	11909118	11912880	3762	+	0
AT3G30280	3	11914365	11915697	1332	+	0
AT3G30281	3	11915862	11916781	919	-	0
AT3G30290	3	11917229	11919546	2317	-	0
AT3G30300	3	11921197	11924574	3377	-	1385
AT3G30310	3	11928701	11929227	526	+	0
AT3G30320	3	11931286	11934694	3408	+	0
AT3G30330	3	11936236	11941273	5037	-	0
AT3G30335	3	11941472	11945087	3615	-	0
AT3G30340	3	11956600	11959098	2498	+	47
AT3G30345	3	11959166	11959239	73	+	1
AT3G30350	3	11960416	11961856	1440	-	1
AT3G30360	3	11964522	11965063	541	+	0
AT3G30370	3	11965179	11965719	540	-	0
AT3G30380	3	11974065	11976571	2506	+	217
AT3G30383	3	11984654	11985002	348	+	0
AT3G30384	3	11986516	11986866	350	+	0
AT3G30385	3	11988380	11988728	348	+	0
AT3G30386	3	11990240	11990588	348	+	0
AT3G30387	3	11992104	11992452	348	+	0
AT3G30388	3	11993963	11994308	345	+	0
AT3G30390	3	11976836	11979621	2785	-	5551
AT3G30391	3	11996834	11996939	105	-	0
AT3G30393	3	11998919	12003671	4752	+	0
AT3G30396	3	12004586	12007067	2481	+	0
AT3G30400	3	12009589	12012152	2563	-	0
AT3G30405	3	12019425	12025026	5601	+	0
AT3G30410	3	12025651	12027384	1733	-	0
AT3G30411	3	12028452	12033525	5073	-	0
AT3G30413	3	12033719	12038688	4969	-	0
AT3G30415	3	12039060	12041042	1982	+	0
AT3G30416	3	12043706	12049221	5515	+	0
AT3G30418	3	12050701	12056135	5434	-	0
AT3G30420	3	12057057	12060589	3532	+	0
AT3G30430	3	12064951	12065296	345	+	0
AT3G30433	3	12066909	12069949	3040	-	0
AT3G30436	3	12071272	12073068	1796	+	0
AT3G30440	3	12077916	12081875	3959	+	0
AT3G30450	3	12083625	12087431	3806	+	0
AT3G30455	3	12088252	12090153	1901	-	0
AT3G30456	3	12094412	12094580	168	-	0
AT3G30460	3	12104372	12105039	667	+	42
AT3G30465	3	12106538	12111597	5059	+	0
AT3G30470	3	12112099	12112689	590	-	0
AT3G30480	3	12114451	12114991	540	+	0
AT3G30490	3	12115434	12115976	542	-	0
AT3G30500	3	12116791	12117802	1011	+	0
AT3G30505	3	12118402	12120419	2017	-	0
AT3G30510	3	12120576	12120728	152	+	0
AT3G30520	3	12130339	12132173	1834	+	0
AT3G30530	3	12139511	12140033	522	+	2
AT3G30540	3	12144791	12146502	1711	-	0
AT3G30550	3	12147806	12150275	2469	+	0
AT3G30560	3	12151948	12157542	5594	+	0
AT3G30570	3	12160335	12164591	4256	+	0
AT3G30580	3	12167766	12168153	387	-	0
AT3G30582	3	12170738	12175434	4696	-	0
AT3G30585	3	12175445	12176849	1404	+	0
AT3G30587	3	12177592	12180256	2664	-	0
AT3G30590	3	12180788	12181319	531	+	0
AT3G30600	3	12185597	12186206	609	+	0
AT3G30610	3	12186690	12187029	339	-	0
AT3G30620	3	12189145	12191103	1958	-	0
AT3G30630	3	12192617	12195308	2691	-	0
AT3G30640	3	12196034	12198898	2864	-	0
AT3G30645	3	12199271	12199881	610	-	0
AT3G30650	3	12200800	12202177	1377	+	0
AT3G30655	3	12203577	12206596	3019	+	0
AT3G30660	3	12207107	12207341	234	+	0
AT3G30663	3	12210365	12211703	1338	-	0
AT3G30665	3	12212482	12213396	914	-	0
AT3G30668	3	12215243	12223941	8698	-	0
AT3G30670	3	12227086	12227956	870	-	0
AT3G30680	3	12228315	12232218	3903	-	0
AT3G30685	3	12234877	12236714	1837	-	0
AT3G30690	3	12244880	12245501	621	-	0
AT3G30695	3	12247334	12253398	6064	-	0
AT3G30700	3	12254559	12255180	621	-	0
AT3G30703	3	12257909	12259649	1740	+	0
AT3G30705	3	12271618	12271726	108	-	0
AT3G30708	3	12280454	12284671	4217	-	0
AT3G30709	3	12286485	12287153	668	-	0
AT3G30710	3	12291811	12294137	2326	-	0
AT3G30711	3	12288028	12290924	2896	+	0
AT3G30712	3	12295249	12295639	390	+	0
AT3G30713	3	12305272	12308582	3310	-	0
AT3G30714	3	12300954	12301347	393	-	0
AT3G30715	3	12309890	12311169	1279	+	0
AT3G30716	3	12319860	12326858	6998	-	0
AT3G30717	3	12329194	12331993	2799	+	0
AT3G30718	3	12334540	12337941	3401	+	0
AT3G30719	3	12341578	12342433	855	+	0
AT3G30720	3	12349046	12349832	786	+	175
AT3G30721	3	12344259	12346596	2337	+	0
AT3G30722	3	12346921	12348706	1785	+	0
AT3G30724	3	12350378	12350887	509	-	0
AT3G30725	3	12352508	12352844	336	+	1
AT3G30727	3	12355010	12356851	1841	-	0
AT3G30730	3	12357395	12357599	204	-	2
AT3G30733	3	12359737	12360033	296	-	0
AT3G30737	3	12361640	12366047	4407	-	38
AT3G30740	3	12367901	12368118	217	+	0
AT3G30742	3	12371345	12372820	1475	-	0
AT3G30743	3	12374579	12378046	3467	+	0
AT3G30744	3	12379789	12381090	1301	+	0
AT3G30745	3	12387771	12391875	4104	+	0
AT3G30746	3	12400028	12402317	2289	+	0
AT3G30747	3	12393631	12396810	3179	+	0
AT3G30748	3	12415656	12418078	2422	+	0
AT3G30749	3	12403102	12412091	8989	+	0
AT3G30750	3	12420555	12420993	438	+	0
AT3G30751	3	12378587	12379102	515	-	0
AT3G30755	3	12421544	12422098	554	-	0
AT3G30760	3	12425496	12425980	484	+	0
AT3G30763	3	12428277	12431476	3199	-	0
AT3G30764	3	12433701	12435973	2272	-	0
AT3G30765	3	12438211	12440001	1790	+	0
AT3G30766	3	12437098	12437662	564	-	0
AT3G30767	3	12440598	12441915	1317	+	0
AT3G30768	3	12444672	12444807	135	-	0
AT3G30769	3	12445009	12445132	123	-	0
AT3G30770	3	12445492	12448085	2593	+	0
AT3G30775	3	12448635	12451248	2613	-	285
AT3G30778	3	12459184	12459304	120	-	0
AT3G30780	3	12462578	12464771	2193	-	0
AT3G30790	3	12467941	12471863	3922	-	0
AT3G30800	3	12476149	12477890	1741	-	0
AT3G30802	3	12479456	12484302	4846	+	0
AT3G30803	3	12485526	12487452	1926	-	1
AT3G30805	3	12488977	12489925	948	-	0
AT3G30810	3	12492822	12496380	3558	+	0
AT3G30811	3	12496549	12500646	4097	-	0
AT3G30812	3	12502458	12502638	180	-	0
AT3G30813	3	12508309	12508892	583	-	0
AT3G30814	3	12504366	12507970	3604	+	0
AT3G30815	3	12509269	12510646	1377	+	0
AT3G30816	3	12511658	12513384	1726	+	0
AT3G30817	3	12511288	12511589	301	-	0
AT3G30818	3	12514116	12515169	1053	-	0
AT3G30819	3	12519333	12524170	4837	-	0
AT3G30820	3	12529842	12531235	1393	+	0
AT3G30821	3	12524491	12528871	4380	+	0
AT3G30825	3	12532939	12536466	3527	+	0
AT3G30827	3	12537687	12538749	1062	+	0
AT3G30830	3	12539533	12541519	1986	-	0
AT3G30831	3	12542474	12546242	3768	-	0
AT3G30832	3	12547922	12549512	1590	-	0
AT3G30833	3	12550246	12554744	4498	-	0
AT3G30834	3	12555933	12557495	1562	-	0
AT3G30835	3	12571102	12571932	830	-	0
AT3G30836	3	12563427	12566928	3501	-	0
AT3G30837	3	12567173	12569997	2824	-	0
AT3G30838	3	12579884	12585786	5902	-	0
AT3G30839	3	12575630	12576593	963	+	0
AT3G30840	3	12588451	12589026	575	-	7
AT3G30841	3	12591391	12593527	2136	+	210
AT3G30842	3	12593958	12600432	6474	-	1
AT3G30843	3	12607270	12608250	980	-	0
AT3G30844	3	12602728	12606196	3468	-	0
AT3G30845	3	12624436	12624754	318	-	0
AT3G30846	3	12614650	12619019	4369	-	0
AT3G30847	3	12622013	12622528	515	-	0
AT3G30848	3	12626125	12626840	715	+	0
AT3G30849	3	12629617	12629719	102	+	0
AT3G30852	3	12633708	12635506	1798	-	0
AT3G30859	3	12637091	12637895	804	+	0
AT3G30867	3	12646168	12647549	1381	+	4
AT3G30875	3	12647724	12654422	6698	-	26
AT3G30885	3	12656979	12657779	800	+	5
AT3G31005	3	12662597	12670958	8361	-	0
AT3G31023	3	12663147	12666444	3297	-	0
AT3G31051	3	12667226	12667370	144	+	0
AT3G31068	3	12667703	12667826	123	-	0
AT3G31161	3	12670275	12670499	224	+	0
AT3G31300	3	12674426	12674618	192	+	0
AT3G31310	3	12677227	12678717	1490	+	0
AT3G31312	3	12679590	12680669	1079	-	0
AT3G31314	3	12681683	12683179	1496	-	0
AT3G31317	3	12685820	12691103	5283	-	0
AT3G31320	3	12694626	12696002	1376	+	0
AT3G31330	3	12697411	12697778	367	-	0
AT3G31340	3	12698078	12700757	2679	+	0
AT3G31350	3	12702586	12703222	636	+	0
AT3G31355	3	12704090	12704807	717	-	0
AT3G31356	3	12708256	12711435	3179	-	0
AT3G31357	3	12713009	12713628	619	+	0
AT3G31358	3	12713991	12716114	2123	-	0
AT3G31359	3	12716832	12722775	5943	-	0
AT3G31360	3	12723411	12724422	1011	-	0
AT3G31365	3	12725744	12729587	3843	-	0
AT3G31367	3	12735170	12737948	2778	-	0
AT3G31370	3	12739411	12740362	951	+	0
AT3G31373	3	12742860	12745393	2533	+	0
AT3G31374	3	12745878	12747374	1496	+	0
AT3G31375	3	12748364	12752403	4039	+	0
AT3G31377	3	12753385	12754761	1376	+	0
AT3G31380	3	12758023	12758958	935	+	0
AT3G31390	3	12760804	12762223	1419	-	0
AT3G31395	3	12762660	12766244	3584	+	0
AT3G31400	3	12768983	12769481	498	+	0
AT3G31401	3	12770518	12770650	132	-	0
AT3G31402	3	12770930	12773539	2609	-	0
AT3G31403	3	12776572	12778649	2077	+	0
AT3G31406	3	12779537	12780473	936	+	0
AT3G31410	3	12780478	12783581	3103	-	0
AT3G31420	3	12787913	12792017	4104	-	0
AT3G31422	3	12792939	12795066	2127	-	0
AT3G31425	3	12784199	12786769	2570	-	0
AT3G31430	3	12795860	12796871	1011	-	0
AT3G31440	3	12800323	12806091	5768	-	0
AT3G31442	3	12803910	12804796	886	-	0
AT3G31450	3	12810850	12813187	2337	+	0
AT3G31460	3	12814910	12815570	660	-	0
AT3G31470	3	12818515	12820597	2082	-	0
AT3G31475	3	12820630	12821686	1056	+	0
AT3G31490	3	12825336	12827347	2011	-	0
AT3G31500	3	12828687	12830731	2044	+	0
AT3G31510	3	12833342	12835647	2305	+	0
AT3G31530	3	12838148	12842889	4741	+	0
AT3G31540	3	12843391	12845748	2357	-	0
AT3G31630	3	12852501	12859789	7288	+	0
AT3G31720	3	12861830	12864017	2187	+	0
AT3G31810	3	12868797	12870124	1327	+	0
AT3G31900	3	12875070	12877422	2352	+	0
AT3G31902	3	12879030	12879375	345	-	0
AT3G31903	3	12879905	12880236	331	+	0
AT3G31904	3	12885375	12891812	6437	-	0
AT3G31905	3	12892773	12895070	2297	-	0
AT3G31906	3	12896941	12898508	1567	+	0
AT3G31908	3	12902408	12903522	1114	-	0
AT3G31909	3	12906597	12907864	1267	+	0
AT3G31910	3	12907876	12910391	2515	-	0
AT3G31915	3	12909850	12912291	2441	+	0
AT3G31920	3	12920069	12926590	6521	-	0
AT3G31930	3	12928341	12929220	879	+	0
AT3G31935	3	12933227	12938295	5068	+	0
AT3G31940	3	12940785	12941768	983	+	0
AT3G31945	3	12942323	12949134	6811	-	2
AT3G31950	3	12950112	12952593	2481	+	0
AT3G31955	3	12954000	12954422	422	-	0
AT3G31960	3	12954902	12955983	1081	+	0
AT3G31970	3	12962490	12967061	4571	-	0
AT3G31980	3	12972403	12976508	4105	-	0
AT3G31990	3	12978897	12981090	2193	-	0
AT3G31993	3	12981627	12982740	1113	-	0
AT3G31996	3	12982725	12983028	303	+	0
AT3G32000	3	12984312	12987051	2739	+	0
AT3G32010	3	12988333	12990208	1875	+	0
AT3G32020	3	12992005	12992614	609	+	0
AT3G32021	3	12994951	12998969	4018	-	0
AT3G32022	3	13003009	13007712	4703	-	0
AT3G32023	3	12993298	12994435	1137	-	0
AT3G32024	3	13008565	13009829	1264	-	0
AT3G32026	3	13010635	13011960	1325	-	0
AT3G32027	3	13012602	13013955	1353	-	0
AT3G32028	3	13014605	13016975	2370	-	0
AT3G32029	3	13020878	13022411	1533	-	0
AT3G32030	3	13032457	13035348	2891	-	0
AT3G32031	3	13024556	13026492	1936	-	0
AT3G32032	3	13028678	13030475	1797	+	0
AT3G32033	3	13017166	13019596	2430	-	0
AT3G32035	3	13035627	13036373	746	+	0
AT3G32036	3	13040230	13040344	114	-	0
AT3G32040	3	13047703	13049040	1337	-	1
AT3G32043	3	13053129	13058318	5189	-	0
AT3G32047	3	13061047	13062710	1663	+	1
AT3G32050	3	13067625	13068582	957	-	1
AT3G32052	3	13069788	13069953	165	+	0
AT3G32060	3	13073032	13074690	1658	+	0
AT3G32070	3	13075709	13076285	576	+	0
AT3G32080	3	13076747	13078338	1591	-	0
AT3G32090	3	13078955	13079921	966	+	6
AT3G32091	3	13080592	13088056	7464	+	0
AT3G32092	3	13088115	13091973	3858	-	0
AT3G32093	3	13092824	13093479	655	+	0
AT3G32095	3	13094380	13095857	1477	+	0
AT3G32100	3	13096970	13097304	334	+	0
AT3G32110	3	13097951	13103951	6000	+	0
AT3G32112	3	13105075	13108692	3617	+	0
AT3G32115	3	13109257	13113938	4681	+	0
AT3G32116	3	13116265	13118455	2190	+	0
AT3G32118	3	13119181	13121222	2041	+	0
AT3G32120	3	13124465	13125316	851	+	0
AT3G32130	3	13127478	13128165	687	+	0
AT3G32135	3	13134078	13136427	2349	+	0
AT3G32140	3	13138220	13139009	789	-	0
AT3G32150	3	13143626	13144825	1199	+	0
AT3G32160	3	13145439	13145953	514	+	0
AT3G32164	3	13147027	13152346	5319	-	0
AT3G32168	3	13157221	13160003	2782	+	0
AT3G32172	3	13160003	13161119	1116	+	0
AT3G32176	3	13161119	13161444	325	+	0
AT3G32180	3	13162412	13162787	375	-	0
AT3G32190	3	13163277	13164557	1280	-	0
AT3G32195	3	13165570	13170335	4765	+	0
AT3G32200	3	13171080	13171527	447	-	0
AT3G32205	3	13173564	13177241	3677	-	0
AT3G32210	3	13189474	13191327	1853	-	0
AT3G32220	3	13192232	13192745	513	-	0
AT3G32223	3	13194998	13197009	2011	-	0
AT3G32226	3	13198630	13202352	3722	+	0
AT3G32230	3	13203900	13208938	5038	+	0
AT3G32240	3	13209735	13212216	2481	+	0
AT3G32250	3	13213925	13216637	2712	+	0
AT3G32260	3	13219167	13221456	2289	+	0
AT3G32270	3	13222098	13223011	913	+	0
AT3G32275	3	13231438	13233121	1683	+	0
AT3G32280	3	13233831	13240154	6323	+	0
AT3G32290	3	13241230	13243286	2056	+	0
AT3G32295	3	13245761	13249019	3258	+	0
AT3G32300	3	13249034	13251125	2091	-	1
AT3G32305	3	13253567	13256745	3178	-	0
AT3G32310	3	13263526	13264055	529	+	0
AT3G32313	3	13265494	13265805	311	-	0
AT3G32316	3	13266252	13267125	873	+	0
AT3G32320	3	13270924	13275593	4669	-	0
AT3G32330	3	13276081	13277155	1074	+	0
AT3G32340	3	13278561	13281228	2667	-	0
AT3G32360	3	13282355	13287540	5185	-	1
AT3G32370	3	13289192	13289828	636	+	0
AT3G32371	3	13292014	13292467	453	+	0
AT3G32373	3	13297851	13302758	4907	-	0
AT3G32375	3	13304500	13306236	1736	+	0
AT3G32377	3	13311476	13313243	1767	-	0
AT3G32383	3	13314145	13318012	3867	+	0
AT3G32385	3	13318347	13322975	4628	-	0
AT3G32387	3	13323219	13325196	1977	+	0
AT3G32389	3	13333767	13338330	4563	+	0
AT3G32391	3	13340017	13341938	1921	+	0
AT3G32393	3	13344239	13349880	5641	+	0
AT3G32394	3	13350683	13351341	658	+	0
AT3G32395	3	13351858	13352788	930	-	0
AT3G32397	3	13353208	13355722	2514	-	0
AT3G32400	3	13356994	13360572	3578	-	0
AT3G32405	3	13361796	13367722	5926	-	0
AT3G32410	3	13368434	13369133	699	-	0
AT3G32415	3	13369796	13373676	3880	+	0
AT3G32425	3	13380743	13383624	2881	-	0
AT3G32435	3	13384212	13384773	561	-	0
AT3G32445	3	13384832	13387113	2281	+	0
AT3G32455	3	13392363	13393527	1164	+	0
AT3G32465	3	13393626	13393749	123	-	0
AT3G32475	3	13397144	13399945	2801	-	0
AT3G32677	3	13400634	13402913	2279	-	0
AT3G32880	3	13404996	13406508	1512	-	0
AT3G32890	3	13407991	13410776	2785	-	0
AT3G32893	3	13414235	13415897	1662	-	0
AT3G32894	3	13416370	13421837	5467	-	0
AT3G32895	3	13431015	13435542	4527	+	1
AT3G32896	3	13424904	13425833	929	+	0
AT3G32897	3	13436155	13438015	1860	-	0
AT3G32898	3	13438975	13439677	702	-	0
AT3G32899	3	13442611	13448710	6099	-	0
AT3G32900	3	13458902	13462417	3515	+	0
AT3G32901	3	13455548	13457496	1948	-	0
AT3G32902	3	13427802	13428501	699	-	0
AT3G32903	3	13429386	13430063	677	+	0
AT3G32904	3	13451437	13452807	1370	-	0
AT3G32905	3	13424036	13424294	258	-	0
AT3G32910	3	13464087	13465615	1528	+	0
AT3G32912	3	13465779	13467015	1236	-	0
AT3G32914	3	13467651	13473530	5879	-	0
AT3G32917	3	13476576	13479549	2973	-	0
AT3G32920	3	13485293	13488783	3490	-	1
AT3G32925	3	13486980	13488632	1652	-	3
AT3G32930	3	13489517	13490849	1332	+	1827
AT3G32940	3	13490944	13493787	2843	-	427
AT3G32950	3	13495364	13498632	3268	-	0
AT3G32960	3	13499676	13500415	739	+	0
AT3G32962	3	13502563	13503104	541	+	0
AT3G32964	3	13503320	13506924	3604	+	0
AT3G32966	3	13510190	13513415	3225	+	0
AT3G32968	3	13513866	13515598	1732	-	0
AT3G32970	3	13518959	13520041	1082	-	0
AT3G32975	3	13521211	13524114	2903	-	0
AT3G32980	3	13526096	13529997	3901	-	90
AT3G32990	3	13534182	13536711	2529	-	15
AT3G33000	3	13537076	13537851	775	-	0
AT3G33002	3	13538066	13538776	710	-	0
AT3G33004	3	13538952	13541488	2536	-	0
AT3G33005	3	13544796	13547327	2531	+	0
AT3G33006	3	13550421	13553113	2692	+	0
AT3G33008	3	13553321	13553735	414	+	0
AT3G33009	3	13557523	13561767	4244	-	0
AT3G33010	3	13568394	13571420	3026	-	0
AT3G33011	3	13563189	13566382	3193	-	0
AT3G33025	3	13571979	13573065	1086	+	0
AT3G33030	3	13574216	13575308	1092	+	0
AT3G33035	3	13576127	13579562	3435	-	0
AT3G33045	3	13579592	13580782	1190	-	0
AT3G33055	3	13581146	13583974	2828	+	0
AT3G33058	3	13601799	13606148	4349	+	0
AT3G33064	3	13620208	13620925	717	+	0
AT3G33065	3	13658663	13659333	670	-	0
AT3G33066	3	13624113	13628913	4800	-	0
AT3G33067	3	13649580	13651310	1730	+	0
AT3G33069	3	13803172	13805953	2781	+	0
AT3G33070	3	13663873	13667883	4010	-	0
AT3G33071	3	13635039	13637775	2736	-	0
AT3G33072	3	13631492	13634029	2537	-	0
AT3G33073	3	13648306	13649212	906	-	0
AT3G33074	3	13639230	13639834	604	-	0
AT3G33075	3	13640059	13640618	559	-	0
AT3G33076	3	13739730	13744449	4719	-	0
AT3G33077	3	13645175	13647900	2725	+	0
AT3G33079	3	13617213	13619474	2261	-	0
AT3G33080	3	13816641	13817171	530	-	0
AT3G33081	3	13614161	13616153	1992	-	0
AT3G33082	3	13612061	13612560	499	-	0
AT3G33083	3	13609395	13611925	2530	+	0
AT3G33084	3	13675143	13680170	5027	+	0
AT3G33085	3	13607764	13608786	1022	+	0
AT3G33091	3	13818737	13820758	2021	-	0
AT3G33094	3	13821469	13821634	165	-	0
AT3G33097	3	13826472	13828506	2034	-	0
AT3G33100	3	13830489	13833069	2580	-	0
AT3G33103	3	13841650	13842464	814	-	0
AT3G33106	3	13871108	13873859	2751	+	0
AT3G33109	3	13874588	13876252	1664	+	0
AT3G33112	3	13878667	13881307	2640	+	0
AT3G33115	3	13885024	13890380	5356	+	0
AT3G33118	3	13890949	13893141	2192	-	0
AT3G33121	3	13896072	13897796	1724	+	0
AT3G33124	3	13904218	13909256	5038	+	0
AT3G33127	3	13910236	13912297	2061	+	0
AT3G33130	3	13919324	13922822	3498	+	0
AT3G33131	3	13923673	13924515	842	+	0
AT3G33133	3	13926893	13930704	3811	+	0
AT3G33136	3	13934222	13939903	5681	-	0
AT3G33139	3	13943129	13945162	2033	-	0
AT3G33142	3	13950957	13954678	3721	+	0
AT3G33145	3	13955338	13955956	618	-	0
AT3G33148	3	13956613	13959337	2724	-	0
AT3G33151	3	13960516	13963601	3085	-	0
AT3G33154	3	13965598	13969030	3432	+	1
AT3G33157	3	13969696	13972020	2324	+	0
AT3G33160	3	13974396	13976208	1812	+	0
AT3G33163	3	13976808	13978162	1354	+	0
AT3G33166	3	13980393	13982869	2476	-	0
AT3G33169	3	13983887	13987724	3837	-	0
AT3G33172	3	13997643	14000072	2429	-	0
AT3G33175	3	14003224	14005209	1985	-	0
AT3G33178	3	14006543	14013004	6461	+	0
AT3G33181	3	14013960	14017579	3619	+	0
AT3G33185	3	14017702	14019028	1326	+	0
AT3G33187	3	14020686	14021392	706	-	0
AT3G33189	3	14028343	14029295	952	+	1
AT3G33193	3	14030704	14035993	5289	+	0
AT3G33197	3	14128921	14132041	3120	+	0
AT3G33201	3	14122406	14126545	4139	-	0
AT3G33205	3	14119918	14122157	2239	+	0
AT3G33215	3	14113039	14114246	1207	+	0
AT3G33225	3	14108279	14111122	2843	-	0
AT3G33230	3	14106868	14107511	643	+	0
AT3G33235	3	14102698	14105290	2592	+	0
AT3G33293	3	14037059	14037626	567	-	0
AT3G33377	3	14100406	14102277	1871	+	0
AT3G33393	3	14037797	14038234	437	-	0
AT3G33448	3	14097798	14098531	733	+	0
AT3G33494	3	14038359	14039358	999	+	0
AT3G33520	3	14093655	14095549	1894	-	449
AT3G33528	3	14082794	14084346	1552	-	3
AT3G33530	3	14085297	14093670	8373	+	1391
AT3G33537	3	14076384	14080142	3758	-	0
AT3G33545	3	14072060	14073143	1083	+	0
AT3G33555	3	14068925	14069748	823	+	0
AT3G33565	3	14060882	14064624	3742	+	0
AT3G33570	3	14058307	14059944	1637	-	0
AT3G33572	3	14055706	14056099	393	-	0
AT3G33575	3	14052166	14055691	3525	+	0
AT3G33585	3	14047984	14050223	2239	-	0
AT3G33595	3	14039965	14046583	6618	-	1
AT3G34299	3	14133047	14134676	1629	+	0
AT3G35003	3	14105721	14106276	555	-	0
AT3G35707	3	14136756	14138239	1483	-	0
AT3G36411	3	14141583	14142132	549	-	0
AT3G36659	3	2100188	2100983	795	+	2
AT3G37820	3	14146315	14151204	4889	+	0
AT3G38525	3	14152322	14154341	2019	+	0
AT3G39230	3	14160794	14163605	2811	-	0
AT3G39935	3	14167163	14168635	1472	+	0
AT3G40640	3	14170240	14170714	474	-	0
AT3G41345	3	14171524	14172161	637	-	0
AT3G41761	3	14195916	14196078	162	+	0
AT3G41762	3	14195740	14196603	863	-	5
AT3G41768	3	14197676	14199484	1808	+	855
AT3G41979	3	14199752	14199916	164	+	2
AT3G42047	3	14227678	14228304	626	-	0
AT3G42050	3	14228494	14233245	4751	-	5153
AT3G42052	3	14235494	14242638	7144	+	332
AT3G42054	3	14243234	14245161	1927	+	0
AT3G42057	3	14246666	14250629	3963	+	0
AT3G42060	3	14251599	14254269	2670	-	0
AT3G42065	3	14255658	14257652	1994	+	0
AT3G42070	3	14257868	14259092	1224	+	0
AT3G42080	3	14260593	14261167	574	+	0
AT3G42083	3	14261958	14263704	1746	+	0
AT3G42086	3	14267219	14272239	5020	-	1
AT3G42090	3	14274221	14274699	478	+	0
AT3G42100	3	14275158	14281278	6120	-	0
AT3G42110	3	14282284	14284706	2422	-	0
AT3G42115	3	14290247	14294330	4083	-	0
AT3G42120	3	14295720	14296950	1230	+	0
AT3G42130	3	14298240	14298883	643	-	0
AT3G42140	3	14302059	14303018	959	-	0
AT3G42148	3	14308061	14308169	108	-	0
AT3G42150	3	14309313	14311638	2325	+	244
AT3G42155	3	14312294	14313498	1204	-	0
AT3G42160	3	14314582	14315634	1052	+	0
AT3G42170	3	14320951	14324069	3118	+	1234
AT3G42174	3	14330083	14334031	3948	+	0
AT3G42178	3	14338696	14344357	5661	+	0
AT3G42179	3	14344961	14345450	489	+	0
AT3G42180	3	14324273	14328676	4403	-	8
AT3G42181	3	14350963	14351182	219	+	0
AT3G42182	3	14352784	14356741	3957	-	0
AT3G42186	3	14356951	14359522	2571	-	0
AT3G42190	3	14364925	14371068	6143	+	0
AT3G42200	3	14372701	14373200	499	+	0
AT3G42203	3	14374608	14377539	2931	-	0
AT3G42206	3	14378345	14380009	1664	+	0
AT3G42220	3	14380474	14384179	3705	-	0
AT3G42230	3	14385162	14388016	2854	-	0
AT3G42233	3	14388224	14389905	1681	+	0
AT3G42236	3	14391713	14394404	2691	+	0
AT3G42240	3	14397329	14398293	964	-	0
AT3G42245	3	14401323	14403205	1882	+	0
AT3G42250	3	14403682	14403985	303	+	0
AT3G42251	3	14406117	14406834	717	+	0
AT3G42252	3	14407295	14408909	1614	+	0
AT3G42253	3	14411777	14413179	1402	+	0
AT3G42254	3	14415003	14415398	395	+	0
AT3G42255	3	14416061	14419442	3381	+	0
AT3G42256	3	14423423	14432589	9166	-	0
AT3G42257	3	14434093	14435671	1578	+	0
AT3G42258	3	14436560	14438817	2257	-	0
AT3G42260	3	14440089	14441496	1407	-	0
AT3G42270	3	14441781	14444827	3046	+	0
AT3G42280	3	14447817	14448962	1145	-	0
AT3G42290	3	14449067	14451268	2201	+	0
AT3G42300	3	14454331	14455596	1265	+	0
AT3G42305	3	14456326	14459109	2783	-	0
AT3G42310	3	14459817	14461497	1680	+	0
AT3G42313	3	14464230	14468082	3852	+	0
AT3G42316	3	14469181	14470707	1526	-	0
AT3G42320	3	14478405	14482649	4244	-	0
AT3G42330	3	14484418	14485333	915	+	0
AT3G42340	3	14487637	14488619	982	+	0
AT3G42350	3	14489926	14492587	2661	-	0
AT3G42353	3	14497055	14497541	486	-	0
AT3G42356	3	14498823	14499696	873	+	0
AT3G42360	3	14500245	14501565	1320	+	0
AT3G42380	3	14503609	14503917	308	+	0
AT3G42383	3	14504126	14508029	3903	-	0
AT3G42385	3	14509499	14509760	261	+	0
AT3G42386	3	14509931	14514632	4701	+	0
AT3G42390	3	14518020	14518467	447	-	0
AT3G42400	3	14520617	14522766	2149	+	0
AT3G42410	3	14523577	14526725	3148	+	0
AT3G42420	3	14527364	14533619	6255	+	0
AT3G42430	3	14543379	14544510	1131	+	0
AT3G42431	3	14546387	14553611	7224	+	0
AT3G42432	3	14556919	14558482	1563	-	0
AT3G42433	3	14558640	14560743	2103	-	0
AT3G42434	3	14564580	14569779	5199	+	0
AT3G42436	3	14570229	14571625	1396	+	0
AT3G42438	3	14574278	14576753	2475	+	0
AT3G42440	3	14577330	14577824	494	+	0
AT3G42445	3	14581045	14583365	2320	-	0
AT3G42450	3	14586113	14588382	2269	+	0
AT3G42460	3	14590290	14591220	930	-	0
AT3G42466	3	14599196	14604217	5021	+	0
AT3G42470	3	14594162	14599355	5193	-	0
AT3G42471	3	14610378	14613555	3177	-	0
AT3G42472	3	14616953	14617834	881	+	0
AT3G42473	3	14607117	14607971	854	+	0
AT3G42474	3	14618793	14619274	481	+	0
AT3G42475	3	14609701	14609824	123	-	0
AT3G42476	3	14620896	14621554	658	+	0
AT3G42478	3	14624307	14627037	2730	+	0
AT3G42480	3	14628218	14628635	417	-	0
AT3G42490	3	14629449	14630400	951	-	0
AT3G42500	3	14631288	14631925	637	-	0
AT3G42510	3	14632931	14633419	488	-	0
AT3G42520	3	14633956	14634483	527	+	0
AT3G42530	3	14635039	14639783	4744	-	0
AT3G42535	3	14642478	14644281	1803	+	0
AT3G42540	3	14645106	14646442	1336	+	0
AT3G42542	3	14649988	14650234	246	+	0
AT3G42545	3	14657059	14662717	5658	+	0
AT3G42550	3	14665727	14669135	3408	-	2
AT3G42553	3	14671478	14675564	4086	+	0
AT3G42556	3	14676966	14677308	342	+	3
AT3G42557	3	14677795	14678149	354	+	0
AT3G42560	3	14680264	14680760	496	+	0
AT3G42565	3	14683050	14683410	360	-	0
AT3G42570	3	14689057	14690347	1290	+	4
AT3G42580	3	14690820	14695927	5107	+	0
AT3G42590	3	14696257	14696950	693	+	0
AT3G42600	3	14697762	14698422	660	+	0
AT3G42610	3	14699144	14699844	700	+	0
AT3G42620	3	14700362	14700970	608	-	0
AT3G42621	3	14701781	14703452	1671	+	0
AT3G42622	3	14704741	14709298	4557	-	0
AT3G42624	3	14712748	14714635	1887	+	0
AT3G42626	3	14717887	14720449	2562	-	0
AT3G42628	3	14720734	14720872	138	-	0
AT3G42630	3	14722249	14723857	1608	+	261
AT3G42640	3	14724308	14728210	3902	+	282
AT3G42645	3	14729820	14734029	4209	-	0
AT3G42646	3	14734667	14735311	644	-	0
AT3G42650	3	14739355	14741466	2111	-	0
AT3G42653	3	14743146	14745900	2754	-	0
AT3G42656	3	14746447	14747209	762	+	0
AT3G42658	3	14749399	14750294	895	-	40
AT3G42660	3	14751279	14755701	4422	+	348
AT3G42670	3	14755797	14760085	4288	-	229
AT3G42680	3	14762870	14763400	530	-	0
AT3G42690	3	14766988	14770763	3775	+	0
AT3G42700	3	14772633	14773296	663	+	0
AT3G42710	3	14774424	14775123	699	-	0
AT3G42711	3	14776070	14777102	1032	-	0
AT3G42712	3	14780326	14782489	2163	-	0
AT3G42713	3	14785862	14787110	1248	-	0
AT3G42714	3	14792551	14792851	300	+	0
AT3G42715	3	14795810	14798513	2703	+	0
AT3G42716	3	14799889	14801814	1925	+	0
AT3G42717	3	14815117	14820859	5742	+	0
AT3G42718	3	14821959	14823996	2037	+	0
AT3G42719	3	14803535	14804201	666	+	0
AT3G42720	3	14828337	14830962	2625	-	0
AT3G42721	3	14831700	14835583	3883	-	0
AT3G42722	3	14837717	14837960	243	+	0
AT3G42723	3	14838391	14841189	2798	-	0
AT3G42724	3	14841391	14842638	1247	+	0
AT3G42725	3	14842899	14843707	808	-	33
AT3G42726	3	14805355	14805643	288	+	0
AT3G42727	3	14806175	14808341	2166	-	0
AT3G42728	3	14787739	14787859	120	+	0
AT3G42730	3	14845235	14851103	5868	+	0
AT3G42740	3	14851875	14852568	693	+	0
AT3G42750	3	14853371	14854029	658	+	0
AT3G42760	3	14854613	14855560	947	-	0
AT3G42763	3	14856136	14858983	2847	-	0
AT3G42766	3	14861484	14865389	3905	+	0
AT3G42770	3	14867121	14870083	2962	+	0
AT3G42780	3	14871212	14871743	531	+	0
AT3G42783	3	14871921	14875383	3462	-	0
AT3G42786	3	14876475	14877255	780	+	0
AT3G42790	3	14877957	14879781	1824	-	1014
AT3G42791	3	14888341	14891215	2874	+	0
AT3G42792	3	14892080	14892895	815	+	0
AT3G42794	3	14895822	14899217	3395	+	0
AT3G42796	3	14899843	14900608	765	+	0
AT3G42798	3	14901652	14902694	1042	+	0
AT3G42800	3	14905229	14907035	1806	+	17
AT3G42803	3	14908574	14910194	1620	+	0
AT3G42806	3	14914007	14918667	4660	+	127
AT3G42810	3	14919656	14920215	559	+	1
AT3G42820	3	14921036	14927032	5996	-	0
AT3G42830	3	14929713	14930678	965	-	0
AT3G42835	3	14931949	14932252	303	+	0
AT3G42836	3	14932438	14935117	2679	-	0
AT3G42837	3	14936239	14938777	2538	+	0
AT3G42850	3	14940113	14945291	5178	-	4
AT3G42860	3	14946187	14948167	1980	-	25
AT3G42870	3	14949455	14951279	1824	+	0
AT3G42875	3	14951430	14952669	1239	+	0
AT3G42880	3	14954586	14956577	1991	+	0
AT3G42883	3	14957141	14959892	2751	-	0
AT3G42886	3	14963294	14966755	3461	+	0
AT3G42890	3	14966923	14969056	2133	+	2
AT3G42900	3	14970608	14972658	2050	+	0
AT3G42910	3	14974102	14977761	3659	-	0
AT3G42913	3	14979791	14982680	2889	+	0
AT3G42916	3	14983524	14985656	2132	+	0
AT3G42920	3	14986918	14987428	510	-	0
AT3G42922	3	14989933	14990452	519	+	0
AT3G42924	3	14993667	14994581	914	-	0
AT3G42927	3	14994905	14997452	2547	+	0
AT3G42930	3	14998006	14999235	1229	-	0
AT3G42935	3	15001675	15003980	2305	+	0
AT3G42940	3	15006612	15007194	582	+	0
AT3G42945	3	15010800	15013507	2707	+	0
AT3G42950	3	15015139	15018071	2932	+	316
AT3G42960	3	15018694	15019685	991	-	0
AT3G42970	3	15024806	15025144	338	+	0
AT3G42980	3	15027588	15029109	1521	+	0
AT3G42990	3	15030353	15031152	799	+	0
AT3G42993	3	15031623	15037037	5414	+	0
AT3G42996	3	15038984	15043310	4326	+	0
AT3G43000	3	15044565	15046814	2249	-	0
AT3G43005	3	15048331	15048949	618	+	0
AT3G43020	3	15052578	15057585	5007	+	0
AT3G43025	3	15058238	15058928	690	-	0
AT3G43040	3	15060570	15061578	1008	+	0
AT3G43050	3	15062528	15064576	2048	+	0
AT3G43060	3	15065458	15067927	2469	-	0
AT3G43070	3	15068971	15071172	2201	+	0
AT3G43080	3	15072354	15075080	2726	-	0
AT3G43083	3	15075839	15077221	1382	-	0
AT3G43090	3	15083043	15084520	1477	-	0
AT3G43095	3	15087293	15088694	1401	-	0
AT3G43100	3	15089890	15091170	1280	+	0
AT3G43110	3	15091610	15092467	857	-	9
AT3G43120	3	15094082	15095512	1430	+	0
AT3G43123	3	15098332	15098851	519	-	0
AT3G43126	3	15100475	15104216	3741	+	0
AT3G43128	3	15105384	15107529	2145	+	0
AT3G43130	3	15110605	15112253	1648	-	0
AT3G43140	3	15112430	15112845	415	+	0
AT3G43141	3	15113156	15115856	2700	-	0
AT3G43142	3	15118446	15121602	3156	-	0
AT3G43144	3	15124180	15129553	5373	-	0
AT3G43146	3	15134144	15136307	2163	+	0
AT3G43147	3	15137564	15138176	612	+	0
AT3G43148	3	15139994	15143123	3129	+	0
AT3G43150	3	15143694	15144432	738	+	0
AT3G43151	3	15145328	15146641	1313	-	0
AT3G43152	3	15147241	15149791	2550	+	0
AT3G43153	3	15150103	15150916	813	-	0
AT3G43154	3	15151221	15152538	1317	+	0
AT3G43156	3	15154031	15155912	1881	+	0
AT3G43157	3	15156979	15158401	1422	+	0
AT3G43158	3	15161433	15162615	1182	+	0
AT3G43160	3	15166560	15168225	1665	+	0
AT3G43170	3	15172147	15172754	607	-	0
AT3G43175	3	15173887	15177508	3621	-	0
AT3G43180	3	15178042	15178937	895	+	0
AT3G43190	3	15179019	15183989	4970	-	8
AT3G43200	3	15185765	15186590	825	-	0
AT3G43205	3	15187015	15187420	405	-	0
AT3G43210	3	15190933	15196168	5235	+	216
AT3G43220	3	15196862	15203062	6200	-	1381
AT3G43230	3	15207366	15209825	2459	+	643
AT3G43240	3	15209935	15214742	4807	-	639
AT3G43250	3	15216712	15217462	750	+	0
AT3G43251	3	15217857	15218346	489	-	0
AT3G43260	3	15219453	15221723	2270	+	0
AT3G43270	3	15222124	15225460	3336	-	282
AT3G43280	3	15229777	15230251	474	-	0
AT3G43290	3	15230567	15231115	548	+	0
AT3G43291	3	15231276	15231441	165	-	0
AT3G43300	3	15233895	15245133	11238	-	2647
AT3G43302	3	15246179	15250302	4123	+	0
AT3G43303	3	15250629	15251025	396	+	0
AT3G43304	3	15251802	15260553	8751	+	0
AT3G43307	3	15262135	15265104	2969	+	0
AT3G43310	3	15265922	15268370	2448	-	1
AT3G43315	3	15271836	15275043	3207	-	0
AT3G43320	3	15275460	15276993	1533	-	0
AT3G43330	3	15279346	15281908	2562	+	0
AT3G43340	3	15284860	15285851	991	-	0
AT3G43350	3	15286072	15290808	4736	+	0
AT3G43352	3	15299364	15299640	276	-	0
AT3G43355	3	15302248	15304269	2021	-	0
AT3G43356	3	15304570	15306362	1792	-	0
AT3G43357	3	15307271	15312506	5235	+	0
AT3G43358	3	15313039	15316207	3168	-	0
AT3G43359	3	15316171	15317224	1053	+	0
AT3G43360	3	15320761	15322789	2028	+	0
AT3G43370	3	15323337	15324286	949	+	0
AT3G43380	3	15324812	15325460	648	-	0
AT3G43390	3	15326263	15330946	4683	-	0
AT3G43400	3	15332135	15333703	1568	+	0
AT3G43402	3	15335423	15335516	93	-	0
AT3G43410	3	15340503	15341109	606	-	0
AT3G43420	3	15345314	15345679	365	+	0
AT3G43425	3	15348512	15352811	4299	+	0
AT3G43430	3	15354534	15355304	770	-	7
AT3G43431	3	15355848	15355986	138	-	0
AT3G43432	3	15359782	15360090	308	-	0
AT3G43433	3	15360393	15361514	1121	+	0
AT3G43436	3	15361696	15365347	3651	+	0
AT3G43440	3	15367595	15370059	2464	+	235
AT3G43442	3	15373324	15375447	2123	+	0
AT3G43444	3	15377567	15381608	4041	+	0
AT3G43447	3	15382325	15384011	1686	+	0
AT3G43450	3	15385286	15385955	669	-	0
AT3G43460	3	15387805	15390501	2696	-	0
AT3G43470	3	15391567	15393281	1714	-	0
AT3G43480	3	15393977	15394463	486	-	0
AT3G43485	3	15394569	15396641	2072	+	0
AT3G43490	3	15398858	15400079	1221	+	0
AT3G43500	3	15400256	15400718	462	-	0
AT3G43505	3	15402412	15402799	387	-	0
AT3G43510	3	15403871	15405378	1507	-	165
AT3G43520	3	15406022	15407908	1886	+	1318
AT3G43521	3	15408944	15409667	723	+	0
AT3G43522	3	15410130	15410499	369	+	0
AT3G43523	3	15413768	15416019	2251	+	0
AT3G43524	3	15420059	15420530	471	+	0
AT3G43526	3	15423006	15425340	2334	+	0
AT3G43528	3	15426467	15426713	246	+	0
AT3G43530	3	15427144	15430076	2932	-	0
AT3G43540	3	15430688	15433187	2499	+	1863
AT3G43546	3	15440475	15446894	6419	-	0
AT3G43550	3	15448634	15450057	1423	+	0
AT3G43563	3	15458937	15460869	1932	-	2
AT3G43566	3	15461540	15466805	5265	-	0
AT3G43570	3	15473344	15474765	1421	+	0
AT3G43571	3	15480919	15482338	1419	+	0
AT3G43572	3	15479020	15479233	213	-	0
AT3G43573	3	15487247	15491948	4701	+	0
AT3G43574	3	15479818	15480028	210	-	0
AT3G43575	3	15493459	15497791	4332	-	0
AT3G43580	3	15502142	15503606	1464	+	18
AT3G43583	3	15506773	15507076	303	-	1
AT3G43586	3	15507667	15509301	1634	-	0
AT3G43590	3	15509620	15512574	2954	+	592
AT3G43600	3	15512606	15517506	4900	-	1093
AT3G43610	3	15517679	15524087	6408	-	907
AT3G43620	3	15525397	15526063	666	+	0
AT3G43622	3	15527179	15530149	2970	-	0
AT3G43623	3	15530341	15530473	132	+	0
AT3G43625	3	15532184	15538492	6308	-	0
AT3G43630	3	15538815	15539418	603	+	0
AT3G43635	3	15541164	15545922	4758	+	0
AT3G43640	3	15546871	15548354	1483	+	0
AT3G43650	3	15549782	15551111	1329	-	0
AT3G43652	3	15552161	15554963	2802	-	0
AT3G43654	3	15555354	15559710	4356	-	2
AT3G43657	3	15561485	15562115	630	-	0
AT3G43660	3	15565223	15566047	824	+	0
AT3G43670	3	15567098	15569901	2803	+	649
AT3G43675	3	15571414	15575045	3631	-	0
AT3G43680	3	15576455	15578269	1814	+	0
AT3G43681	3	15578891	15584429	5538	-	0
AT3G43682	3	15584588	15585426	838	+	0
AT3G43684	3	15585531	15587105	1574	-	0
AT3G43686	3	15587719	15590947	3228	+	0
AT3G43688	3	15592266	15597394	5128	+	0
AT3G43690	3	15598178	15600798	2620	+	472
AT3G43700	3	15601867	15603888	2021	+	196
AT3G43710	3	15605607	15606744	1137	+	2
AT3G43715	3	15606865	15607606	741	-	3
AT3G43720	3	15615385	15617149	1764	-	1787
AT3G43722	3	15620911	15621007	96	-	0
AT3G43723	3	15622166	15626684	4518	+	0
AT3G43726	3	15629329	15630085	756	-	0
AT3G43730	3	15633912	15636942	3030	+	0
AT3G43740	3	15644053	15645662	1609	+	346
AT3G43750	3	15646459	15647566	1107	+	0
AT3G43760	3	15648212	15649422	1210	-	0
AT3G43770	3	15650586	15651000	414	-	0
AT3G43780	3	15651303	15653034	1731	+	0
AT3G43790	3	15655383	15660086	4703	+	56
AT3G43800	3	15660858	15661925	1067	+	787
AT3G43810	3	15664370	15666460	2090	-	1272
AT3G43820	3	15668522	15669776	1254	-	0
AT3G43825	3	15670222	15674704	4482	+	0
AT3G43826	3	15675392	15676148	756	-	1
AT3G43828	3	15677382	15678009	627	-	5
AT3G43829	3	15678708	15678855	147	-	0
AT3G43830	3	15678860	15679850	990	-	0
AT3G43832	3	15682292	15682874	582	-	0
AT3G43833	3	15687553	15688773	1220	+	0
AT3G43835	3	15692316	15697566	5250	+	0
AT3G43840	3	15700351	15700855	504	+	17
AT3G43850	3	15702084	15704152	2068	-	1
AT3G43860	3	15706993	15709789	2796	+	0
AT3G43862	3	15714895	15716641	1746	-	0
AT3G43863	3	15717073	15717829	756	-	0
AT3G43864	3	15718054	15720790	2736	-	0
AT3G43867	3	15721997	15726638	4641	-	0
AT3G43870	3	15728175	15729150	975	+	0
AT3G43880	3	15738172	15738616	444	-	0
AT3G43890	3	15741467	15743453	1986	-	0
AT3G43900	3	15746839	15747094	255	+	0
AT3G43910	3	15751386	15752689	1303	+	0
AT3G43920	3	15753547	15760859	7312	+	272
AT3G43930	3	15760816	15763330	2514	-	8
AT3G43940	3	15764264	15765371	1107	-	0
AT3G43950	3	15766360	15767014	654	+	0
AT3G43955	3	15768819	15773629	4810	-	579
AT3G43960	3	15774054	15775657	1603	-	114
AT3G43970	3	15777407	15777948	541	-	0
AT3G43980	3	15778401	15779311	910	-	334
AT3G43990	3	15782537	15785178	2641	-	0
AT3G44000	3	15787226	15788739	1513	-	0
AT3G44005	3	15795416	15796016	600	-	0
AT3G44006	3	15796237	15796417	180	+	0
AT3G44010	3	15799930	15801200	1270	-	1550
AT3G44020	3	15801371	15802730	1359	+	600
AT3G44030	3	15803992	15806948	2956	+	0
AT3G44035	3	15808430	15810650	2220	+	0
AT3G44042	3	15813074	15814056	982	-	1
AT3G44045	3	15817538	15818150	612	+	0
AT3G44050	3	15818737	15824861	6124	+	211
AT3G44060	3	15824937	15826391	1454	-	0
AT3G44070	3	15828176	15829088	912	-	0
AT3G44080	3	15835631	15837126	1495	-	0
AT3G44090	3	15839122	15840759	1637	+	0
AT3G44091	3	15843162	15843282	120	+	0
AT3G44093	3	15849042	15853462	4420	-	0
AT3G44096	3	15859367	15863166	3799	-	0
AT3G44100	3	15866038	15867310	1272	-	1055
AT3G44110	3	15868793	15871256	2463	-	4306
AT3G44115	3	15874990	15875442	452	+	0
AT3G44117	3	15876725	15877074	349	+	0
AT3G44120	3	15878398	15879817	1419	-	18
AT3G44130	3	15881869	15883638	1769	+	0
AT3G44140	3	15885076	15885380	304	-	0
AT3G44150	3	15887586	15888848	1262	+	310
AT3G44160	3	15888901	15891988	3087	-	379
AT3G44170	3	15894789	15895257	468	+	0
AT3G44171	3	15896200	15896356	156	-	0
AT3G44175	3	15898566	15900327	1761	+	0
AT3G44180	3	15900794	15901716	922	+	0
AT3G44190	3	15901796	15903608	1812	-	433
AT3G44200	3	15906439	15911474	5035	+	550
AT3G44205	3	15913020	15915321	2301	-	69
AT3G44210	3	15916269	15917332	1063	+	1
AT3G44212	3	15917927	15918131	204	-	0
AT3G44215	3	15919238	15923690	4452	-	2
AT3G44220	3	15928159	15929758	1599	+	66
AT3G44230	3	15932133	15932748	615	+	0
AT3G44235	3	15933283	15933963	680	+	0
AT3G44240	3	15940183	15940903	720	+	0
AT3G44245	3	15942983	15944564	1581	-	0
AT3G44250	3	15948504	15950224	1720	-	0
AT3G44260	3	15952044	15953084	1040	-	85
AT3G44261	3	15954538	15954667	129	-	0
AT3G44262	3	15956885	15957093	208	-	0
AT3G44264	3	15958386	15959820	1434	-	0
AT3G44267	3	15960322	15961773	1451	+	0
AT3G44270	3	15962692	15963828	1136	+	0
AT3G44274	3	15965747	15966251	504	-	0
AT3G44280	3	15968592	15971167	2575	-	220
AT3G44290	3	15972908	15975183	2275	-	0
AT3G44300	3	15983310	15985535	2225	+	8
AT3G44310	3	15986863	15989103	2240	+	21782
AT3G44320	3	15993378	15995811	2433	+	58
AT3G44325	3	15996571	15999922	3351	-	1
AT3G44326	3	16000878	16002118	1240	-	0
AT3G44330	3	16006674	16010965	4291	+	1247
AT3G44340	3	16011620	16020254	8634	-	1582
AT3G44350	3	16022835	16024487	1652	-	5
AT3G44370	3	16030321	16035161	4840	-	270
AT3G44380	3	16036182	16036880	698	-	226
AT3G44390	3	16039318	16039600	282	-	0
AT3G44400	3	16044686	16049701	5015	-	109
AT3G44410	3	16055050	16055770	720	-	14
AT3G44420	3	16056296	16056844	548	+	24
AT3G44425	3	16057730	16060385	2655	+	0
AT3G44428	3	16067392	16067725	333	-	0
AT3G44430	3	16068256	16069750	1494	+	540
AT3G44440	3	16070981	16071256	275	+	2
AT3G44444	3	16072448	16072637	189	-	1
AT3G44450	3	16074095	16074678	583	-	1078
AT3G44460	3	16079975	16081906	1931	-	0
AT3G44470	3	16084754	16086568	1814	-	0
AT3G44480	3	16090563	16096359	5796	-	1812
AT3G44490	3	16097478	16098599	1121	+	0
AT3G44500	3	16101416	16106081	4665	+	0
AT3G44510	3	16108099	16111188	3089	-	4
AT3G44516	3	16112674	16113221	547	+	0
AT3G44530	3	16115587	16121518	5931	+	348
AT3G44540	3	16124020	16127954	3934	+	6
AT3G44550	3	16138016	16141546	3530	+	16
AT3G44560	3	16151135	16154397	3262	+	0
AT3G44570	3	16158404	16159835	1431	+	3
AT3G44580	3	16160511	16161003	492	-	0
AT3G44590	3	16163816	16164931	1115	+	483
AT3G44600	3	16164934	16169262	4328	-	539
AT3G44605	3	16175445	16180455	5010	+	0
AT3G44610	3	16188128	16192175	4047	-	235
AT3G44620	3	16193828	16195833	2005	+	1732
AT3G44630	3	16195954	16201225	5271	+	1523
AT3G44640	3	16207539	16209058	1519	-	0
AT3G44650	3	16209848	16212164	2316	-	0
AT3G44660	3	16214963	16215785	822	-	0
AT3G44670	3	16216944	16221617	4673	+	1940
AT3G44680	3	16226555	16229954	3399	-	216
AT3G44690	3	16230684	16234215	3531	-	72
AT3G44700	3	16236342	16237736	1394	-	1
AT3G44704	3	16244192	16244348	156	-	0
AT3G44705	3	16244951	16250205	5254	+	0
AT3G44710	3	16251833	16253535	1702	-	0
AT3G44713	3	16260204	16262484	2280	+	14
AT3G44716	3	16263199	16264261	1062	+	61
AT3G44717	3	16264448	16264931	483	-	0
AT3G44718	3	16266110	16266314	204	-	0
AT3G44720	3	16271651	16273344	1693	+	489
AT3G44730	3	16285740	16291048	5308	+	252
AT3G44735	3	16291179	16292464	1285	-	408
AT3G44740	3	16295969	16297805	1836	-	145
AT3G44750	3	16297978	16299847	1869	+	574
AT3G44755	3	16302002	16302731	729	+	2
AT3G44757	3	16304046	16304615	569	+	0
AT3G44760	3	16305321	16306378	1057	+	0
AT3G44765	3	16311974	16314027	2053	+	9
AT3G44770	3	16316079	16319458	3379	+	18
AT3G44780	3	16321600	16322604	1004	-	0
AT3G44783	3	16326039	16326162	123	+	0
AT3G44784	3	16327457	16327634	177	-	0
AT3G44785	3	16328220	16328448	228	-	0
AT3G44790	3	16328791	16330265	1474	+	4
AT3G44793	3	16330897	16331896	999	+	0
AT3G44796	3	16335173	16340018	4845	+	0
AT3G44798	3	16342294	16343014	720	+	60
AT3G44800	3	16343332	16346027	2695	+	13
AT3G44805	3	16350394	16351437	1043	+	20
AT3G44810	3	16358495	16359983	1488	-	0
AT3G44820	3	16361369	16364610	3241	-	270
AT3G44830	3	16368889	16372356	3467	+	0
AT3G44840	3	16372498	16373759	1261	-	1
AT3G44850	3	16374616	16376931	2315	-	240
AT3G44860	3	16379632	16381070	1438	+	529
AT3G44870	3	16382218	16383605	1387	+	0
AT3G44880	3	16383594	16386312	2718	+	2157
AT3G44890	3	16386433	16388466	2033	+	7776
AT3G44900	3	16388723	16391360	2637	+	76
AT3G44910	3	16392063	16394579	2516	-	0
AT3G44920	3	16397037	16399725	2688	-	0
AT3G44930	3	16402057	16404672	2615	-	0
AT3G44935	3	16409002	16409610	608	+	0
AT3G44940	3	16413333	16415266	1933	-	134
AT3G44950	3	16421044	16421286	242	+	2
AT3G44955	3	16427040	16427112	72	-	0
AT3G44960	3	16427794	16429151	1357	+	53
AT3G44970	3	16432442	16434848	2406	+	324
AT3G44980	3	16441022	16442098	1076	+	0
AT3G44990	3	16446974	16448764	1790	-	2490
AT3G45000	3	16460102	16461407	1305	+	2
AT3G45010	3	16466289	16468989	2700	+	1020
AT3G45020	3	16468960	16470153	1193	-	47
AT3G45030	3	16471385	16472393	1008	-	1664
AT3G45040	3	16472661	16475753	3092	-	264
AT3G45050	3	16475965	16477524	1559	+	882
AT3G45060	3	16477560	16479482	1922	-	24
AT3G45070	3	16486282	16487349	1067	-	10
AT3G45080	3	16488714	16489713	999	-	0
AT3G45090	3	16490599	16494762	4163	-	421
AT3G45093	3	16496810	16497290	480	+	4
AT3G45095	3	16499709	16504054	4345	-	19
AT3G45100	3	16504459	16507404	2945	+	308
AT3G45110	3	16508169	16508532	363	+	1
AT3G45120	3	16511729	16512050	321	-	0
AT3G45130	3	16512270	16517522	5252	-	1
AT3G45140	3	16525409	16529352	3943	+	5001
AT3G45150	3	16531178	16531676	498	+	0
AT3G45160	3	16533450	16534082	632	-	960
AT3G45170	3	16537537	16538305	768	+	0
AT3G45180	3	16538990	16539212	222	-	0
AT3G45190	3	16541672	16548278	6606	-	1366
AT3G45200	3	16548827	16549730	903	-	0
AT3G45210	3	16557272	16557970	698	-	587
AT3G45220	3	16564880	16566330	1450	-	0
AT3G45230	3	16569050	16569827	777	+	193
AT3G45240	3	16570477	16573762	3285	-	16
AT3G45242	3	16570477	16573762	3285	-	0
AT3G45243	3	16575822	16576173	351	+	0
AT3G45245	3	16578383	16578734	351	+	0
AT3G45248	3	16581928	16582273	345	+	0
AT3G45250	3	16583722	16584148	426	+	0
AT3G45252	3	16586073	16586364	291	+	0
AT3G45253	3	16589290	16594622	5332	-	0
AT3G45256	3	16595098	16596232	1134	+	0
AT3G45260	3	16596380	16598698	2318	-	736
AT3G45270	3	16601322	16603563	2241	-	0
AT3G45275	3	16605893	16606238	345	+	0
AT3G45280	3	16611412	16613340	1928	-	9
AT3G45285	3	16614565	16614901	336	+	0
AT3G45290	3	16617543	16621370	3827	+	77
AT3G45300	3	16620202	16625048	4846	-	429
AT3G45310	3	16628383	16630521	2138	-	492
AT3G45320	3	16631645	16632146	501	+	0
AT3G45330	3	16632439	16634488	2049	-	2
AT3G45340	3	16636471	16638835	2364	+	0
AT3G45350	3	16639040	16640511	1471	+	0
AT3G45360	3	16641618	16641999	381	+	0
AT3G45370	3	16642779	16643632	853	+	0
AT3G45380	3	16644520	16647172	2652	-	0
AT3G45390	3	16647920	16649974	2054	-	52
AT3G45400	3	16651962	16653678	1716	+	131
AT3G45410	3	16653898	16656013	2115	-	18
AT3G45420	3	16657262	16659266	2004	-	89
AT3G45430	3	16660758	16662783	2025	-	63
AT3G45440	3	16664874	16666884	2010	-	10
AT3G45443	3	16667976	16669561	1585	-	276
AT3G45446	3	16669845	16671931	2086	-	0
AT3G45450	3	16673145	16674880	1735	+	0
AT3G45460	3	16678433	16680043	1610	-	0
AT3G45470	3	16680504	16681261	757	-	0
AT3G45480	3	16683203	16684592	1389	-	0
AT3G45490	3	16686961	16687893	932	-	1
AT3G45500	3	16688417	16689693	1276	-	0
AT3G45510	3	16690789	16691728	939	-	0
AT3G45520	3	16692705	16696797	4092	-	0
AT3G45525	3	16697272	16697828	556	-	0
AT3G45530	3	16701132	16703366	2234	-	2
AT3G45540	3	16706311	16707649	1338	-	1
AT3G45550	3	16709444	16712000	2556	-	0
AT3G45555	3	16712367	16713009	642	-	0
AT3G45560	3	16719629	16722674	3045	-	0
AT3G45570	3	16725093	16726116	1023	-	0
AT3G45577	3	16728700	16729547	847	+	0
AT3G45580	3	16729988	16731511	1523	-	0
AT3G45590	3	16732592	16733854	1262	+	57
AT3G45600	3	16733754	16735951	2197	-	800
AT3G45610	3	16739288	16740445	1157	-	68
AT3G45620	3	16745881	16748156	2275	+	413
AT3G45630	3	16748173	16753833	5660	-	1176
AT3G45638	3	16755214	16756290	1076	-	6
AT3G45640	3	16756769	16758698	1929	+	1478
AT3G45650	3	16759252	16761266	2014	+	121
AT3G45660	3	16762204	16764241	2037	+	2
AT3G45670	3	16765319	16766459	1140	+	0
AT3G45673	3	16768074	16768257	183	-	0
AT3G45680	3	16770932	16773030	2098	+	95
AT3G45690	3	16776267	16778150	1883	+	0
AT3G45700	3	16778712	16781198	2486	+	0
AT3G45710	3	16782642	16784735	2093	+	15
AT3G45720	3	16785045	16786945	1900	+	0
AT3G45730	3	16789979	16790582	603	+	40
AT3G45740	3	16790760	16793534	2774	+	261
AT3G45750	3	16793610	16797947	4337	-	233
AT3G45755	3	16799248	16800514	1266	+	0
AT3G45760	3	16801995	16804967	2972	-	0
AT3G45770	3	16805561	16807856	2295	-	975
AT3G45775	3	16809431	16813871	4440	-	0
AT3G45780	3	16816865	16824210	7345	+	10053
AT3G45790	3	16825004	16826222	1218	-	0
AT3G45800	3	16829481	16832207	2726	-	0
AT3G45810	3	16832882	16837569	4687	-	0
AT3G45820	3	16840029	16840983	954	-	6
AT3G45830	3	16841276	16845541	4265	+	530
AT3G45840	3	16847903	16849887	1984	-	2
AT3G45850	3	16855611	16861527	5916	-	1427
AT3G45851	3	16861430	16861535	105	+	0
AT3G45860	3	16863400	16866041	2641	-	567
AT3G45870	3	16867201	16868926	1725	+	15
AT3G45880	3	16868913	16871548	2635	-	48
AT3G45890	3	16871680	16874311	2631	+	178
AT3G45900	3	16874401	16876083	1682	-	522
AT3G45910	3	16876337	16877075	738	-	0
AT3G45920	3	16882181	16883001	820	+	0
AT3G45930	3	16883315	16883876	561	+	287
AT3G45935	3	16885890	16885964	74	+	0
AT3G45940	3	16886225	16889171	2946	-	33
AT3G45950	3	16889460	16890618	1158	-	7
AT3G45955	3	16891638	16891712	74	+	0
AT3G45960	3	16892755	16893900	1145	+	2
AT3G45965	3	16894162	16894236	74	+	0
AT3G45970	3	16896165	16897308	1143	+	47
AT3G45980	3	16897286	16898013	727	-	2374
AT3G45990	3	16900777	16904136	3359	-	0
AT3G46000	3	16907450	16908999	1549	-	1518
AT3G46010	3	16909362	16910820	1458	-	2202
AT3G46020	3	16912343	16913350	1007	-	73
AT3G46030	3	16913447	16914131	684	-	1735
AT3G46040	3	16914538	16915759	1221	+	1205
AT3G46050	3	16916071	16917184	1113	+	0
AT3G46060	3	16917588	16920018	2430	+	1488
AT3G46070	3	16920444	16920957	513	-	0
AT3G46080	3	16922752	16923247	495	-	9
AT3G46086	3	16925141	16925258	117	-	0
AT3G46090	3	16926215	16926850	635	-	27
AT3G46100	3	16928293	16931033	2740	-	1250
AT3G46110	3	16932111	16933726	1615	+	41
AT3G46120	3	16935920	16939766	3846	-	0
AT3G46130	3	16945363	16946461	1098	+	302
AT3G46140	3	16948089	16949220	1131	+	0
AT3G46150	3	16949530	16950145	615	-	4
AT3G46160	3	16950954	16952136	1182	+	0
AT3G46170	3	16952722	16953589	867	-	1
AT3G46180	3	16954364	16956833	2469	-	197
AT3G46183	3	16957634	16962212	4578	-	0
AT3G46186	3	16963250	16963628	378	+	0
AT3G46190	3	16965888	16967345	1457	+	0
AT3G46200	3	16969265	16971204	1939	+	209
AT3G46206	3	16974645	16974765	120	-	0
AT3G46210	3	16976685	16978923	2238	-	182
AT3G46220	3	16979047	16984177	5130	+	458
AT3G46230	3	16984117	16984841	724	-	15
AT3G46240	3	16985842	16988064	2222	-	0
AT3G46250	3	16990101	16992407	2306	-	0
AT3G46260	3	16998162	16999992	1830	-	0
AT3G46270	3	17000640	17004251	3611	-	1
AT3G46280	3	17005482	17008424	2942	-	0
AT3G46290	3	17012727	17015885	3158	+	1264
AT3G46300	3	17015776	17016746	970	-	1
AT3G46310	3	17017450	17017825	375	-	1
AT3G46320	3	17019910	17020428	518	-	274
AT3G46330	3	17020746	17025011	4265	-	0
AT3G46340	3	17026657	17031842	5185	+	0
AT3G46345	3	17032488	17032836	348	+	0
AT3G46350	3	17036426	17041680	5254	+	0
AT3G46360	3	17042214	17043500	1286	-	0
AT3G46370	3	17051954	17055514	3560	+	626
AT3G46375	3	17055918	17057277	1359	+	0
AT3G46380	3	17059217	17059896	679	-	0
AT3G46382	3	17063424	17064105	681	+	0
AT3G46384	3	17064270	17065121	851	+	0
AT3G46385	3	17065484	17066571	1087	-	139
AT3G46387	3	17067674	17068604	930	+	0
AT3G46390	3	17071254	17071683	429	-	0
AT3G46400	3	17073195	17077328	4133	+	0
AT3G46410	3	17079092	17080684	1592	+	0
AT3G46420	3	17082107	17086534	4427	+	0
AT3G46430	3	17087593	17088753	1160	+	1090
AT3G46440	3	17089044	17091875	2831	-	231
AT3G46450	3	17092937	17095639	2702	-	730
AT3G46460	3	17095877	17097452	1575	-	609
AT3G46470	3	17099915	17100973	1058	-	0
AT3G46480	3	17103172	17105594	2422	+	2
AT3G46482	3	17105740	17106055	315	-	0
AT3G46484	3	17106789	17110692	3903	+	0
AT3G46487	3	17111428	17114136	2708	+	0
AT3G46490	3	17115628	17119451	3823	+	230
AT3G46500	3	17120479	17122745	2266	+	0
AT3G46510	3	17123738	17126691	2953	-	1070
AT3G46520	3	17128262	17130210	1948	+	4
AT3G46530	3	17130366	17133338	2972	-	1122
AT3G46540	3	17134090	17135587	1497	-	1093
AT3G46550	3	17136455	17137874	1419	-	844
AT3G46560	3	17138586	17139512	926	+	520
AT3G46570	3	17145796	17146867	1071	-	0
AT3G46580	3	17148341	17149589	1248	+	173
AT3G46585	3	17149751	17149823	72	+	0
AT3G46590	3	17152774	17156227	3453	+	2079
AT3G46600	3	17157923	17159965	2042	+	557
AT3G46610	3	17160004	17162475	2471	-	607
AT3G46613	3	17165790	17166225	435	+	0
AT3G46614	3	17170380	17171044	664	-	2
AT3G46616	3	17173443	17173752	309	-	0
AT3G46620	3	17178696	17180067	1371	-	190
AT3G46630	3	17180933	17182457	1524	-	1051
AT3G46640	3	17183069	17185218	2149	+	42
AT3G46650	3	17185452	17187812	2360	-	53
AT3G46658	3	17188869	17191167	2298	+	3
AT3G46660	3	17189263	17191167	1904	-	0
AT3G46666	3	17191597	17191893	296	-	0
AT3G46668	3	17191667	17195280	3613	+	33
AT3G46670	3	17192588	17194397	1809	-	663
AT3G46680	3	17195317	17196743	1426	-	0
AT3G46690	3	17197625	17199337	1712	-	0
AT3G46700	3	17200300	17201889	1589	-	0
AT3G46710	3	17206488	17209032	2544	-	0
AT3G46720	3	17210854	17212348	1494	-	12
AT3G46730	3	17213068	17215612	2544	-	21
AT3G46740	3	17215812	17219343	3531	-	2974
AT3G46750	3	17219740	17221638	1898	+	0
AT3G46760	3	17222026	17223040	1014	+	0
AT3G46770	3	17223953	17225316	1363	+	4
AT3G46780	3	17228672	17231201	2529	+	43447
AT3G46790	3	17231772	17234002	2230	-	269
AT3G46800	3	17234493	17236542	2049	-	0
AT3G46810	3	17238235	17240623	2388	-	0
AT3G46820	3	17241780	17244277	2497	-	381
AT3G46830	3	17246343	17248713	2370	-	571
AT3G46840	3	17251010	17254113	3103	+	0
AT3G46850	3	17256337	17259442	3105	+	0
AT3G46860	3	17260233	17260599	366	+	0
AT3G46870	3	17262982	17264475	1493	+	212
AT3G46875	3	17264579	17264661	82	+	0
AT3G46880	3	17265292	17266266	974	+	20
AT3G46890	3	17266340	17267128	788	-	16
AT3G46900	3	17268874	17269510	636	+	332
AT3G46901	3	17271247	17271421	174	-	0
AT3G46904	3	17273695	17273806	111	+	0
AT3G46910	3	17278635	17279652	1017	+	0
AT3G46911	3	17279710	17280176	466	+	0
AT3G46920	3	17280429	17284857	4428	-	265
AT3G46930	3	17285642	17288032	2390	+	85
AT3G46940	3	17288193	17288952	759	-	361
AT3G46950	3	17289368	17290963	1595	+	75
AT3G46960	3	17290872	17298067	7195	-	720
AT3G46970	3	17301393	17306446	5053	-	4032
AT3G46980	3	17307002	17309938	2936	-	767
AT3G46990	3	17311671	17313752	2081	+	113
AT3G47000	3	17313645	17316566	2921	-	803
AT3G47010	3	17316648	17319531	2883	-	279
AT3G47020	3	17319861	17321077	1216	+	0
AT3G47021	3	17321210	17321519	309	+	0
AT3G47030	3	17322118	17323545	1427	+	5
AT3G47040	3	17324161	17327152	2991	-	0
AT3G47050	3	17328032	17330889	2857	-	1
AT3G47060	3	17332984	17336966	3982	+	514
AT3G47070	3	17337064	17337733	669	-	10506
AT3G47080	3	17338105	17340396	2291	-	673
AT3G47090	3	17341511	17344645	3134	-	118
AT3G47100	3	17345569	17346106	537	+	27
AT3G47110	3	17347102	17350296	3194	-	43
AT3G47120	3	17351140	17352822	1682	-	199
AT3G47130	3	17353713	17354851	1138	+	1
AT3G47140	3	17357025	17357801	776	+	0
AT3G47150	3	17358590	17359765	1175	+	0
AT3G47160	3	17359987	17362118	2131	-	143
AT3G47165	3	17363359	17363833	474	-	0
AT3G47170	3	17368671	17370494	1823	-	0
AT3G47180	3	17372799	17373547	748	-	33
AT3G47190	3	17374378	17376054	1676	-	0
AT3G47200	3	17377499	17379235	1736	-	0
AT3G47210	3	17385312	17387244	1932	+	1
AT3G47220	3	17387975	17390762	2787	+	1
AT3G47230	3	17392098	17393699	1601	-	1
AT3G47240	3	17393860	17394988	1128	-	5
AT3G47250	3	17399876	17401731	1855	-	1908
AT3G47260	3	17403128	17407827	4699	+	0
AT3G47270	3	17409791	17413813	4022	+	0
AT3G47280	3	17414406	17417056	2650	-	0
AT3G47290	3	17420509	17423588	3079	+	895
AT3G47295	3	17427949	17428511	562	+	518
AT3G47300	3	17428442	17429623	1181	-	96
AT3G47310	3	17430151	17432359	2208	+	0
AT3G47320	3	17433458	17433966	508	+	0
AT3G47330	3	17434492	17436912	2420	-	0
AT3G47340	3	17437883	17441243	3360	-	230
AT3G47341	3	17441420	17441567	147	+	0
AT3G47342	3	17445381	17445459	78	+	20
AT3G47347	3	17445809	17445886	77	+	18
AT3G47348	3	17445962	17446047	85	+	52
AT3G47350	3	17446817	17449703	2886	+	385
AT3G47360	3	17451111	17452843	1732	+	142
AT3G47370	3	17453477	17454721	1244	-	1423
AT3G47380	3	17457794	17458570	776	+	70
AT3G47390	3	17459338	17464716	5378	+	580
AT3G47400	3	17465589	17468118	2529	+	27
AT3G47410	3	17468794	17469460	666	-	0
AT3G47420	3	17472341	17475258	2917	-	1605
AT3G47430	3	17480602	17481792	1190	+	1249
AT3G47440	3	17482024	17483158	1134	+	0
AT3G47450	3	17483067	17486347	3280	-	1125
AT3G47460	3	17486764	17493395	6631	+	207
AT3G47470	3	17493371	17495033	1662	-	227505
AT3G47480	3	17496353	17496947	594	-	63
AT3G47490	3	17498278	17500980	2702	+	622
AT3G47500	3	17503999	17506058	2059	-	3149
AT3G47510	3	17511078	17511858	780	+	81
AT3G47520	3	17513273	17515041	1768	+	2767
AT3G47530	3	17517354	17519165	1811	-	44
AT3G47540	3	17521028	17522624	1596	+	163
AT3G47543	3	17522655	17522829	174	-	0
AT3G47550	3	17523457	17525540	2083	+	409
AT3G47560	3	17525484	17527052	1568	-	831
AT3G47570	3	17527506	17530929	3423	+	155
AT3G47580	3	17532647	17536059	3412	+	302
AT3G47590	3	17535758	17537530	1772	-	327
AT3G47600	3	17539337	17541230	1893	-	162
AT3G47610	3	17549120	17551420	2300	+	329
AT3G47620	3	17558848	17560767	1919	+	977
AT3G47630	3	17563045	17565496	2451	-	225
AT3G47640	3	17567125	17569385	2260	+	129
AT3G47650	3	17569504	17570567	1063	+	4897
AT3G47660	3	17571191	17574805	3614	+	10
AT3G47670	3	17574784	17575880	1096	-	276
AT3G47675	3	17576003	17576537	534	-	147
AT3G47680	3	17577397	17579577	2180	-	508
AT3G47690	3	17581095	17583586	2491	+	68
AT3G47700	3	17583600	17586624	3024	-	232
AT3G47710	3	17590728	17591455	727	+	0
AT3G47720	3	17592624	17594132	1508	+	0
AT3G47730	3	17594059	17598896	4837	-	803
AT3G47740	3	17600650	17604965	4315	+	0
AT3G47750	3	17606426	17610889	4463	+	150
AT3G47760	3	17611786	17616639	4853	+	0
AT3G47770	3	17618054	17622678	4624	+	0
AT3G47780	3	17624478	17629013	4535	+	104
AT3G47790	3	17629529	17633911	4382	+	1
AT3G47800	3	17634809	17637204	2395	+	300
AT3G47810	3	17637121	17639691	2570	-	1252
AT3G47820	3	17644427	17646160	1733	+	166
AT3G47830	3	17647068	17648346	1278	+	50
AT3G47833	3	17648622	17650140	1518	+	724
AT3G47836	3	17650259	17651765	1506	-	313
AT3G47840	3	17651911	17654032	2121	+	6
AT3G47850	3	17654071	17656013	1942	-	345
AT3G47860	3	17656669	17658316	1647	-	642
AT3G47870	3	17659679	17661008	1329	-	1
AT3G47875	3	17663474	17666891	3417	-	16
AT3G47890	3	17666926	17673530	6604	-	911
AT3G47910	3	17674381	17681730	7349	-	1395
AT3G47920	3	17682951	17683854	903	+	0
AT3G47930	3	17684443	17687620	3177	+	530
AT3G47940	3	17687955	17689549	1594	-	129
AT3G47950	3	17692701	17697999	5298	+	55
AT3G47960	3	17697941	17700833	2892	-	1219
AT3G47965	3	17707917	17708909	992	-	122
AT3G47980	3	17710373	17712866	2493	+	22
AT3G47990	3	17713143	17716308	3165	-	544
AT3G48000	3	17716866	17720020	3154	-	4636
AT3G48010	3	17721334	17724028	2694	-	3
AT3G48020	3	17724589	17725198	609	+	3
AT3G48030	3	17725409	17727954	2545	-	254
AT3G48040	3	17731479	17733492	2013	+	174
AT3G48050	3	17733532	17739412	5880	-	1005
AT3G48057	3	17742108	17742291	183	+	0
AT3G48058	3	17742334	17742715	381	+	0
AT3G48060	3	17743113	17748736	5623	-	405
AT3G48070	3	17750710	17752761	2051	+	551
AT3G48080	3	17752937	17755190	2253	-	31
AT3G48090	3	17755373	17757780	2407	-	570
AT3G48100	3	17758426	17760874	2448	-	206
AT3G48110	3	17763000	17771146	8146	+	2500
AT3G48115	3	17771169	17772926	1757	-	258
AT3G48120	3	17772056	17774739	2683	+	162
AT3G48130	3	17774951	17775128	177	-	1
AT3G48131	3	17775455	17775587	132	-	1
AT3G48140	3	17778355	17779549	1194	+	4410
AT3G48150	3	17779652	17782645	2993	-	111
AT3G48160	3	17783330	17786099	2769	+	89
AT3G48170	3	17786139	17790008	3869	-	1312
AT3G48180	3	17790464	17790919	455	-	6
AT3G48185	3	17793010	17793543	533	-	27
AT3G48190	3	17797333	17828591	31258	+	946
AT3G48195	3	17828571	17832731	4160	-	403
AT3G48200	3	17832772	17837514	4742	-	5355
AT3G48201	3	17838134	17838266	132	-	1
AT3G48205	3	17840653	17841257	604	+	0
AT3G48208	3	17846072	17846342	270	+	0
AT3G48209	3	17847680	17847884	204	+	0
AT3G48210	3	17849358	17851683	2325	+	128
AT3G48220	3	17852283	17853557	1274	-	0
AT3G48230	3	17855111	17858120	3009	+	0
AT3G48231	3	17858258	17858874	616	-	0
AT3G48235	3	17863753	17865925	2172	+	0
AT3G48237	3	17866532	17866685	153	-	0
AT3G48240	3	17867315	17868387	1072	+	77
AT3G48250	3	17870063	17871929	1866	-	99
AT3G48260	3	17873011	17875220	2209	-	32
AT3G48270	3	17876570	17878173	1603	+	0
AT3G48275	3	17894410	17894482	72	+	0
AT3G48280	3	17879565	17881312	1747	+	272
AT3G48290	3	17882555	17884270	1715	+	55
AT3G48298	3	17885541	17885667	126	-	0
AT3G48300	3	17885523	17887118	1595	+	18
AT3G48310	3	17888100	17889814	1714	+	758
AT3G48320	3	17891133	17892847	1714	+	450
AT3G48330	3	17892737	17893975	1238	-	444
AT3G48340	3	17897738	17899208	1470	+	10
AT3G48344	3	17902087	17902255	168	-	0
AT3G48346	3	17903303	17903462	159	+	1
AT3G48350	3	17905724	17907561	1837	+	119
AT3G48360	3	17908191	17910525	2334	-	4
AT3G48370	3	17914247	17914992	745	-	0
AT3G48380	3	17916415	17920237	3822	+	460
AT3G48390	3	17920814	17923496	2682	+	49
AT3G48400	3	17923677	17925589	1912	+	0
AT3G48410	3	17925701	17928188	2487	-	104
AT3G48420	3	17929646	17931701	2055	+	6048
AT3G48425	3	17931817	17934744	2927	+	183
AT3G48430	3	17935608	17940746	5138	+	656
AT3G48440	3	17941401	17943576	2175	+	142
AT3G48450	3	17944028	17944888	860	-	6
AT3G48460	3	17949444	17951195	1751	+	1345
AT3G48470	3	17951688	17956812	5124	+	179
AT3G48480	3	17957097	17959124	2027	-	34
AT3G48490	3	17961288	17961910	622	+	59
AT3G48500	3	17962162	17965613	3451	+	1160
AT3G48510	3	17967353	17968538	1185	-	9
AT3G48515	3	17974590	17974626	36	-	0
AT3G48520	3	17974976	17976670	1694	-	0
AT3G48523	3	17979163	17983387	4224	-	17
AT3G48526	3	17984170	17985383	1213	+	2
AT3G48530	3	17987377	17989763	2386	+	673
AT3G48540	3	17989797	17992015	2218	-	63
AT3G48550	3	17993998	17994734	736	+	115
AT3G48560	3	18001311	18003581	2270	-	10972
AT3G48570	3	18003912	18004974	1062	-	183
AT3G48580	3	18007164	18008488	1324	+	26
AT3G48590	3	18008656	18009982	1326	-	448
AT3G48600	3	18010092	18011440	1348	-	61
AT3G48610	3	18011544	18014082	2538	-	1034
AT3G48620	3	18015982	18017810	1828	+	0
AT3G48630	3	18018225	18018808	583	-	0
AT3G48640	3	18021649	18022324	675	-	15
AT3G48650	3	18024662	18026149	1487	+	38
AT3G48660	3	18029658	18030133	475	+	20
AT3G48670	3	18030780	18034065	3285	+	614
AT3G48675	3	18034191	18034551	360	+	0
AT3G48680	3	18035010	18037041	2031	+	825
AT3G48690	3	18037046	18038234	1188	-	1871
AT3G48700	3	18038647	18039876	1229	-	37
AT3G48710	3	18040936	18044226	3290	+	601
AT3G48720	3	18046322	18049463	3141	+	841
AT3G48730	3	18049613	18051702	2089	+	5349
AT3G48740	3	18052465	18054755	2290	-	2548
AT3G48745	3	18069077	18069149	72	+	0
AT3G48750	3	18071535	18074641	3106	+	855
AT3G48760	3	18075793	18078291	2498	+	727
AT3G48770	3	18078473	18086817	8344	-	25
AT3G48780	3	18089060	18093088	4028	+	699
AT3G48790	3	18093403	18095181	1778	+	28
AT3G48800	3	18095824	18096661	837	-	165
AT3G48810	3	18097047	18099721	2674	+	152
AT3G48820	3	18099728	18102911	3183	-	313
AT3G48830	3	18103151	18110216	7065	+	51
AT3G48840	3	18112720	18114070	1350	-	1
AT3G48850	3	18114525	18116499	1974	-	3
AT3G48860	3	18117485	18122093	4608	+	511
AT3G48870	3	18122196	18126742	4546	-	3547
AT3G48880	3	18126869	18129189	2320	+	376
AT3G48890	3	18129600	18131573	1973	+	983
AT3G48900	3	18131828	18136343	4515	+	54
AT3G48920	3	18139391	18140561	1170	+	4
AT3G48930	3	18140770	18142281	1511	-	3490
AT3G48940	3	18142862	18144163	1301	-	0
AT3G48950	3	18148016	18149987	1971	+	0
AT3G48960	3	18150443	18151412	969	-	0
AT3G48970	3	18152287	18153375	1088	-	19
AT3G48980	3	18155415	18158417	3002	+	128
AT3G48990	3	18158746	18161379	2633	-	2588
AT3G49000	3	18162700	18165986	3286	+	385
AT3G49010	3	18166768	18168692	1924	-	4279
AT3G49020	3	18169078	18170660	1582	+	0
AT3G49030	3	18173086	18174947	1861	+	0
AT3G49040	3	18177675	18179339	1664	+	0
AT3G49050	3	18180967	18183752	2785	+	419
AT3G49051	3	18184290	18184431	141	-	0
AT3G49055	3	18185165	18186968	1803	-	16
AT3G49060	3	18186897	18191992	5095	-	492
AT3G49070	3	18192478	18193729	1251	-	35
AT3G49080	3	18194153	18196727	2574	-	569
AT3G49100	3	18196838	18198457	1619	+	174
AT3G49110	3	18200663	18203142	2479	+	201
AT3G49115	3	18205774	18205975	201	+	0
AT3G49120	3	18207650	18210132	2482	+	862
AT3G49130	3	18210452	18211708	1256	+	2
AT3G49140	3	18211862	18215619	3757	-	2125
AT3G49142	3	18215787	18217848	2061	-	20
AT3G49150	3	18218857	18221918	3061	+	2
AT3G49160	3	18221993	18224885	2892	-	556
AT3G49162	3	18225378	18226805	1427	-	0
AT3G49170	3	18226910	18229610	2700	-	76
AT3G49180	3	18229748	18232004	2256	+	151
AT3G49190	3	18231844	18234391	2547	-	1
AT3G49200	3	18235268	18237646	2378	-	0
AT3G49210	3	18238047	18241237	3190	-	50
AT3G49220	3	18249775	18253839	4064	+	2345
AT3G49230	3	18254231	18255485	1254	+	0
AT3G49240	3	18255978	18258100	2122	+	252
AT3G49250	3	18258260	18260998	2738	-	234
AT3G49260	3	18262398	18266021	3623	+	1574
AT3G49270	3	18267251	18268271	1020	-	0
AT3G49280	3	18270024	18270934	910	+	0
AT3G49290	3	18272424	18275341	2917	+	476
AT3G49300	3	18276769	18277605	836	-	3
AT3G49305	3	18279749	18280408	659	-	0
AT3G49307	3	18282204	18283194	990	-	0
AT3G49310	3	18284856	18288059	3203	-	438
AT3G49320	3	18288246	18290672	2426	-	66
AT3G49330	3	18291487	18292048	561	+	26
AT3G49340	3	18293346	18294577	1231	-	17
AT3G49350	3	18297405	18300189	2784	-	234
AT3G49360	3	18303045	18304416	1371	-	262
AT3G49370	3	18304741	18307906	3165	-	56
AT3G49380	3	18311908	18313490	1582	-	4
AT3G49390	3	18314526	18317998	3472	-	635
AT3G49400	3	18319212	18324624	5412	-	94
AT3G49410	3	18324745	18329191	4446	+	48
AT3G49420	3	18329386	18331431	2045	+	32
AT3G49430	3	18331538	18335041	3503	+	1002
AT3G49440	3	18335714	18336317	603	-	0
AT3G49450	3	18337304	18338498	1194	-	0
AT3G49460	3	18340350	18340616	266	-	0
AT3G49470	3	18340975	18342489	1514	+	1776
AT3G49480	3	18342543	18343473	930	-	4
AT3G49490	3	18344743	18348699	3956	-	1206
AT3G49500	3	18349160	18353624	4464	-	794
AT3G49510	3	18353841	18356508	2667	+	33
AT3G49520	3	18359583	18360750	1167	+	0
AT3G49530	3	18362442	18364913	2471	-	360
AT3G49540	3	18365677	18366565	888	+	0
AT3G49550	3	18367908	18368900	992	+	98
AT3G49551	3	18368820	18368988	168	-	11
AT3G49560	3	18370563	18372139	1576	+	1639
AT3G49570	3	18372532	18373024	492	-	14
AT3G49580	3	18375268	18375784	516	-	50
AT3G49590	3	18377478	18380284	2806	+	638
AT3G49600	3	18380548	18387128	6580	-	666
AT3G49601	3	18387301	18389564	2263	-	839
AT3G49610	3	18390412	18391417	1005	-	0
AT3G49620	3	18393746	18396816	3070	+	2
AT3G49630	3	18397758	18400255	2497	+	0
AT3G49640	3	18400305	18402869	2564	-	240
AT3G49645	3	18403001	18404788	1787	-	100
AT3G49650	3	18405007	18409709	4702	-	349
AT3G49660	3	18413612	18415579	1967	+	83
AT3G49668	3	18417564	18418278	714	-	0
AT3G49670	3	18417567	18421106	3539	+	2292
AT3G49680	3	18422648	18425693	3045	+	4092
AT3G49690	3	18427734	18429201	1467	+	1
AT3G49700	3	18434469	18436141	1672	-	0
AT3G49710	3	18437844	18440010	2166	+	71
AT3G49720	3	18440002	18442198	2196	-	1604
AT3G49725	3	18442274	18445457	3183	-	110
AT3G49730	3	18445729	18447646	1917	-	155
AT3G49740	3	18447787	18450094	2307	+	26
AT3G49744	3	18450231	18450405	174	-	0
AT3G49750	3	18450425	18451494	1069	-	90
AT3G49760	3	18455346	18456125	779	-	0
AT3G49765	3	18460140	18460581	441	+	0
AT3G49770	3	18460889	18461876	987	-	0
AT3G49780	3	18465678	18466376	698	+	82
AT3G49790	3	18468050	18469763	1713	-	138
AT3G49796	3	18471056	18471302	246	+	0
AT3G49800	3	18471624	18473743	2119	-	616
AT3G49810	3	18474536	18476834	2298	-	385
AT3G49820	3	18481236	18481722	486	+	1
AT3G49830	3	18482382	18483940	1558	+	0
AT3G49832	3	18484000	18484495	495	+	0
AT3G49840	3	18484512	18487043	2531	+	131
AT3G49845	3	18487257	18488298	1041	+	0
AT3G49850	3	18489033	18490996	1963	+	421
AT3G49860	3	18491121	18492177	1056	-	13
AT3G49870	3	18492407	18494139	1732	-	1273
AT3G49880	3	18496248	18498713	2465	+	344
AT3G49890	3	18499169	18500722	1553	+	61
AT3G49900	3	18500574	18502725	2151	-	214
AT3G49910	3	18504255	18504967	712	+	5193
AT3G49920	3	18505835	18507835	2000	-	73
AT3G49925	3	18507811	18507885	74	+	0
AT3G49930	3	18510245	18510963	718	+	4
AT3G49940	3	18514342	18515475	1133	+	295
AT3G49950	3	18522509	18523906	1397	+	19
AT3G49960	3	18524083	18525687	1604	-	10
AT3G49970	3	18527215	18529066	1851	-	15
AT3G49980	3	18530328	18531477	1149	-	1
AT3G49990	3	18532322	18534274	1952	-	763
AT3G50000	3	18534458	18536970	2512	+	982
AT3G50010	3	18537182	18539601	2419	-	3
AT3G50020	3	18542164	18542687	523	-	0
AT3G50022	3	18543559	18543709	150	-	0
AT3G50030	3	18546489	18548132	1643	-	2
AT3G50040	3	18549267	18551041	1774	-	24
AT3G50050	3	18553983	18557209	3226	-	199
AT3G50060	3	18557969	18559106	1137	-	205
AT3G50070	3	18565133	18566780	1647	-	313
AT3G50080	3	18572735	18574514	1779	+	281
AT3G50090	3	18575431	18577336	1905	+	0
AT3G50100	3	18578352	18580594	2242	+	155
AT3G50110	3	18580608	18584535	3927	-	206
AT3G50120	3	18584999	18587312	2313	-	5
AT3G50123	3	18587973	18588117	144	+	0
AT3G50130	3	18589110	18591273	2163	-	3
AT3G50140	3	18592400	18594564	2164	-	2
AT3G50150	3	18595730	18597642	1912	-	0
AT3G50160	3	18598428	18601009	2581	-	0
AT3G50170	3	18601754	18603793	2039	-	6
AT3G50180	3	18604940	18607162	2222	-	0
AT3G50190	3	18609113	18611169	2056	-	4
AT3G50200	3	18612461	18613323	862	-	0
AT3G50210	3	18614169	18616452	2283	-	150
AT3G50220	3	18617423	18618729	1306	-	27
AT3G50230	3	18620598	18623200	2602	+	4
AT3G50240	3	18623261	18628888	5627	-	1242
AT3G50250	3	18630031	18630478	447	-	0
AT3G50260	3	18634575	18635398	823	+	1
AT3G50270	3	18635919	18637341	1422	+	790
AT3G50280	3	18637853	18639185	1332	+	1
AT3G50290	3	18640171	18640993	822	+	0
AT3G50295	3	18641797	18642664	867	+	0
AT3G50300	3	18643954	18645406	1452	+	9
AT3G50301	3	18645923	18646505	582	+	0
AT3G50310	3	18648150	18649521	1371	-	7
AT3G50320	3	18653730	18654717	987	-	0
AT3G50330	3	18657207	18658307	1100	-	0
AT3G50337	3	18663067	18663235	168	-	0
AT3G50340	3	18665093	18666672	1579	-	234
AT3G50350	3	18672101	18674022	1921	+	77
AT3G50360	3	18674336	18675712	1376	+	672
AT3G50370	3	18676058	18684346	8288	-	2822
AT3G50373	3	18684658	18685121	463	-	0
AT3G50376	3	18685471	18686071	600	+	0
AT3G50380	3	18686442	18700533	14091	-	1641
AT3G50390	3	18702073	18703619	1546	+	15
AT3G50400	3	18704764	18706570	1806	+	0
AT3G50410	3	18709747	18710760	1013	+	85
AT3G50420	3	18710870	18713649	2779	-	17
AT3G50430	3	18713696	18717409	3713	+	159
AT3G50440	3	18717310	18718494	1184	-	676
AT3G50450	3	18722414	18723135	721	+	1
AT3G50460	3	18727839	18728649	810	+	0
AT3G50470	3	18729053	18730269	1216	+	30
AT3G50480	3	18733067	18734388	1321	+	536
AT3G50490	3	18738629	18739261	632	+	0
AT3G50500	3	18741589	18744157	2568	-	1002
AT3G50505	3	18744807	18744879	72	-	0
AT3G50510	3	18744886	18745623	737	-	7
AT3G50520	3	18748022	18749593	1571	+	408
AT3G50530	3	18753540	18756773	3233	+	1146
AT3G50540	3	18757748	18758244	496	+	0
AT3G50550	3	18759462	18760510	1048	+	249
AT3G50560	3	18761087	18764016	2929	-	251
AT3G50570	3	18766748	18767529	781	-	32
AT3G50580	3	18768630	18769519	889	-	0
AT3G50590	3	18771018	18779502	8484	+	2165
AT3G50610	3	18779722	18780412	690	-	0
AT3G50620	3	18784694	18786914	2220	-	111
AT3G50625	3	18791542	18796042	4500	+	0
AT3G50630	3	18800379	18801587	1208	+	252
AT3G50640	3	18803802	18804663	861	-	0
AT3G50650	3	18806257	18808210	1953	-	103
AT3G50651	3	18808690	18808882	192	+	0
AT3G50660	3	18814139	18817244	3105	-	317
AT3G50665	3	18826039	18826111	72	+	0
AT3G50670	3	18826299	18829618	3319	-	1736
AT3G50674	3	18831162	18831507	345	+	0
AT3G50680	3	18833330	18833805	475	-	0
AT3G50682	3	18833967	18834096	129	-	0
AT3G50685	3	18834154	18834834	680	-	3683
AT3G50690	3	18834966	18837097	2131	-	658
AT3G50695	3	18838993	18839131	138	-	0
AT3G50700	3	18840410	18842950	2540	+	235
AT3G50710	3	18845198	18846673	1475	-	0
AT3G50720	3	18847518	18849430	1912	-	0
AT3G50730	3	18851532	18853137	1605	-	0
AT3G50740	3	18855160	18856884	1724	-	634
AT3G50750	3	18861838	18863234	1396	-	701
AT3G50751	3	18863689	18863869	180	+	0
AT3G50755	3	18864774	18865254	480	+	0
AT3G50760	3	18868064	18869384	1320	+	192
AT3G50764	3	18871490	18871631	141	-	0
AT3G50770	3	18873957	18874780	823	+	32
AT3G50780	3	18875398	18877534	2136	-	468
AT3G50790	3	18879922	18881982	2060	-	1582
AT3G50800	3	18882303	18882999	696	-	27
AT3G50808	3	18887613	18888047	434	-	0
AT3G50810	3	18888867	18890101	1234	-	41
AT3G50820	3	18890875	18892426	1551	-	62606
AT3G50825	3	18893403	18893484	81	-	21
AT3G50830	3	18893844	18895497	1653	-	1160
AT3G50835	3	18896870	18896943	73	+	1
AT3G50840	3	18896174	18898621	2447	-	574
AT3G50845	3	18899929	18901209	1280	-	80
AT3G50850	3	18901341	18902152	811	-	23
AT3G50860	3	18901996	18904197	2201	+	181
AT3G50870	3	18910989	18912608	1619	+	36
AT3G50880	3	18913485	18914960	1475	+	297
AT3G50890	3	18916165	18917328	1163	+	182
AT3G50895	3	18917432	18917506	74	+	0
AT3G50900	3	18918018	18918618	600	+	39
AT3G50910	3	18919512	18922238	2726	+	453
AT3G50920	3	18922371	18923716	1345	-	288
AT3G50925	3	18925657	18926083	426	-	0
AT3G50930	3	18929525	18931839	2314	+	124
AT3G50940	3	18933762	18935611	1849	+	7
AT3G50950	3	18935673	18938799	3126	+	2209
AT3G50960	3	18938696	18940428	1732	-	92
AT3G50970	3	18940776	18941554	778	+	27
AT3G50980	3	18941924	18942865	941	+	0
AT3G50990	3	18943134	18944811	1677	+	0
AT3G51000	3	18945024	18946621	1597	-	731
AT3G51010	3	18946697	18948157	1460	-	509
AT3G51020	3	18949644	18950221	577	+	0
AT3G51030	3	18950995	18952050	1055	-	93
AT3G51040	3	18952121	18953801	1680	-	306
AT3G51050	3	18953922	18957956	4034	+	889
AT3G51057	3	18962792	18962897	105	-	0
AT3G51060	3	18964343	18966405	2062	+	34
AT3G51070	3	18969067	18972291	3224	+	44
AT3G51075	3	18968742	18972285	3543	-	36
AT3G51080	3	18973212	18974892	1680	+	253
AT3G51090	3	18977987	18980003	2016	-	93
AT3G51100	3	18980262	18982291	2029	-	362
AT3G51110	3	18983625	18985848	2223	+	189
AT3G51120	3	18985899	18992010	6111	-	705
AT3G51130	3	18994140	18997589	3449	+	676
AT3G51135	3	18997642	18997715	73	-	0
AT3G51140	3	18997599	18999904	2305	+	1453
AT3G51150	3	19000855	19006769	5914	+	932
AT3G51160	3	19007009	19008427	1418	-	770
AT3G51171	3	19010804	19012008	1204	+	0
AT3G51180	3	19013389	19016185	2796	+	74
AT3G51190	3	19016605	19017547	942	-	2
AT3G51200	3	19018852	19019173	321	-	0
AT3G51210	3	19020885	19021201	316	+	0
AT3G51220	3	19021733	19022637	904	-	42
AT3G51230	3	19023220	19024351	1131	-	68
AT3G51238	3	19025109	19026779	1670	-	0
AT3G51240	3	19025191	19026872	1681	+	3
AT3G51250	3	19028202	19030676	2474	+	919
AT3G51260	3	19030994	19033064	2070	+	2013
AT3G51265	3	19033392	19033464	72	-	0
AT3G51270	3	19033541	19036946	3405	+	672
AT3G51280	3	19037139	19038951	1812	+	190
AT3G51290	3	19039511	19044371	4860	+	146
AT3G51300	3	19042886	19044372	1486	+	16
AT3G51310	3	19044479	19049382	4903	-	1232
AT3G51320	3	19049601	19051565	1964	-	93
AT3G51325	3	19051990	19052694	704	+	9
AT3G51330	3	19053367	19056224	2857	-	43
AT3G51340	3	19057012	19060036	3024	-	47
AT3G51350	3	19060321	19063510	3189	-	13
AT3G51360	3	19064293	19066560	2267	-	0
AT3G51370	3	19069362	19072195	2833	+	1679
AT3G51375	3	19073449	19073541	92	+	1
AT3G51380	3	19074035	19074426	391	-	26
AT3G51390	3	19075575	19078120	2545	+	186
AT3G51400	3	19077849	19078955	1106	-	0
AT3G51410	3	19081256	19082212	956	-	0
AT3G51420	3	19084034	19085858	1824	+	2051
AT3G51430	3	19086451	19088110	1659	+	207
AT3G51440	3	19089080	19090639	1559	+	19
AT3G51450	3	19090946	19092509	1563	+	152
AT3G51460	3	19092517	19097353	4836	+	920
AT3G51470	3	19097786	19099275	1489	-	170
AT3G51478	3	19099920	19100439	519	+	32
AT3G51480	3	19100675	19104825	4150	+	452
AT3G51490	3	19104884	19107797	2913	-	31
AT3G51500	3	19108133	19108890	757	+	269
AT3G51510	3	19109061	19110051	990	+	3554
AT3G51520	3	19110595	19112760	2165	+	546
AT3G51530	3	19112693	19114643	1950	-	146
AT3G51540	3	19115341	19117210	1869	+	13
AT3G51550	3	19117583	19120881	3298	-	3082
AT3G51560	3	19121807	19125913	4106	-	1
AT3G51570	3	19126357	19130456	4099	+	1
AT3G51580	3	19130767	19133347	2580	-	348
AT3G51590	3	19135664	19136675	1011	-	0
AT3G51600	3	19138393	19139252	859	-	4301
AT3G51610	3	19139551	19142085	2534	-	439
AT3G51620	3	19143651	19148242	4591	+	625
AT3G51630	3	19148870	19152193	3323	+	4
AT3G51632	3	19148906	19152193	3287	+	0
AT3G51636	3	19153591	19153732	141	+	0
AT3G51640	3	19153761	19157321	3560	+	367
AT3G51642	3	19157825	19157936	111	-	1
AT3G51644	3	19158275	19158416	141	-	0
AT3G51650	3	19158970	19162379	3409	+	268
AT3G51660	3	19164062	19165247	1185	-	149
AT3G51670	3	19168849	19171150	2301	+	1437
AT3G51680	3	19173621	19174667	1046	-	1
AT3G51690	3	19176373	19178161	1788	-	0
AT3G51700	3	19179265	19181189	1924	-	0
AT3G51710	3	19182483	19183996	1513	+	33
AT3G51720	3	19185050	19186634	1584	+	424
AT3G51730	3	19186665	19188691	2026	+	3311
AT3G51740	3	19189048	19192051	3003	+	594
AT3G51750	3	19196361	19197356	995	-	217
AT3G51760	3	19197336	19199506	2170	-	149
AT3G51770	3	19199780	19204464	4684	-	749
AT3G51780	3	19206767	19208310	1543	-	416
AT3G51790	3	19209584	19210744	1160	-	120
AT3G51800	3	19211026	19213776	2750	-	2172
AT3G51810	3	19214747	19215831	1084	+	0
AT3G51820	3	19216002	19219057	3055	-	6019
AT3G51830	3	19220120	19225280	5160	+	951
AT3G51840	3	19225359	19229163	3804	-	2853
AT3G51850	3	19232466	19235889	3423	+	1378
AT3G51860	3	19239426	19242913	3487	+	36
AT3G51870	3	19243949	19246936	2987	+	477
AT3G51880	3	19246983	19249124	2141	-	1511
AT3G51890	3	19249479	19250974	1495	-	163
AT3G51895	3	19251286	19255760	4474	-	2145
AT3G51910	3	19265293	19266619	1326	+	24
AT3G51915	3	19267233	19267784	551	-	1
AT3G51920	3	19268042	19269479	1437	-	2203
AT3G51930	3	19271623	19273064	1441	+	72
AT3G51940	3	19273493	19275269	1776	-	117
AT3G51950	3	19277777	19281346	3569	-	5757
AT3G51960	3	19282600	19284146	1546	-	89
AT3G51970	3	19284338	19285582	1244	+	22
AT3G51980	3	19285571	19287552	1981	-	476
AT3G51990	3	19287877	19289330	1453	+	140
AT3G52000	3	19293009	19294702	1693	+	0
AT3G52003	3	19295208	19295436	228	+	0
AT3G52010	3	19296243	19298073	1830	+	1
AT3G52020	3	19299308	19301076	1768	+	0
AT3G52030	3	19301777	19304253	2476	+	368
AT3G52040	3	19304169	19304861	692	-	247
AT3G52050	3	19304990	19309580	4590	+	520
AT3G52055	3	19310058	19310362	304	-	0
AT3G52060	3	19310531	19312286	1755	-	1335
AT3G52070	3	19312717	19313466	749	+	1
AT3G52072	3	19312683	19314731	2048	-	34
AT3G52080	3	19315042	19317843	2801	+	2
AT3G52090	3	19317848	19319123	1275	-	967
AT3G52100	3	19319342	19322773	3431	+	283
AT3G52105	3	19323331	19323827	496	+	186
AT3G52110	3	19323749	19325713	1964	-	264
AT3G52115	3	19326332	19328323	1991	+	57
AT3G52120	3	19328710	19331970	3260	+	1097
AT3G52130	3	19331931	19332473	542	-	5
AT3G52140	3	19332827	19341657	8830	+	1936
AT3G52150	3	19342023	19343466	1443	+	7768
AT3G52155	3	19343694	19344849	1155	+	736
AT3G52160	3	19344971	19346615	1644	-	8
AT3G52170	3	19346751	19349533	2782	-	336
AT3G52180	3	19349651	19353596	3945	-	1385
AT3G52190	3	19353971	19357074	3103	-	301
AT3G52200	3	19360205	19366387	6182	+	1164
AT3G52210	3	19366983	19369494	2511	+	260
AT3G52220	3	19369361	19371074	1713	-	813
AT3G52230	3	19371212	19372687	1475	+	2845
AT3G52240	3	19372713	19375880	3167	-	427
AT3G52250	3	19376137	19383100	6963	+	1436
AT3G52260	3	19383265	19386553	3288	-	173
AT3G52270	3	19387179	19388944	1765	-	7
AT3G52280	3	19389046	19391383	2337	-	452
AT3G52285	3	19392673	19392745	72	-	0
AT3G52290	3	19393818	19396403	2585	+	545
AT3G52300	3	19396564	19398377	1813	+	4624
AT3G52302	3	19398655	19398754	99	-	0
AT3G52310	3	19398627	19402953	4326	+	68
AT3G52320	3	19403019	19404192	1173	-	0
AT3G52330	3	19404954	19406207	1253	-	0
AT3G52340	3	19407022	19409457	2435	+	1156
AT3G52345	3	19409367	19409439	72	-	0
AT3G52350	3	19409605	19410148	543	-	0
AT3G52360	3	19412119	19412918	799	+	636
AT3G52370	3	19417489	19419782	2293	+	648
AT3G52380	3	19421396	19423097	1701	+	5116
AT3G52390	3	19422987	19425214	2227	-	84
AT3G52400	3	19425633	19427141	1508	-	82
AT3G52410	3	19428299	19428920	621	+	0
AT3G52420	3	19429734	19430063	329	+	103
AT3G52430	3	19431370	19434403	3033	+	452
AT3G52440	3	19435446	19436190	744	+	0
AT3G52450	3	19440738	19442383	1645	-	13
AT3G52460	3	19446969	19447872	903	+	16
AT3G52470	3	19450648	19451982	1334	+	622
AT3G52480	3	19452253	19453162	909	-	20
AT3G52490	3	19455698	19458919	3221	-	152
AT3G52500	3	19465498	19467386	1888	-	1524
AT3G52510	3	19469651	19470378	727	-	0
AT3G52520	3	19473482	19473884	402	+	19
AT3G52525	3	19475158	19475961	803	+	27
AT3G52527	3	19478102	19478451	349	-	0
AT3G52530	3	19484866	19485922	1056	-	20
AT3G52535	3	19487128	19488556	1428	+	108
AT3G52540	3	19488545	19489850	1305	-	52
AT3G52550	3	19492105	19492935	830	-	36
AT3G52560	3	19494376	19496095	1719	-	1527
AT3G52561	3	19497081	19497596	515	-	0
AT3G52565	3	19500987	19501067	80	+	0
AT3G52570	3	19501129	19502999	1870	+	192
AT3G52580	3	19503222	19504973	1751	+	1005
AT3G52590	3	19505628	19506932	1304	+	5030
AT3G52600	3	19506890	19509390	2500	-	0
AT3G52605	3	19510337	19511335	998	-	0
AT3G52610	3	19510445	19512658	2213	+	195
AT3G52620	3	19513085	19513645	560	+	3
AT3G52630	3	19513978	19514745	767	+	166
AT3G52640	3	19514872	19520544	5672	-	875
AT3G52660	3	19521659	19524953	3294	+	683
AT3G52670	3	19525246	19526737	1491	+	68
AT3G52680	3	19527028	19531167	4139	+	79
AT3G52690	3	19530735	19531811	1076	+	0
AT3G52700	3	19532194	19538403	6209	-	3
AT3G52705	3	19533919	19534238	319	-	0
AT3G52710	3	19534584	19536018	1434	+	312
AT3G52720	3	19538689	19541284	2595	-	3882
AT3G52730	3	19542930	19544264	1334	-	1604
AT3G52740	3	19546373	19546964	591	-	480
AT3G52742	3	19547357	19549011	1654	-	3
AT3G52748	3	19548971	19549589	618	+	13
AT3G52750	3	19549660	19553014	3354	-	2846
AT3G52760	3	19553678	19554812	1134	-	247
AT3G52765	3	19555035	19555107	72	+	0
AT3G52770	3	19557720	19559007	1287	-	25
AT3G52780	3	19561326	19564195	2869	-	0
AT3G52790	3	19565866	19566354	488	-	1
AT3G52800	3	19569310	19570682	1372	+	758
AT3G52810	3	19570960	19573733	2773	-	0
AT3G52820	3	19573943	19576977	3034	-	27
AT3G52830	3	19578004	19578265	261	+	0
AT3G52840	3	19581112	19586299	5187	+	2498
AT3G52850	3	19587820	19591947	4127	+	2244
AT3G52860	3	19591847	19592767	920	-	136
AT3G52870	3	19593172	19595822	2650	-	1005
AT3G52880	3	19601211	19604454	3243	-	8139
AT3G52890	3	19607956	19612186	4230	+	1148
AT3G52900	3	19613117	19614027	910	+	237
AT3G52905	3	19614006	19615745	1739	-	107
AT3G52910	3	19616020	19618449	2429	-	319
AT3G52920	3	19624342	19626258	1916	+	1362
AT3G52930	3	19626747	19629073	2326	-	5957
AT3G52940	3	19630197	19633296	3099	-	418
AT3G52941	3	19633329	19633473	144	-	0
AT3G52950	3	19634409	19636819	2410	+	577
AT3G52955	3	19637127	19637210	83	+	0
AT3G52957	3	19638398	19639278	880	-	0
AT3G52960	3	19639667	19640619	952	+	5184
AT3G52970	3	19641305	19643282	1977	-	0
AT3G52980	3	19645659	19646962	1303	+	0
AT3G52990	3	19648860	19652508	3648	+	2388
AT3G53000	3	19654067	19656080	2013	+	163
AT3G53010	3	19656487	19658003	1516	-	18
AT3G53015	3	19659300	19659413	113	-	0
AT3G53016	3	19659570	19659676	106	-	0
AT3G53020	3	19660516	19662025	1509	-	4043
AT3G53030	3	19662280	19664505	2225	+	409
AT3G53040	3	19664673	19666487	1814	-	2
AT3G53050	3	19669083	19669774	691	+	0
AT3G53060	3	19670165	19670423	258	+	0
AT3G53065	3	19672872	19673471	599	+	0
AT3G53070	3	19674532	19674942	410	+	0
AT3G53075	3	19676523	19677104	581	+	0
AT3G53080	3	19677992	19678741	749	+	0
AT3G53090	3	19679207	19685360	6153	+	580
AT3G53100	3	19684685	19686674	1989	-	587
AT3G53110	3	19687739	19690661	2922	+	1578
AT3G53120	3	19690570	19692578	2008	-	323
AT3G53130	3	19692770	19697542	4772	+	1324
AT3G53140	3	19695642	19697542	1900	+	0
AT3G53150	3	19697735	19699259	1524	-	4
AT3G53160	3	19702455	19703976	1521	-	23
AT3G53170	3	19704484	19706417	1933	-	144
AT3G53180	3	19706893	19711439	4546	+	1306
AT3G53190	3	19713927	19717595	3668	+	1154
AT3G53200	3	19718281	19719462	1181	-	0
AT3G53210	3	19720164	19721875	1711	+	79
AT3G53220	3	19721993	19722702	709	+	28
AT3G53230	3	19723350	19726672	3322	+	295
AT3G53232	3	19730977	19731423	446	-	4
AT3G53235	3	19733837	19734695	858	-	61
AT3G53240	3	19733765	19739181	5416	+	388
AT3G53250	3	19742967	19743297	330	+	0
AT3G53260	3	19744050	19746780	2730	-	2595
AT3G53270	3	19750046	19753199	3153	-	320
AT3G53280	3	19755703	19757613	1910	+	456
AT3G53290	3	19758156	19759603	1447	+	0
AT3G53294	3	19759982	19760108	126	-	0
AT3G53300	3	19760474	19762357	1883	+	0
AT3G53305	3	19763617	19765268	1651	+	0
AT3G53310	3	19766663	19768599	1936	-	78
AT3G53320	3	19769175	19772369	3194	-	191
AT3G53330	3	19772929	19773938	1009	+	0
AT3G53340	3	19774330	19776205	1875	-	201
AT3G53342	3	19777086	19777353	267	+	0
AT3G53350	3	19780052	19782680	2628	-	149
AT3G53360	3	19784501	19786808	2307	+	21
AT3G53365	3	19787254	19787702	448	+	3
AT3G53370	3	19787893	19788843	950	-	123
AT3G53380	3	19789061	19791416	2355	-	312
AT3G53390	3	19792530	19796753	4223	+	472
AT3G53400	3	19798106	19800136	2030	+	0
AT3G53402	3	19798106	19800136	2030	+	0
AT3G53403	3	19800360	19800695	335	-	9
AT3G53410	3	19800950	19802328	1378	-	159
AT3G53420	3	19803654	19805713	2059	-	39679
AT3G53430	3	19809686	19810469	783	-	4233
AT3G53440	3	19810787	19812670	1883	+	89
AT3G53450	3	19812976	19815430	2454	-	4
AT3G53460	3	19819184	19821519	2335	-	4353
AT3G53470	3	19822725	19823493	768	+	1293
AT3G53480	3	19825306	19831797	6491	+	33
AT3G53490	3	19832471	19834073	1602	+	81
AT3G53500	3	19834342	19837088	2746	-	1548
AT3G53510	3	19837208	19839862	2654	-	157
AT3G53520	3	19841373	19844308	2935	+	854
AT3G53530	3	19845096	19846820	1724	+	105
AT3G53540	3	19846646	19850968	4322	-	756
AT3G53550	3	19856869	19858308	1439	+	0
AT3G53560	3	19859626	19861031	1405	-	1218
AT3G53570	3	19861178	19864588	3410	-	562
AT3G53580	3	19864756	19867134	2378	+	2032
AT3G53590	3	19867378	19871651	4273	-	1
AT3G53600	3	19875531	19876059	528	+	0
AT3G53610	3	19876231	19878519	2288	-	701
AT3G53611	3	19878541	19878694	153	+	1
AT3G53620	3	19880503	19883672	3169	+	438
AT3G53630	3	19883878	19885904	2026	+	321
AT3G53640	3	19887006	19888935	1929	-	1
AT3G53650	3	19889357	19889774	417	+	129
AT3G53668	3	19890420	19892404	1984	+	0
AT3G53670	3	19890363	19892443	2080	+	0
AT3G53680	3	19892862	19897412	4550	-	286
AT3G53690	3	19898787	19900065	1278	-	6
AT3G53700	3	19900279	19902884	2605	+	756
AT3G53710	3	19903312	19905489	2177	-	1011
AT3G53720	3	19905677	19910112	4435	-	631
AT3G53730	3	19912493	19913033	540	-	1274
AT3G53740	3	19913706	19915016	1310	-	2850
AT3G53750	3	19915287	19917641	2354	+	1025
AT3G53760	3	19917853	19922365	4512	-	194
AT3G53770	3	19923303	19924113	810	+	0
AT3G53775	3	19924376	19924448	72	+	0
AT3G53780	3	19924567	19927026	2459	-	341
AT3G53790	3	19928477	19930267	1790	+	0
AT3G53800	3	19930860	19932892	2032	+	535
AT3G53810	3	19932991	19935234	2243	-	151
AT3G53820	3	19938705	19939134	429	+	0
AT3G53830	3	19940813	19943799	2986	+	885
AT3G53840	3	19945570	19947719	2149	+	8
AT3G53850	3	19948130	19949288	1158	-	282
AT3G53860	3	19949561	19951290	1729	-	67
AT3G53870	3	19951487	19952961	1474	+	4065
AT3G53880	3	19953172	19955290	2118	+	147
AT3G53890	3	19955343	19956361	1018	-	2416
AT3G53900	3	19956655	19959041	2386	-	1040
AT3G53910	3	19959855	19960446	591	-	0
AT3G53920	3	19960868	19963949	3081	-	1513
AT3G53930	3	19966351	19970813	4462	+	296
AT3G53940	3	19971018	19973769	2751	-	90
AT3G53950	3	19975618	19977439	1821	+	224
AT3G53960	3	19978121	19980959	2838	-	354
AT3G53965	3	19984940	19985011	71	+	0
AT3G53970	3	19985138	19987339	2201	+	664
AT3G53980	3	19987578	19988269	691	-	81
AT3G53990	3	19989336	19991134	1798	-	914
AT3G54000	3	19996606	19998623	2017	+	61
AT3G54010	3	20000860	20005183	4323	+	982
AT3G54020	3	20005732	20008254	2522	+	172
AT3G54030	3	20010926	20013693	2767	+	344
AT3G54040	3	20013760	20015437	1677	-	25
AT3G54050	3	20016891	20018822	1931	+	29846
AT3G54060	3	20018655	20020926	2271	-	20
AT3G54070	3	20021329	20023603	2274	-	0
AT3G54080	3	20025266	20027022	1756	+	444
AT3G54085	3	20026580	20027991	1411	-	13
AT3G54090	3	20028123	20029986	1863	+	708
AT3G54100	3	20034070	20037953	3883	-	191
AT3G54110	3	20038679	20041210	2531	+	1029
AT3G54120	3	20041125	20042340	1215	-	58
AT3G54130	3	20042704	20044526	1822	-	164
AT3G54140	3	20045662	20048572	2910	-	1037
AT3G54150	3	20050643	20052815	2172	-	7
AT3G54160	3	20053467	20055027	1560	+	20
AT3G54170	3	20056704	20059522	2818	+	394
AT3G54180	3	20059795	20061438	1643	+	129
AT3G54190	3	20061527	20064154	2627	-	1057
AT3G54200	3	20065664	20066560	896	+	112
AT3G54210	3	20067539	20068435	896	-	10251
AT3G54220	3	20070157	20072780	2623	+	708
AT3G54230	3	20073101	20080384	7283	+	1198
AT3G54240	3	20080925	20082145	1220	+	0
AT3G54250	3	20082298	20084732	2434	-	229
AT3G54260	3	20085009	20086763	1754	-	216
AT3G54270	3	20087081	20089846	2765	-	56
AT3G54280	3	20091975	20104257	12282	+	2194
AT3G54290	3	20104398	20106044	1646	-	454
AT3G54300	3	20108207	20110683	2476	-	583
AT3G54310	3	20111152	20112944	1792	-	6
AT3G54320	3	20114683	20118639	3956	+	118
AT3G54340	3	20119172	20121170	1998	-	0
AT3G54350	3	20122082	20126872	4790	-	683
AT3G54360	3	20128304	20131854	3550	-	2953
AT3G54363	3	20132238	20132535	297	-	22
AT3G54366	3	20132885	20133750	865	+	331
AT3G54380	3	20133892	20137007	3115	-	283
AT3G54390	3	20137740	20139142	1402	-	402
AT3G54400	3	20140057	20142642	2585	-	1576
AT3G54410	3	20144550	20145489	939	+	0
AT3G54420	3	20145909	20147063	1154	+	88
AT3G54430	3	20147100	20148127	1027	-	167
AT3G54440	3	20148291	20157138	8847	-	2318
AT3G54450	3	20158533	20162005	3472	+	1
AT3G54460	3	20161941	20167293	5352	-	1470
AT3G54470	3	20168094	20170303	2209	-	1289
AT3G54480	3	20170684	20173416	2732	-	610
AT3G54490	3	20173618	20175462	1844	+	0
AT3G54500	3	20175369	20179027	3658	-	15890
AT3G54510	3	20180291	20183509	3218	+	23
AT3G54520	3	20183559	20185200	1641	-	0
AT3G54530	3	20185965	20187637	1672	-	0
AT3G54540	3	20189804	20192792	2988	+	1478
AT3G54550	3	20193626	20194663	1037	-	1
AT3G54560	3	20196265	20197650	1385	+	640
AT3G54570	3	20197948	20199202	1254	-	0
AT3G54580	3	20200687	20203782	3095	-	0
AT3G54590	3	20206159	20208472	2313	+	1
AT3G54600	3	20210858	20213080	2222	+	3460
AT3G54610	3	20213559	20217653	4094	+	250
AT3G54620	3	20217853	20220438	2585	-	644
AT3G54625	3	20220809	20223024	2215	+	0
AT3G54630	3	20221096	20223028	1932	-	5
AT3G54640	3	20223147	20225523	2376	-	1350
AT3G54650	3	20225772	20228921	3149	-	540
AT3G54660	3	20229743	20233182	3439	-	8758
AT3G54670	3	20235482	20243960	8478	+	947
AT3G54680	3	20244388	20246080	1692	+	220
AT3G54690	3	20246538	20248140	1602	+	732
AT3G54700	3	20248424	20250070	1646	-	0
AT3G54710	3	20251840	20254199	2359	+	121
AT3G54720	3	20254724	20257848	3124	-	966
AT3G54730	3	20259002	20260453	1451	+	2
AT3G54740	3	20262390	20264601	2211	+	195
AT3G54750	3	20264633	20268881	4248	-	468
AT3G54760	3	20269079	20272457	3378	-	1500
AT3G54770	3	20273715	20275898	2183	-	1
AT3G54780	3	20278876	20281551	2675	+	88
AT3G54790	3	20281534	20285126	3592	-	490
AT3G54800	3	20286083	20290077	3994	+	0
AT3G54802	3	20291589	20291742	153	-	0
AT3G54804	3	20293146	20293251	105	-	0
AT3G54810	3	20296231	20298691	2460	+	704
AT3G54820	3	20302020	20304010	1990	+	403
AT3G54823	3	20305299	20309796	4497	-	4
AT3G54826	3	20310326	20311821	1495	+	553
AT3G54830	3	20311900	20315030	3130	-	372
AT3G54840	3	20318411	20321001	2590	+	829
AT3G54850	3	20321421	20324020	2599	+	253
AT3G54860	3	20324089	20329917	5828	-	507
AT3G54870	3	20330805	20336717	5912	+	16
AT3G54880	3	20336855	20338522	1667	-	215
AT3G54890	3	20339503	20341103	1600	-	211519
AT3G54900	3	20341587	20342393	806	-	3401
AT3G54910	3	20342755	20344806	2051	-	295
AT3G54920	3	20345081	20348582	3501	+	982
AT3G54925	3	20349434	20349980	546	-	0
AT3G54930	3	20350838	20352948	2110	-	142
AT3G54940	3	20354350	20356318	1968	+	0
AT3G54950	3	20358895	20361233	2338	-	209
AT3G54960	3	20363309	20366840	3531	-	403
AT3G54970	3	20368167	20370098	1931	-	168
AT3G54980	3	20370233	20373069	2836	+	126
AT3G54990	3	20373717	20376522	2805	-	35
AT3G55000	3	20381507	20383789	2282	+	403
AT3G55005	3	20383955	20386382	2427	+	303
AT3G55010	3	20386618	20388806	2188	+	604
AT3G55020	3	20388868	20394911	6043	-	1605
AT3G55030	3	20396759	20398653	1894	+	313
AT3G55040	3	20398537	20400346	1809	-	2299
AT3G55050	3	20400487	20402595	2108	-	349
AT3G55060	3	20402983	20407046	4063	-	86
AT3G55070	3	20408285	20411140	2855	+	668
AT3G55080	3	20411398	20415934	4536	-	455
AT3G55090	3	20416341	20418552	2211	-	86
AT3G55100	3	20420289	20422340	2051	-	0
AT3G55110	3	20424549	20427377	2828	-	248
AT3G55120	3	20430113	20431470	1357	-	550
AT3G55130	3	20433877	20436390	2513	-	846
AT3G55140	3	20438771	20440429	1658	+	425
AT3G55150	3	20440549	20442604	2055	-	1
AT3G55160	3	20445411	20452400	6989	-	359
AT3G55170	3	20452909	20454342	1433	-	436
AT3G55180	3	20454902	20456682	1780	+	0
AT3G55190	3	20458006	20459890	1884	+	0
AT3G55200	3	20460532	20464556	4024	+	50
AT3G55210	3	20465214	20466240	1026	+	0
AT3G55220	3	20466920	20470944	4024	-	53
AT3G55230	3	20471790	20472889	1099	+	33
AT3G55240	3	20473540	20474763	1223	-	1743
AT3G55250	3	20479288	20480634	1346	+	2756
AT3G55252	3	20480798	20481322	524	-	0
AT3G55254	3	20482189	20482813	624	-	0
AT3G55258	3	20487980	20488469	489	-	0
AT3G55260	3	20489247	20493076	3829	+	754
AT3G55270	3	20496080	20500019	3939	+	886
AT3G55280	3	20500334	20501709	1375	+	1471
AT3G55290	3	20502611	20503797	1186	+	73
AT3G55300	3	20504035	20504901	866	-	0
AT3G55310	3	20505822	20507025	1203	+	0
AT3G55320	3	20506991	20513393	6402	-	717
AT3G55330	3	20513824	20515351	1527	-	4903
AT3G55340	3	20515646	20518059	2413	+	195
AT3G55350	3	20518390	20520875	2485	+	209
AT3G55360	3	20520929	20523014	2085	-	1416
AT3G55370	3	20527062	20529291	2229	+	105
AT3G55380	3	20531406	20533173	1767	+	335
AT3G55390	3	20534614	20535685	1071	+	39
AT3G55400	3	20535630	20539067	3437	-	1831
AT3G55410	3	20541434	20546034	4600	+	2381
AT3G55420	3	20547716	20548767	1051	+	249
AT3G55430	3	20549598	20552215	2617	-	710
AT3G55440	3	20553689	20556560	2871	+	12312
AT3G55450	3	20557898	20560212	2314	+	210
AT3G55460	3	20560807	20563762	2955	+	1192
AT3G55470	3	20564235	20566329	2094	+	142
AT3G55480	3	20566247	20571248	5001	-	1161
AT3G55485	3	20571433	20571938	505	+	2
AT3G55490	3	20572023	20573682	1659	-	44
AT3G55500	3	20574830	20576182	1352	-	216
AT3G55510	3	20578977	20582405	3428	+	205
AT3G55512	3	20587903	20588027	124	+	0
AT3G55515	3	20590922	20591162	240	+	2
AT3G55520	3	20593660	20595345	1685	+	730
AT3G55530	3	20595125	20597603	2478	-	320
AT3G55540	3	20598217	20599614	1397	+	0
AT3G55550	3	20600018	20602087	2069	-	0
AT3G55560	3	20604615	20606380	1765	-	183
AT3G55566	3	20608741	20608840	99	+	0
AT3G55570	3	20610165	20610671	506	-	0
AT3G55573	3	20611296	20611428	132	-	0
AT3G55580	3	20612699	20615920	3221	+	43
AT3G55590	3	20617048	20618881	1833	+	1
AT3G55600	3	20620442	20622470	2028	+	136
AT3G55605	3	20622619	20624002	1383	+	135
AT3G55610	3	20624019	20629093	5074	-	2681
AT3G55620	3	20634201	20636506	2305	+	1196
AT3G55630	3	20636668	20639492	2824	+	2114
AT3G55640	3	20639832	20642659	2827	+	224
AT3G55646	3	20644895	20646655	1760	+	204
AT3G55650	3	20647084	20648617	1533	+	0
AT3G55660	3	20648941	20651388	2447	-	209
AT3G55665	3	20653690	20654218	528	+	0
AT3G55670	3	20658012	20659503	1491	-	0
AT3G55672	3	20660959	20661460	501	+	0
AT3G55677	3	20663982	20664576	594	+	0
AT3G55680	3	20665684	20666315	631	-	0
AT3G55690	3	20666971	20668505	1534	+	72
AT3G55700	3	20671114	20673372	2258	+	8
AT3G55710	3	20673846	20675946	2100	+	252
AT3G55720	3	20679819	20681447	1628	+	9
AT3G55730	3	20681903	20684053	2150	-	86
AT3G55734	3	20691646	20691806	160	+	2
AT3G55735	3	20693685	20693757	72	+	0
AT3G55740	3	20695498	20698271	2773	+	342
AT3G55750	3	20698552	20700067	1515	+	1432
AT3G55760	3	20700391	20703083	2692	+	821
AT3G55770	3	20703221	20705320	2099	+	1915
AT3G55780	3	20705626	20707021	1395	+	1
AT3G55790	3	20708279	20708591	312	+	0
AT3G55795	3	20709172	20709244	72	+	0
AT3G55800	3	20709385	20711640	2255	+	50158
AT3G55810	3	20711704	20713236	1532	-	0
AT3G55820	3	20713708	20714805	1097	+	13
AT3G55830	3	20714945	20717443	2498	+	415
AT3G55840	3	20716994	20718866	1872	-	4
AT3G55850	3	20721719	20725893	4174	-	465
AT3G55860	3	20727590	20729618	2028	-	0
AT3G55870	3	20730857	20733903	3046	+	0
AT3G55880	3	20736570	20738913	2343	+	153
AT3G55890	3	20740816	20742002	1186	+	14
AT3G55900	3	20742329	20742653	324	-	1
AT3G55910	3	20742898	20743479	581	+	6
AT3G55920	3	20743442	20745083	1641	-	161
AT3G55930	3	20745381	20746964	1583	-	0
AT3G55940	3	20747786	20750184	2398	+	70
AT3G55950	3	20753690	20756395	2705	-	110
AT3G55960	3	20760456	20763033	2577	-	869
AT3G55970	3	20766734	20769324	2590	-	0
AT3G55980	3	20776294	20778842	2548	+	363
AT3G55990	3	20780314	20783233	2919	+	158
AT3G56000	3	20783317	20785796	2479	-	58
AT3G56010	3	20788669	20789924	1255	+	1975
AT3G56020	3	20790569	20791085	516	-	1014
AT3G56030	3	20791248	20792532	1284	+	26
AT3G56040	3	20792476	20797572	5096	-	3719
AT3G56050	3	20797954	20801165	3211	-	2827
AT3G56060	3	20803132	20806013	2881	-	592
AT3G56070	3	20806748	20808152	1404	-	502
AT3G56080	3	20810308	20813036	2728	-	1392
AT3G56085	3	20813516	20813589	73	-	0
AT3G56090	3	20814046	20816035	1989	-	791
AT3G56100	3	20816930	20819517	2587	-	102
AT3G56110	3	20820252	20823030	2778	-	434
AT3G56120	3	20823145	20826543	3398	+	392
AT3G56130	3	20826657	20829270	2613	+	1138
AT3G56140	3	20829281	20832871	3590	+	2225
AT3G56150	3	20833578	20837160	3582	-	4368
AT3G56160	3	20837443	20841541	4098	-	2503
AT3G56170	3	20842144	20844476	2332	+	211
AT3G56180	3	20844666	20845692	1026	+	0
AT3G56190	3	20845673	20848534	2861	-	1790
AT3G56200	3	20850028	20852027	1999	+	270
AT3G56210	3	20852384	20855610	3226	-	441
AT3G56220	3	20858917	20860531	1614	+	97
AT3G56230	3	20860777	20862265	1488	-	17
AT3G56240	3	20863256	20864544	1288	-	7274
AT3G56250	3	20866119	20867840	1721	+	37
AT3G56260	3	20867969	20869024	1055	-	102
AT3G56270	3	20869999	20872049	2050	+	228
AT3G56275	3	20872830	20873472	642	+	19
AT3G56277	3	20874307	20874656	349	-	0
AT3G56280	3	20876566	20877445	879	+	0
AT3G56290	3	20878538	20879568	1030	-	2859
AT3G56300	3	20880168	20882366	2198	+	143
AT3G56310	3	20882802	20885915	3113	+	1274
AT3G56320	3	20885893	20889656	3763	-	141
AT3G56330	3	20890249	20892002	1753	+	155
AT3G56340	3	20892128	20893443	1315	-	2394
AT3G56350	3	20893945	20895625	1680	-	0
AT3G56360	3	20896480	20897593	1113	+	1495
AT3G56370	3	20899098	20902981	3883	-	2172
AT3G56380	3	20905479	20906368	889	+	0
AT3G56390	3	20907353	20907697	344	+	0
AT3G56400	3	20908927	20910481	1554	-	838
AT3G56408	3	20915496	20921340	5844	+	15
AT3G56410	3	20916171	20921338	5167	-	260
AT3G56420	3	20922139	20923234	1095	-	0
AT3G56430	3	20923599	20925809	2210	-	293
AT3G56440	3	20926000	20928988	2988	+	111
AT3G56450	3	20930556	20932869	2313	+	110
AT3G56460	3	20932790	20934540	1750	-	1373
AT3G56470	3	20934814	20936436	1622	+	34
AT3G56480	3	20936097	20939631	3534	-	561
AT3G56490	3	20941501	20943469	1968	+	816
AT3G56500	3	20943637	20943970	333	+	2
AT3G56510	3	20943927	20946661	2734	-	367
AT3G56520	3	20947106	20947731	625	-	0
AT3G56530	3	20948910	20950045	1135	-	0
AT3G56540	3	20950822	20951892	1070	+	1
AT3G56550	3	20952291	20954641	2350	-	12
AT3G56560	3	20955403	20956867	1464	+	0
AT3G56570	3	20958659	20961137	2478	+	52
AT3G56580	3	20961550	20963749	2199	+	522
AT3G56590	3	20964856	20968019	3163	+	787
AT3G56600	3	20968443	20970913	2470	+	7
AT3G56610	3	20971585	20972084	499	-	0
AT3G56620	3	20972502	20974611	2109	-	57
AT3G56630	3	20978936	20980632	1696	+	678
AT3G56640	3	20981380	20984336	2956	+	258
AT3G56650	3	20984751	20986131	1380	+	1699
AT3G56660	3	20986216	20988213	1997	-	4
AT3G56670	3	20989034	20989995	961	-	0
AT3G56680	3	20991279	20993677	2398	+	1090
AT3G56690	3	20993692	20998695	5003	-	254
AT3G56700	3	20999730	21002058	2328	-	1
AT3G56705	3	21004258	21004809	551	+	3
AT3G56710	3	21006749	21007565	816	-	109
AT3G56720	3	21011010	21013490	2480	+	454
AT3G56730	3	21013990	21015078	1088	+	20
AT3G56740	3	21015370	21018157	2787	+	277
AT3G56750	3	21018088	21020431	2343	-	514
AT3G56760	3	21020557	21023756	3199	-	497
AT3G56770	3	21029201	21030618	1417	-	9
AT3G56780	3	21031612	21033202	1590	+	5
AT3G56790	3	21033834	21034455	621	-	1
AT3G56800	3	21034536	21036077	1541	-	3207
AT3G56810	3	21036759	21038947	2188	-	282
AT3G56820	3	21039802	21041760	1958	-	99
AT3G56825	3	21041726	21042609	883	-	4
AT3G56830	3	21042429	21044318	1889	-	158
AT3G56840	3	21044316	21046314	1998	+	370
AT3G56850	3	21046340	21048516	2176	-	368
AT3G56860	3	21048744	21052286	3542	-	2482
AT3G56870	3	21052472	21055597	3125	+	121
AT3G56880	3	21059914	21060965	1051	+	487
AT3G56890	3	21062989	21063717	728	-	9
AT3G56891	3	21064198	21064922	724	-	2
AT3G56900	3	21066123	21069483	3360	+	124
AT3G56910	3	21069410	21070356	946	-	9071
AT3G56920	3	21070647	21072702	2055	+	1
AT3G56930	3	21073420	21076314	2894	+	143
AT3G56940	3	21076504	21078443	1939	+	73469
AT3G56950	3	21078296	21079856	1560	-	362
AT3G56960	3	21080956	21083885	2929	+	106
AT3G56970	3	21084109	21085150	1041	-	1
AT3G56980	3	21086545	21087494	949	-	3
AT3G56990	3	21088256	21092061	3805	-	334
AT3G57000	3	21092267	21094297	2030	+	410
AT3G57010	3	21095653	21097451	1798	-	71
AT3G57020	3	21098314	21100360	2046	-	935
AT3G57030	3	21101456	21103293	1837	-	626
AT3G57040	3	21109613	21111432	1819	+	1012
AT3G57050	3	21111699	21114662	2963	-	2337
AT3G57060	3	21114797	21121113	6316	-	352
AT3G57062	3	21121337	21122569	1232	+	528
AT3G57070	3	21123923	21125647	1724	+	635
AT3G57072	3	21125698	21125836	138	-	0
AT3G57080	3	21125856	21127636	1780	+	317
AT3G57090	3	21128529	21130189	1660	+	751
AT3G57100	3	21133012	21134482	1470	-	2
AT3G57110	3	21134923	21135334	411	+	5
AT3G57120	3	21138904	21140610	1706	+	177
AT3G57130	3	21147557	21150027	2470	+	26
AT3G57140	3	21150421	21153596	3175	-	149
AT3G57150	3	21153972	21156009	2037	-	1127
AT3G57157	3	21157010	21157247	237	+	27
AT3G57160	3	21157609	21158816	1207	-	22
AT3G57170	3	21159406	21163184	3778	-	594
AT3G57180	3	21163544	21166138	2594	-	587
AT3G57190	3	21166402	21168376	1974	+	469
AT3G57200	3	21169264	21172316	3052	+	45
AT3G57210	3	21172826	21174172	1346	-	0
AT3G57220	3	21174454	21177119	2665	+	322
AT3G57230	3	21177422	21180932	3510	+	525
AT3G57240	3	21181741	21183075	1334	-	2
AT3G57250	3	21186718	21187251	533	+	0
AT3G57260	3	21188516	21189859	1343	-	224
AT3G57270	3	21191236	21193189	1953	-	1
AT3G57280	3	21193779	21195716	1937	+	587
AT3G57290	3	21196549	21199183	2634	-	1886
AT3G57300	3	21199487	21207885	8398	+	1963
AT3G57310	3	21208199	21208511	312	-	0
AT3G57320	3	21209956	21210863	907	+	226
AT3G57330	3	21211455	21216375	4920	-	1076
AT3G57340	3	21218972	21220485	1513	+	644
AT3G57350	3	21220386	21225305	4919	-	323
AT3G57360	3	21225539	21226692	1153	+	15
AT3G57370	3	21226838	21228475	1637	-	0
AT3G57380	3	21229801	21231729	1928	+	3
AT3G57390	3	21233700	21235911	2211	+	179
AT3G57400	3	21238432	21240228	1796	+	1502
AT3G57410	3	21243135	21251100	7965	-	1759
AT3G57420	3	21252418	21255276	2858	-	457
AT3G57430	3	21255634	21258480	2846	-	152
AT3G57440	3	21258679	21260596	1917	+	10
AT3G57450	3	21261933	21262622	689	+	212
AT3G57460	3	21263085	21265797	2712	-	24
AT3G57470	3	21269260	21276013	6753	-	1637
AT3G57480	3	21277935	21279354	1419	-	113
AT3G57490	3	21279665	21280948	1283	-	259
AT3G57500	3	21281847	21282591	744	+	29
AT3G57510	3	21283337	21285941	2604	-	0
AT3G57520	3	21288764	21293158	4394	-	875
AT3G57530	3	21296553	21299591	3038	-	770
AT3G57540	3	21301396	21303061	1665	-	186
AT3G57550	3	21306722	21309464	2742	+	569
AT3G57560	3	21310824	21312312	1488	-	685
AT3G57570	3	21312443	21320365	7922	+	593
AT3G57580	3	21320490	21322379	1889	-	72
AT3G57586	3	21322563	21329357	6794	+	9
AT3G57590	3	21330181	21331396	1215	-	93
AT3G57600	3	21332782	21333863	1081	+	59
AT3G57610	3	21334283	21336674	2391	-	2668
AT3G57620	3	21337563	21339301	1738	+	0
AT3G57630	3	21339301	21343796	4495	-	444
AT3G57640	3	21344799	21346057	1258	-	39
AT3G57645	3	21346341	21347204	863	+	0
AT3G57650	3	21349506	21353174	3668	+	875
AT3G57660	3	21353745	21362814	9069	+	536
AT3G57670	3	21370902	21373446	2544	+	29
AT3G57680	3	21381053	21383629	2576	+	229
AT3G57690	3	21384203	21384572	369	+	0
AT3G57700	3	21384916	21385939	1023	+	0
AT3G57710	3	21384675	21387399	2724	-	233
AT3G57720	3	21387721	21389726	2005	+	81
AT3G57730	3	21389963	21391562	1599	-	87
AT3G57740	3	21392670	21393744	1074	+	6
AT3G57750	3	21393978	21395288	1310	+	231
AT3G57760	3	21395592	21397244	1652	+	75
AT3G57765	3	21397261	21398132	871	-	2
AT3G57770	3	21397541	21398853	1312	+	17
AT3G57780	3	21399765	21402899	3134	-	574
AT3G57785	3	21404573	21405217	644	-	538
AT3G57790	3	21405386	21407624	2238	-	309
AT3G57800	3	21407788	21411721	3933	-	758
AT3G57810	3	21415783	21417948	2165	+	572
AT3G57820	3	21418280	21418824	544	-	0
AT3G57830	3	21419516	21422546	3030	+	285
AT3G57840	3	21422822	21423287	465	+	0
AT3G57850	3	21424376	21424791	415	+	0
AT3G57854	3	21425478	21425926	448	+	0
AT3G57860	3	21426313	21428253	1940	+	70
AT3G57870	3	21428495	21430200	1705	-	1933
AT3G57880	3	21430982	21434600	3618	-	578
AT3G57890	3	21438083	21442021	3938	+	1403
AT3G57900	3	21442280	21442574	294	-	0
AT3G57910	3	21442747	21444312	1565	+	124
AT3G57920	3	21444320	21446035	1715	-	93
AT3G57930	3	21447106	21448690	1584	-	231
AT3G57940	3	21449297	21455961	6664	+	228
AT3G57950	3	21460422	21460968	546	+	5
AT3G57958	3	21462680	21462881	201	-	0
AT3G57960	3	21463090	21464194	1104	+	0
AT3G57965	3	21464701	21466627	1926	-	87
AT3G57970	3	21465225	21466677	1452	+	55
AT3G57980	3	21466918	21469148	2230	-	293
AT3G57990	3	21470001	21471486	1485	-	1377
AT3G58000	3	21474949	21475477	528	+	23
AT3G58010	3	21475804	21477569	1765	-	819
AT3G58020	3	21479479	21481349	1870	+	203
AT3G58030	3	21484155	21487054	2899	+	781
AT3G58035	3	21487316	21487398	82	+	0
AT3G58040	3	21488515	21491488	2973	+	506
AT3G58050	3	21492538	21497157	4619	+	769
AT3G58060	3	21497777	21499676	1899	-	1
AT3G58070	3	21506612	21507654	1042	-	240
AT3G58080	3	21510305	21510562	257	-	0
AT3G58090	3	21512318	21514281	1963	-	119
AT3G58100	3	21515198	21516487	1289	-	133
AT3G58110	3	21516744	21519862	3118	+	768
AT3G58120	3	21520973	21523327	2354	-	411
AT3G58130	3	21527639	21529905	2266	+	123
AT3G58140	3	21529730	21532572	2842	-	3180
AT3G58150	3	21532812	21534089	1277	-	11
AT3G58160	3	21534796	21541877	7081	+	332
AT3G58165	3	21542281	21542352	71	+	0
AT3G58170	3	21542358	21543974	1616	-	576
AT3G58180	3	21544096	21546180	2084	+	314
AT3G58190	3	21548483	21549558	1075	-	0
AT3G58193	3	21559059	21559139	80	+	0
AT3G58196	3	21559243	21559320	77	+	1
AT3G58200	3	21559892	21561465	1573	-	44
AT3G58210	3	21562441	21564067	1626	-	0
AT3G58220	3	21564449	21566482	2033	-	437
AT3G58230	3	21566859	21567396	537	-	0
AT3G58240	3	21568529	21569827	1298	-	0
AT3G58250	3	21570744	21572143	1399	-	1
AT3G58260	3	21573753	21575369	1616	-	0
AT3G58270	3	21575886	21577845	1959	-	59
AT3G58280	3	21578511	21579767	1256	-	0
AT3G58290	3	21580571	21581861	1290	-	0
AT3G58300	3	21582763	21583390	627	-	0
AT3G58310	3	21584037	21585030	993	-	0
AT3G58320	3	21585566	21586328	762	-	0
AT3G58330	3	21587361	21588002	641	-	0
AT3G58340	3	21589070	21590401	1331	-	0
AT3G58347	3	21591187	21591388	201	-	1
AT3G58350	3	21591451	21592962	1511	-	40
AT3G58360	3	21593504	21594866	1362	-	0
AT3G58370	3	21595773	21596538	765	-	0
AT3G58380	3	21597798	21599568	1770	-	5
AT3G58390	3	21600029	21601217	1188	-	0
AT3G58400	3	21602666	21604063	1397	-	0
AT3G58410	3	21604870	21606229	1359	-	0
AT3G58420	3	21609306	21612409	3103	-	0
AT3G58430	3	21613162	21616183	3021	-	82
AT3G58440	3	21618445	21621249	2804	-	0
AT3G58450	3	21621996	21623166	1170	+	0
AT3G58460	3	21623178	21626701	3523	-	651
AT3G58470	3	21626670	21628569	1899	-	181
AT3G58480	3	21629105	21631853	2748	+	1
AT3G58490	3	21632811	21635106	2295	+	760
AT3G58500	3	21635225	21639105	3880	-	1919
AT3G58510	3	21639977	21643795	3818	+	929
AT3G58520	3	21643769	21645486	1717	-	38
AT3G58530	3	21645546	21648368	2822	+	169
AT3G58540	3	21648592	21649390	798	+	2
AT3G58550	3	21649363	21650287	924	-	11
AT3G58560	3	21650595	21654200	3605	-	1375
AT3G58570	3	21656503	21660532	4029	+	181
AT3G58580	3	21660597	21664095	3498	-	660
AT3G58590	3	21666081	21668625	2544	+	24
AT3G58600	3	21668514	21671167	2653	-	338
AT3G58610	3	21671432	21675090	3658	+	8829
AT3G58620	3	21680325	21683135	2810	+	346
AT3G58630	3	21683567	21685941	2374	-	142
AT3G58640	3	21686740	21693841	7101	-	1352
AT3G58650	3	21696245	21699998	3753	-	217
AT3G58660	3	21701533	21703114	1581	+	438
AT3G58670	3	21703389	21706079	2690	-	341
AT3G58676	3	21706818	21706938	120	-	0
AT3G58680	3	21707275	21708911	1636	+	1479
AT3G58690	3	21709169	21711381	2212	+	256
AT3G58700	3	21711562	21712955	1393	+	528
AT3G58710	3	21715006	21716916	1910	+	140
AT3G58720	3	21716865	21717948	1083	-	282
AT3G58730	3	21718256	21719980	1724	-	2739
AT3G58740	3	21720772	21723790	3018	-	0
AT3G58750	3	21724313	21727690	3377	-	603
AT3G58760	3	21728713	21731928	3215	+	400
AT3G58770	3	21732257	21735327	3070	+	26
AT3G58780	3	21738459	21742517	4058	+	5
AT3G58790	3	21742070	21746324	4254	-	243
AT3G58795	3	21745706	21746545	839	+	1
AT3G58800	3	21748227	21749928	1701	+	112
AT3G58810	3	21749965	21752008	2043	+	43
AT3G58820	3	21752532	21754615	2083	+	206
AT3G58830	3	21755052	21756641	1589	-	681
AT3G58840	3	21757311	21758772	1461	-	290
AT3G58850	3	21759351	21759942	591	-	161
AT3G58860	3	21763741	21765306	1565	-	0
AT3G58865	3	21765878	21766823	945	+	30
AT3G58877	3	21768187	21768367	180	-	0
AT3G58880	3	21768484	21770167	1683	-	0
AT3G58890	3	21771045	21772577	1532	+	0
AT3G58900	3	21772812	21774743	1931	+	230
AT3G58910	3	21775305	21776079	774	-	0
AT3G58920	3	21776292	21777988	1696	+	0
AT3G58930	3	21778209	21780433	2224	-	137
AT3G58940	3	21780784	21783663	2879	-	170
AT3G58950	3	21784115	21785840	1725	-	2
AT3G58960	3	21787145	21788807	1662	-	0
AT3G58970	3	21789331	21791359	2028	-	723
AT3G58975	3	21792141	21794029	1888	-	141
AT3G58980	3	21794444	21797006	2562	-	135
AT3G58990	3	21797057	21798303	1246	-	1945
AT3G59000	3	21799275	21801743	2468	+	131
AT3G59010	3	21802804	21805214	2410	-	382
AT3G59020	3	21810259	21817555	7296	-	1429
AT3G59030	3	21819070	21821440	2370	+	0
AT3G59040	3	21821348	21824348	3000	-	1343
AT3G59050	3	21824695	21827509	2814	-	0
AT3G59052	3	21824695	21827509	2814	-	0
AT3G59060	3	21827977	21830507	2530	-	3929
AT3G59068	3	21832342	21832701	359	+	1
AT3G59070	3	21832363	21834514	2151	-	0
AT3G59080	3	21836578	21838620	2042	+	106
AT3G59090	3	21839196	21842755	3559	+	637
AT3G59100	3	21843406	21853860	10454	+	359
AT3G59110	3	21854718	21858204	3486	+	780
AT3G59120	3	21857875	21860221	2346	-	0
AT3G59130	3	21860985	21862807	1822	-	0
AT3G59140	3	21863419	21868701	5282	-	975
AT3G59150	3	21872705	21874735	2030	+	107
AT3G59160	3	21875022	21876641	1619	+	0
AT3G59170	3	21878166	21879799	1633	+	0
AT3G59180	3	21880718	21882459	1741	+	0
AT3G59190	3	21884526	21886776	2250	+	11
AT3G59200	3	21887171	21889344	2173	+	18
AT3G59210	3	21889570	21891915	2345	+	390
AT3G59220	3	21894133	21895623	1490	+	22
AT3G59230	3	21896051	21897787	1736	-	5
AT3G59240	3	21898681	21900364	1683	-	0
AT3G59250	3	21901569	21903284	1715	-	126
AT3G59260	3	21903838	21905188	1350	+	0
AT3G59270	3	21906592	21907872	1280	-	52
AT3G59280	3	21908912	21910722	1810	-	600
AT3G59290	3	21911600	21917844	6244	+	502
AT3G59300	3	21918454	21922706	4252	+	1317
AT3G59310	3	21921745	21924415	2670	-	211
AT3G59320	3	21924516	21926886	2370	-	258
AT3G59330	3	21926960	21928499	1539	-	114
AT3G59340	3	21928763	21931570	2807	-	0
AT3G59350	3	21932524	21935192	2668	+	99
AT3G59360	3	21935278	21940250	4972	-	627
AT3G59370	3	21941864	21942571	707	-	0
AT3G59380	3	21944177	21945943	1766	+	524
AT3G59390	3	21946117	21948372	2255	+	125
AT3G59400	3	21948716	21949710	994	-	8189
AT3G59410	3	21950187	21959266	9079	+	557
AT3G59415	3	21959509	21959580	71	+	0
AT3G59420	3	21959646	21963041	3395	-	410
AT3G59430	3	21964064	21967035	2971	-	145
AT3G59440	3	21970354	21971122	768	+	4
AT3G59450	3	21972839	21974923	2084	+	4
AT3G59455	3	21976819	21977393	574	+	0
AT3G59460	3	21977512	21978323	811	+	0
AT3G59470	3	21978846	21980753	1907	-	208
AT3G59480	3	21983020	21984598	1578	+	25
AT3G59490	3	21984595	21986351	1756	-	274
AT3G59500	3	21986540	21988326	1786	+	484
AT3G59510	3	21988452	21989712	1260	-	10
AT3G59520	3	21991825	21993263	1438	+	148
AT3G59530	3	21993252	21995308	2056	+	72
AT3G59540	3	21995676	21996836	1160	-	1883
AT3G59550	3	21997053	22000678	3625	+	120
AT3G59570	3	22000831	22006056	5225	-	146
AT3G59580	3	22009050	22012791	3741	+	132
AT3G59590	3	22014166	22015768	1602	+	0
AT3G59600	3	22016384	22018100	1716	+	680
AT3G59610	3	22019552	22021308	1756	+	0
AT3G59620	3	22023461	22024700	1239	+	0
AT3G59630	3	22025073	22027868	2795	-	314
AT3G59640	3	22028773	22030445	1672	+	161
AT3G59650	3	22033128	22034157	1029	+	186
AT3G59660	3	22034170	22038658	4488	-	601
AT3G59670	3	22039475	22042713	3238	+	246
AT3G59680	3	22044003	22046040	2037	+	88
AT3G59690	3	22048753	22051673	2920	+	14
AT3G59695	3	22049729	22051595	1866	-	0
AT3G59700	3	22052132	22054275	2143	+	12
AT3G59710	3	22054936	22057156	2220	-	13
AT3G59720	3	22060004	22063902	3898	+	0
AT3G59730	3	22064307	22065879	1572	-	0
AT3G59740	3	22066986	22069058	2072	-	7
AT3G59750	3	22069854	22071821	1967	-	44
AT3G59760	3	22071947	22075416	3469	-	1152
AT3G59765	3	22076460	22078339	1879	-	87
AT3G59770	3	22079032	22086149	7117	-	1880
AT3G59780	3	22086477	22090444	3967	+	13002
AT3G59790	3	22092447	22094240	1793	+	17
AT3G59800	3	22094436	22096358	1922	-	236
AT3G59810	3	22096514	22097908	1394	+	333
AT3G59820	3	22098027	22102164	4137	-	139
AT3G59830	3	22102802	22105380	2578	-	4
AT3G59840	3	22105521	22106198	677	-	350
AT3G59845	3	22106242	22107924	1682	-	0
AT3G59850	3	22109163	22111609	2446	-	0
AT3G59860	3	22113850	22114908	1058	-	0
AT3G59870	3	22116108	22118241	2133	-	592
AT3G59880	3	22120968	22121700	732	+	20
AT3G59884	3	22122795	22122899	104	-	0
AT3G59890	3	22124197	22126630	2433	-	153
AT3G59900	3	22129725	22130464	739	+	5
AT3G59910	3	22130482	22133583	3101	-	1200
AT3G59920	3	22134998	22138457	3459	+	2681
AT3G59923	3	22138722	22138796	74	+	0
AT3G59926	3	22138846	22138918	72	-	0
AT3G59930	3	22139550	22140320	770	-	0
AT3G59940	3	22142899	22144439	1540	+	2221
AT3G59950	3	22144279	22147691	3412	-	634
AT3G59960	3	22148333	22150386	2053	+	0
AT3G59970	3	22151194	22154483	3289	+	7893
AT3G59980	3	22154243	22155641	1398	-	1013
AT3G59990	3	22155704	22158954	3250	-	1409
AT3G60000	3	22160883	22162867	1984	+	0
AT3G60010	3	22163093	22163558	465	-	0
AT3G60020	3	22164843	22165305	462	-	0
AT3G60030	3	22165653	22169572	3919	-	1771
AT3G60040	3	22175936	22179728	3792	-	60
AT3G60050	3	22180024	22181776	1752	-	131
AT3G60060	3	22182290	22183078	788	+	1
AT3G60070	3	22183242	22186329	3087	-	263
AT3G60075	3	22186834	22186916	82	-	0
AT3G60080	3	22187307	22188795	1488	+	597
AT3G60090	3	22190857	22191331	474	+	0
AT3G60100	3	22192729	22196447	3718	+	1
AT3G60110	3	22197825	22201451	3626	+	60
AT3G60120	3	22205946	22208952	3006	+	0
AT3G60130	3	22210245	22213840	3595	+	337
AT3G60140	3	22216671	22220824	4153	+	0
AT3G60150	3	22222104	22223512	1408	+	71
AT3G60160	3	22223802	22229204	5402	-	123
AT3G60164	3	22232022	22237075	5053	-	0
AT3G60170	3	22232511	22236531	4020	+	6
AT3G60176	3	22240154	22241164	1010	-	0
AT3G60180	3	22242503	22244061	1558	-	68
AT3G60190	3	22244168	22247833	3665	-	1083
AT3G60200	3	22249256	22250520	1264	+	63
AT3G60210	3	22251222	22252898	1676	-	1011
AT3G60220	3	22254597	22256086	1489	-	121
AT3G60238	3	22259084	22259844	760	-	0
AT3G60240	3	22261649	22268455	6806	+	3058
AT3G60245	3	22268745	22270006	1261	+	5048
AT3G60250	3	22270336	22272113	1777	-	718
AT3G60260	3	22273842	22277148	3306	+	205
AT3G60270	3	22278028	22278762	734	-	0
AT3G60280	3	22279663	22280675	1012	-	0
AT3G60286	3	22281740	22282248	508	-	16
AT3G60290	3	22282626	22284556	1930	+	156
AT3G60300	3	22285262	22287511	2249	+	824
AT3G60310	3	22287681	22291308	3627	+	215
AT3G60318	3	22291596	22291737	141	+	3
AT3G60320	3	22291885	22295371	3486	-	2333
AT3G60328	3	22298366	22298525	159	-	0
AT3G60330	3	22298372	22303673	5301	+	23
AT3G60340	3	22304151	22306512	2361	+	998
AT3G60350	3	22306487	22311186	4699	-	833
AT3G60360	3	22312257	22314400	2143	-	162
AT3G60370	3	22314731	22316550	1819	-	807
AT3G60380	3	22316912	22319266	2354	-	804
AT3G60390	3	22320594	22322586	1992	-	276
AT3G60400	3	22329091	22331103	2012	+	173
AT3G60410	3	22331484	22333652	2168	+	546
AT3G60420	3	22334423	22337617	3194	+	326
AT3G60440	3	22337792	22339446	1654	+	650
AT3G60450	3	22340956	22342315	1359	+	285
AT3G60460	3	22342428	22343491	1063	-	0
AT3G60470	3	22344812	22347121	2309	+	6
AT3G60480	3	22347450	22348239	789	-	201
AT3G60490	3	22349526	22350371	845	+	13
AT3G60500	3	22353882	22356625	2743	+	410
AT3G60510	3	22356951	22360147	3196	-	216
AT3G60520	3	22361529	22362579	1050	-	210
AT3G60530	3	22373214	22374387	1173	+	323
AT3G60540	3	22374962	22375865	903	-	31
AT3G60550	3	22379804	22380641	837	+	6
AT3G60560	3	22382457	22382778	321	+	0
AT3G60565	3	22383921	22389906	5985	-	0
AT3G60570	3	22391246	22392463	1217	+	0
AT3G60580	3	22393938	22395044	1106	+	40
AT3G60590	3	22398227	22399904	1677	+	415
AT3G60600	3	22400394	22402703	2309	+	1304
AT3G60610	3	22403236	22405048	1812	-	0
AT3G60613	3	22405546	22405829	283	-	0
AT3G60620	3	22406405	22408597	2192	+	733
AT3G60630	3	22410364	22412608	2244	-	761
AT3G60640	3	22415834	22417158	1324	+	126
AT3G60647	3	22419350	22419548	198	+	0
AT3G60650	3	22419950	22420274	324	+	2
AT3G60660	3	22421409	22423477	2068	+	44
AT3G60670	3	22424511	22426288	1777	-	22
AT3G60680	3	22429959	22432042	2083	+	107
AT3G60690	3	22435120	22435949	829	+	230
AT3G60700	3	22438401	22439205	804	+	5
AT3G60710	3	22440197	22441472	1275	+	3
AT3G60720	3	22441770	22443771	2001	+	74
AT3G60730	3	22444889	22447273	2384	+	0
AT3G60740	3	22447244	22453364	6120	-	506
AT3G60750	3	22453695	22457152	3457	+	59124
AT3G60760	3	22458615	22459202	587	-	0
AT3G60770	3	22460188	22461779	1591	-	3585
AT3G60780	3	22462656	22463785	1129	+	0
AT3G60790	3	22464622	22466948	2326	+	0
AT3G60800	3	22467172	22469592	2420	-	347
AT3G60805	3	22470240	22470313	73	-	0
AT3G60810	3	22470518	22471906	1388	+	515
AT3G60820	3	22471768	22473971	2203	-	2253
AT3G60830	3	22474073	22476445	2372	+	512
AT3G60840	3	22477572	22480463	2891	-	169
AT3G60850	3	22481893	22484102	2209	+	320
AT3G60860	3	22484803	22491722	6919	+	1136
AT3G60870	3	22493203	22494001	798	+	0
AT3G60880	3	22494851	22496697	1846	+	406
AT3G60890	3	22497023	22497475	452	-	13
AT3G60897	3	22498839	22498971	132	-	0
AT3G60900	3	22499359	22501239	1880	-	77
AT3G60910	3	22501697	22503372	1675	+	538
AT3G60920	3	22503327	22513031	9704	-	3
AT3G60930	3	22514026	22516871	2845	+	27
AT3G60935	3	22517149	22520275	3126	-	0
AT3G60940	3	22521445	22523700	2255	-	0
AT3G60950	3	22524474	22530306	5832	+	0
AT3G60955	3	22529642	22532476	2834	-	2
AT3G60957	3	22533782	22535556	1774	+	1
AT3G60960	3	22535705	22538635	2930	+	107
AT3G60961	3	22541318	22552529	11211	+	0
AT3G60965	3	22541490	22551393	9903	-	191
AT3G60966	3	22552619	22553668	1049	+	2
AT3G60970	3	22557534	22561716	4182	+	8
AT3G60972	3	22561915	22562576	661	-	2
AT3G60980	3	22565308	22566745	1437	-	172
AT3G60990	3	22569282	22569973	691	-	0
AT3G61010	3	22571326	22575255	3929	-	1034
AT3G61020	3	22575590	22577497	1907	+	155
AT3G61028	3	22581472	22584938	3466	-	6
AT3G61030	3	22585654	22590853	5199	+	2
AT3G61035	3	22592251	22593649	1398	-	0
AT3G61040	3	22593972	22596125	2153	-	1
AT3G61050	3	22597226	22601412	4186	+	1879
AT3G61060	3	22602909	22604582	1673	+	316
AT3G61070	3	22604093	22606878	2785	-	629
AT3G61080	3	22607129	22609099	1970	+	1436
AT3G61090	3	22609039	22609822	783	-	7
AT3G61100	3	22610436	22611321	885	-	89
AT3G61105	3	22611409	22611490	81	+	0
AT3G61110	3	22611633	22612904	1271	+	2625
AT3G61111	3	22613229	22614002	773	-	0
AT3G61113	3	22614581	22615415	834	-	30
AT3G61117	3	22616429	22616558	129	-	0
AT3G61118	3	22616580	22617427	847	-	2
AT3G61120	3	22618258	22620491	2233	-	1
AT3G61130	3	22621968	22625716	3748	+	2838
AT3G61140	3	22626261	22630117	3856	+	732
AT3G61150	3	22630607	22635123	4516	+	485
AT3G61160	3	22635880	22638817	2937	+	60
AT3G61170	3	22638690	22641237	2547	-	11
AT3G61172	3	22641763	22642110	347	-	0
AT3G61175	3	22642982	22643309	327	-	0
AT3G61177	3	22644469	22644791	322	-	0
AT3G61180	3	22645565	22647667	2102	+	870
AT3G61182	3	22647770	22648168	398	-	0
AT3G61185	3	22648832	22649205	373	-	0
AT3G61190	3	22650158	22651488	1330	-	5
AT3G61198	3	22655883	22656599	716	-	10
AT3G61200	3	22657454	22658390	936	-	634
AT3G61210	3	22658677	22659870	1193	-	1015
AT3G61220	3	22662952	22664493	1541	+	2337
AT3G61230	3	22664424	22665597	1173	-	13
AT3G61240	3	22666182	22669757	3575	+	1317
AT3G61250	3	22671001	22672738	1737	+	77
AT3G61260	3	22675237	22676788	1551	-	2398
AT3G61270	3	22678150	22680379	2229	+	1
AT3G61280	3	22680959	22683769	2810	+	136
AT3G61290	3	22684406	22686907	2501	+	0
AT3G61300	3	22687569	22690619	3050	+	0
AT3G61310	3	22690595	22692834	2239	-	657
AT3G61320	3	22693908	22695754	1846	+	423
AT3G61330	3	22695992	22700051	4059	-	0
AT3G61340	3	22701078	22702481	1403	-	1
AT3G61350	3	22702683	22704481	1798	+	95
AT3G61360	3	22704303	22706138	1835	-	91
AT3G61370	3	22706311	22708509	2198	+	90
AT3G61380	3	22708481	22711279	2798	-	259
AT3G61389	3	22716098	22716218	120	-	0
AT3G61390	3	22716352	22718373	2021	+	2
AT3G61400	3	22718955	22720397	1442	+	0
AT3G61410	3	22721005	22722673	1668	+	15
AT3G61415	3	22722709	22726424	3715	-	262
AT3G61420	3	22727039	22731954	4915	-	1228
AT3G61430	3	22733308	22735335	2027	+	8831
AT3G61440	3	22735662	22738126	2464	+	7803
AT3G61450	3	22738352	22740096	1744	+	9
AT3G61460	3	22741510	22742284	774	-	719
AT3G61470	3	22745652	22747282	1630	+	108365
AT3G61480	3	22749983	22756584	6601	+	286
AT3G61490	3	22758062	22760340	2278	+	249
AT3G61500	3	22760540	22762388	1848	-	0
AT3G61510	3	22763494	22765730	2236	-	0
AT3G61520	3	22768916	22771274	2358	-	14
AT3G61530	3	22771441	22773790	2349	-	207
AT3G61540	3	22773385	22775827	2442	+	367
AT3G61545	3	22775921	22775994	73	+	0
AT3G61550	3	22776400	22777225	825	+	268
AT3G61560	3	22777828	22780191	2363	+	186
AT3G61570	3	22779440	22783834	4394	-	243
AT3G61571	3	22784020	22784182	162	-	0
AT3G61580	3	22786046	22787972	1926	+	3278
AT3G61590	3	22791961	22794341	2380	+	253
AT3G61600	3	22795578	22798320	2742	+	1673
AT3G61610	3	22799026	22801205	2179	+	198
AT3G61620	3	22801220	22804104	2884	-	228
AT3G61630	3	22805179	22806527	1348	+	116
AT3G61640	3	22810040	22810747	707	-	218
AT3G61650	3	22812600	22815011	2411	-	242
AT3G61660	3	22816151	22816541	390	+	2
AT3G61670	3	22818588	22822020	3432	+	790
AT3G61678	3	22823242	22823476	234	-	1
AT3G61680	3	22823480	22826992	3512	+	28
AT3G61690	3	22827883	22834048	6165	+	1121
AT3G61700	3	22835206	22839089	3883	+	1161
AT3G61710	3	22839314	22842432	3118	-	588
AT3G61715	3	22842521	22842592	71	+	0
AT3G61720	3	22843010	22845398	2388	-	0
AT3G61721	3	22845745	22846569	824	+	0
AT3G61723	3	22846404	22846925	521	-	0
AT3G61730	3	22848426	22850475	2049	-	5
AT3G61740	3	22850836	22856972	6136	-	476
AT3G61750	3	22857896	22859254	1358	-	224
AT3G61755	3	22860126	22860199	73	+	0
AT3G61760	3	22860513	22864153	3640	-	23
AT3G61763	3	22864276	22864372	96	-	0
AT3G61770	3	22864542	22866407	1865	+	1042
AT3G61780	3	22867813	22871462	3649	-	504
AT3G61790	3	22871790	22873786	1996	-	389
AT3G61800	3	22874554	22876846	2292	-	186
AT3G61810	3	22877167	22878469	1302	+	44
AT3G61820	3	22879803	22881630	1827	-	1663
AT3G61825	3	22881806	22881878	72	+	0
AT3G61826	3	22886630	22886723	93	-	0
AT3G61827	3	22886841	22887027	186	-	0
AT3G61829	3	22887190	22887322	132	-	0
AT3G61830	3	22887888	22891435	3547	+	563
AT3G61840	3	22892465	22893269	804	+	24
AT3G61850	3	22895267	22897558	2291	+	103
AT3G61860	3	22900067	22902395	2328	-	713
AT3G61870	3	22902637	22904070	1433	+	11264
AT3G61880	3	22905867	22907958	2091	-	232
AT3G61890	3	22914153	22915325	1172	-	570
AT3G61897	3	22922209	22922321	112	+	1
AT3G61898	3	22922549	22922940	391	+	67
AT3G61900	3	22925812	22926379	567	+	59
AT3G61910	3	22929005	22930442	1437	-	3
AT3G61920	3	22932495	22933362	867	-	21
AT3G61930	3	22935509	22936181	672	+	0
AT3G61940	3	22937169	22938574	1405	+	3
AT3G61947	3	22939270	22939387	117	-	0
AT3G61950	3	22939545	22941451	1906	+	243
AT3G61960	3	22941771	22945288	3517	-	717
AT3G61962	3	22947107	22947233	126	-	0
AT3G61970	3	22951462	22952851	1389	+	268
AT3G61980	3	22956138	22956883	745	-	123
AT3G61990	3	22957053	22958995	1942	-	111
AT3G62000	3	22959052	22961219	2167	-	285
AT3G62010	3	22964613	22971384	6771	+	1883
AT3G62020	3	22971357	22972268	911	-	224
AT3G62030	3	22973003	22975378	2375	+	24426
AT3G62040	3	22975275	22976583	1308	-	56
AT3G62050	3	22978245	22979023	778	+	48
AT3G62060	3	22979954	22982944	2990	+	136
AT3G62070	3	22983137	22984513	1376	-	169
AT3G62080	3	22986173	22988777	2604	+	172
AT3G62090	3	22988546	22990709	2163	-	42
AT3G62097	3	22994270	22994381	111	-	0
AT3G62100	3	22995790	22996761	971	+	16
AT3G62110	3	22997030	23000041	3011	-	706
AT3G62120	3	23001029	23004321	3292	-	2721
AT3G62130	3	23004930	23007006	2076	+	513
AT3G62140	3	23007082	23008749	1667	+	267
AT3G62150	3	23008754	23013909	5155	-	108
AT3G62160	3	23014207	23015839	1632	-	70
AT3G62170	3	23016222	23018509	2287	-	0
AT3G62180	3	23019622	23020479	857	-	0
AT3G62190	3	23021039	23023332	2293	+	724
AT3G62200	3	23023436	23025732	2296	-	266
AT3G62210	3	23026608	23028306	1698	-	1
AT3G62220	3	23029099	23031155	2056	-	280
AT3G62230	3	23031530	23033128	1598	+	0
AT3G62240	3	23033441	23036765	3324	-	622
AT3G62245	3	23036879	23036952	73	+	0
AT3G62250	3	23037093	23037797	704	+	4570
AT3G62260	3	23038289	23040584	2295	-	226
AT3G62270	3	23042283	23046048	3765	-	51
AT3G62280	3	23049422	23051152	1730	-	5
AT3G62285	3	23051469	23051542	73	-	0
AT3G62290	3	23051543	23053817	2274	+	5519
AT3G62300	3	23054003	23057188	3185	+	419
AT3G62310	3	23057244	23060731	3487	-	1080
AT3G62320	3	23061804	23062398	594	-	2
AT3G62330	3	23062818	23065721	2903	-	510
AT3G62336	3	23068159	23068363	204	-	0
AT3G62340	3	23069515	23071207	1692	-	0
AT3G62350	3	23071079	23071766	687	-	0
AT3G62360	3	23072785	23080563	7778	-	1814
AT3G62370	3	23080758	23083282	2524	+	404
AT3G62380	3	23083522	23085035	1513	-	0
AT3G62390	3	23087016	23089206	2190	-	380
AT3G62400	3	23089640	23090737	1097	+	1102
AT3G62410	3	23090943	23091566	623	+	10625
AT3G62420	3	23091585	23092850	1265	-	0
AT3G62422	3	23091585	23092850	1265	-	0
AT3G62430	3	23093794	23095304	1510	-	16
AT3G62440	3	23096103	23097726	1623	-	0
AT3G62450	3	23098143	23098630	487	+	135
AT3G62455	3	23100567	23104580	4013	-	26
AT3G62460	3	23104664	23105624	960	-	136
AT3G62470	3	23106436	23108511	2075	-	73
AT3G62475	3	23109099	23110680	1581	+	0
AT3G62480	3	23111282	23111873	591	-	0
AT3G62490	3	23112499	23114999	2500	-	0
AT3G62499	3	23119843	23120149	306	+	6
AT3G62500	3	23120422	23122222	1800	+	77
AT3G62510	3	23123397	23123774	377	+	9
AT3G62520	3	23125123	23127241	2118	+	0
AT3G62528	3	23131481	23131655	174	-	1
AT3G62529	3	23131645	23131975	330	+	0
AT3G62530	3	23132137	23133298	1161	+	5534
AT3G62540	3	23133339	23135313	1974	-	25
AT3G62550	3	23135983	23137173	1190	+	364
AT3G62560	3	23137425	23139045	1620	+	709
AT3G62570	3	23142484	23144609	2125	+	28
AT3G62580	3	23146827	23147951	1124	+	1159
AT3G62590	3	23147917	23150352	2435	-	107
AT3G62600	3	23150789	23153510	2721	-	1150
AT3G62610	3	23154757	23156585	1828	+	32
AT3G62620	3	23159775	23161854	2079	+	171
AT3G62630	3	23163746	23165195	1449	-	324
AT3G62640	3	23166288	23166900	612	-	1
AT3G62650	3	23168060	23169187	1127	+	648
AT3G62660	3	23172805	23174762	1957	+	571
AT3G62670	3	23176555	23178631	2076	-	0
AT3G62680	3	23182721	23183994	1273	+	0
AT3G62690	3	23185347	23186701	1354	-	109
AT3G62700	3	23190266	23195762	5496	-	3444
AT3G62710	3	23197657	23200635	2978	-	0
AT3G62720	3	23201116	23202913	1797	+	255
AT3G62725	3	23203791	23207565	3774	-	18
AT3G62730	3	23207853	23209471	1618	-	0
AT3G62735	3	23210706	23210777	71	+	0
AT3G62740	3	23211415	23213888	2473	+	93
AT3G62750	3	23214370	23217045	2675	+	3497
AT3G62760	3	23217424	23218246	822	-	0
AT3G62770	3	23218632	23221232	2600	-	435
AT3G62780	3	23221844	23222995	1151	-	9
AT3G62790	3	23223060	23224308	1248	-	769
AT3G62800	3	23225591	23227512	1921	-	297
AT3G62810	3	23227681	23228398	717	+	383
AT3G62820	3	23229748	23230501	753	+	461
AT3G62830	3	23232302	23235567	3265	+	878
AT3G62840	3	23235489	23236816	1327	-	1174
AT3G62850	3	23237486	23239155	1669	-	0
AT3G62860	3	23239445	23242251	2806	-	94
AT3G62870	3	23242664	23244353	1689	-	4991
AT3G62880	3	23244661	23246055	1394	-	120
AT3G62890	3	23246156	23248063	1907	+	29
AT3G62900	3	23248128	23254810	6682	-	878
AT3G62907	3	23256846	23256960	114	-	1
AT3G62910	3	23257553	23260427	2874	-	1547
AT3G62920	3	23260661	23261293	632	+	56
AT3G62930	3	23261441	23261927	486	-	24
AT3G62940	3	23262864	23264731	1867	-	535
AT3G62950	3	23266248	23266934	686	+	92
AT3G62960	3	23268709	23269324	615	+	13
AT3G62970	3	23270632	23272923	2291	+	352
AT3G62980	3	23273115	23276375	3260	-	3000
AT3G62988	3	23281907	23282081	174	-	0
AT3G62990	3	23282772	23283368	596	+	4
AT3G63000	3	23283608	23285540	1932	+	699
AT3G63003	3	23285592	23285665	73	-	0
AT3G63006	3	23285753	23285826	73	-	0
AT3G63010	3	23289424	23291486	2062	+	58
AT3G63020	3	23294381	23295039	658	+	0
AT3G63030	3	23295342	23296597	1255	+	146
AT3G63040	3	23296571	23297225	654	-	0
AT3G63050	3	23297890	23298389	499	-	13
AT3G63052	3	23298910	23299111	201	-	1
AT3G63060	3	23300289	23301473	1184	-	18
AT3G63070	3	23302364	23309658	7294	+	1106
AT3G63080	3	23309736	23311386	1650	+	539
AT3G63088	3	23313052	23313199	147	+	2
AT3G63090	3	23313427	23314989	1562	+	107
AT3G63095	3	23315505	23316258	753	+	7
AT3G63110	3	23318075	23319540	1465	-	517
AT3G63120	3	23322955	23324247	1292	-	692
AT3G63130	3	23324608	23326973	2365	+	629
AT3G63140	3	23326866	23328709	1843	-	23318
AT3G63150	3	23328927	23332848	3921	-	753
AT3G63160	3	23333512	23334034	522	-	2961
AT3G63170	3	23334351	23336109	1758	+	708
AT3G63180	3	23336091	23340317	4226	-	608
AT3G63190	3	23342581	23344773	2192	-	5040
AT3G63200	3	23345901	23347564	1663	+	712
AT3G63210	3	23353614	23355160	1546	-	646
AT3G63220	3	23357391	23359238	1847	-	128
AT3G63230	3	23359632	23360338	706	+	0
AT3G63233	3	23361536	23361689	153	-	0
AT3G63240	3	23363871	23367592	3721	-	221
AT3G63250	3	23370307	23372682	2375	-	546
AT3G63260	3	23372880	23375007	2127	-	994
AT3G63270	3	23375616	23377473	1857	-	250
AT3G63280	3	23377978	23381546	3568	+	122
AT3G63290	3	23381644	23383538	1894	+	88
AT3G63300	3	23384987	23387842	2855	+	204
AT3G63310	3	23387855	23388985	1130	-	493
AT3G63320	3	23389837	23391556	1719	-	1
AT3G63340	3	23391627	23398377	6750	-	1313
AT3G63350	3	23399467	23400812	1345	+	0
AT3G63360	3	23401256	23401591	335	-	0
AT3G63370	3	23402075	23405991	3916	+	305
AT3G63375	3	23406176	23406267	91	+	8
AT3G63380	3	23406610	23410360	3750	-	65
AT3G63390	3	23411165	23411968	803	-	186
AT3G63400	3	23412023	23415659	3636	+	672
AT3G63410	3	23415588	23417119	1531	-	13667
AT3G63420	3	23417271	23418698	1427	+	247
AT3G63430	3	23420365	23422399	2034	+	51
AT3G63440	3	23424156	23426536	2380	+	208
AT3G63445	3	23422652	23426362	3710	-	72
AT3G63450	3	23426748	23429154	2406	-	291
AT3G63460	3	23430641	23437374	6733	-	3117
AT3G63470	3	23438473	23441060	2587	+	39
AT3G63480	3	23440886	23444006	3120	-	87
AT3G63490	3	23444202	23446355	2153	+	13230
AT3G63500	3	23446229	23450198	3969	-	1347
AT3G63510	3	23450535	23452794	2259	+	560
AT3G63520	3	23452910	23456078	3168	+	10094
AT3G63530	3	23456156	23458459	2303	-	265
AT3G63540	3	23459181	23459804	623	-	3590
AT3G66652	3	2083393	2087556	4163	+	145
AT3G66654	3	2087979	2090495	2516	+	589
AT3G66656	3	2091261	2091798	537	-	0
AT3G66658	3	2095104	2099151	4047	-	568
AT4G00005	4	1179	1536	357	-	0
AT4G00020	4	2894	10455	7561	-	297
AT4G00026	4	11354	13359	2005	-	304
AT4G00030	4	13526	14413	887	+	725
AT4G00040	4	14626	16079	1453	+	652
AT4G00050	4	17791	20066	2275	+	872
AT4G00060	4	21436	28871	7435	+	1052
AT4G00070	4	29670	31426	1756	-	9
AT4G00080	4	32892	33718	826	+	0
AT4G00085	4	33799	33872	73	+	0
AT4G00090	4	34090	36880	2790	+	488
AT4G00100	4	37083	38312	1229	+	3226
AT4G00110	4	38503	40189	1686	-	125
AT4G00114	4	40861	41383	522	-	0
AT4G00120	4	41664	43197	1533	-	2
AT4G00124	4	45274	45370	96	-	0
AT4G00130	4	48265	49068	803	+	0
AT4G00140	4	51165	53449	2284	-	0
AT4G00150	4	57198	59286	2088	-	524
AT4G00160	4	63409	65479	2070	+	0
AT4G00165	4	69272	69884	612	-	814
AT4G00170	4	70476	72211	1735	-	407
AT4G00180	4	72551	75384	2833	-	750
AT4G00190	4	80432	82040	1608	-	0
AT4G00200	4	82444	84694	2250	-	76
AT4G00210	4	85692	86895	1203	-	5
AT4G00220	4	90035	92237	2202	+	18
AT4G00225	4	92643	93147	504	-	0
AT4G00230	4	93922	97454	3532	+	580
AT4G00231	4	97498	99353	1855	+	201
AT4G00232	4	100256	100721	465	-	0
AT4G00234	4	100918	101788	870	+	0
AT4G00236	4	102140	103750	1610	+	0
AT4G00238	4	103822	105217	1395	-	261
AT4G00240	4	106379	110718	4339	-	81
AT4G00250	4	112704	113966	1262	-	4
AT4G00260	4	114970	117051	2081	+	0
AT4G00270	4	117151	118577	1426	-	474
AT4G00280	4	122408	122851	443	-	0
AT4G00290	4	122850	125591	2741	-	342
AT4G00300	4	126508	130399	3891	+	662
AT4G00305	4	131549	131930	381	+	3
AT4G00310	4	133642	135469	1827	+	74
AT4G00315	4	137403	138888	1485	+	0
AT4G00320	4	139938	141643	1705	+	0
AT4G00330	4	142600	144523	1923	-	639
AT4G00335	4	145903	148339	2436	+	188
AT4G00340	4	148813	151686	2873	+	911
AT4G00342	4	151732	151912	180	-	0
AT4G00350	4	151918	154130	2212	+	1
AT4G00355	4	154704	156376	1672	+	887
AT4G00356	4	156573	156729	156	-	0
AT4G00360	4	160767	163023	2256	+	3670
AT4G00370	4	162896	166357	3461	-	3631
AT4G00380	4	167958	170974	3016	+	144
AT4G00390	4	171496	172843	1347	-	5
AT4G00400	4	174061	176853	2792	-	947
AT4G00413	4	178038	178161	123	-	0
AT4G00416	4	179021	179513	492	+	0
AT4G00420	4	181322	184387	3065	-	350
AT4G00430	4	185449	187627	2178	-	6094
AT4G00440	4	193878	198579	4701	+	963
AT4G00450	4	202415	211003	8588	+	1215
AT4G00460	4	211080	213697	2617	-	46
AT4G00467	4	214845	216076	1231	-	0
AT4G00480	4	216811	219743	2932	-	209
AT4G00490	4	222319	225131	2812	+	1555
AT4G00500	4	225027	227396	2369	-	284
AT4G00520	4	227693	231699	4006	+	480
AT4G00525	4	231779	232939	1160	+	32
AT4G00530	4	232927	233645	718	-	70
AT4G00540	4	234596	237582	2986	-	0
AT4G00550	4	237966	240500	2534	-	324
AT4G00560	4	240659	242379	1720	-	384
AT4G00570	4	242514	246771	4257	-	1869
AT4G00580	4	248712	250258	1546	+	1
AT4G00585	4	250954	252598	1644	-	1007
AT4G00590	4	252765	255054	2289	+	100
AT4G00600	4	255319	256610	1291	-	0
AT4G00610	4	256956	257943	987	-	0
AT4G00620	4	259027	261019	1992	-	253
AT4G00630	4	261448	268050	6602	-	2013
AT4G00650	4	269025	271503	2478	+	165
AT4G00651	4	271486	271879	393	-	3
AT4G00660	4	274256	278737	4481	+	867
AT4G00670	4	278315	279186	871	-	13
AT4G00680	4	279595	280699	1104	-	7
AT4G00690	4	281312	283129	1817	+	29
AT4G00695	4	283913	285975	2062	+	7
AT4G00700	4	286050	289514	3464	+	34
AT4G00710	4	290047	293453	3406	+	1427
AT4G00720	4	293640	297314	3674	-	1355
AT4G00730	4	299358	304508	5150	-	1488
AT4G00740	4	307430	310482	3052	-	952
AT4G00750	4	314352	317675	3323	+	790
AT4G00752	4	317563	320895	3332	-	296
AT4G00753	4	322363	323033	670	+	0
AT4G00755	4	324981	327008	2027	+	562
AT4G00760	4	327024	333477	6453	-	488
AT4G00770	4	331156	333477	2321	+	3
AT4G00780	4	334731	336344	1613	+	5341
AT4G00800	4	336944	345714	8770	-	1647
AT4G00810	4	345951	347199	1248	-	1846
AT4G00820	4	349115	351550	2435	+	236
AT4G00830	4	352015	355233	3218	+	1089
AT4G00840	4	355257	357279	2022	-	181
AT4G00850	4	357550	359194	1644	+	94
AT4G00860	4	359314	360493	1179	-	1359
AT4G00870	4	362168	363691	1523	-	18
AT4G00872	4	364146	364736	590	-	1
AT4G00880	4	366372	367274	902	-	1364
AT4G00885	4	369855	369991	136	-	0
AT4G00890	4	373959	375350	1391	-	26
AT4G00891	4	377480	377908	428	-	0
AT4G00893	4	379792	381455	1663	-	3
AT4G00895	4	381787	382643	856	+	2759
AT4G00900	4	382662	386529	3867	-	642
AT4G00905	4	387864	389113	1249	+	74
AT4G00910	4	389369	391287	1918	-	3
AT4G00920	4	393766	395382	1616	+	5
AT4G00930	4	396557	400734	4177	+	210
AT4G00940	4	403319	404810	1491	-	47
AT4G00950	4	405672	407142	1470	-	207
AT4G00955	4	412117	413327	1210	+	105
AT4G00960	4	414360	416180	1820	+	24
AT4G00970	4	418436	421694	3258	+	225
AT4G00975	4	421972	423258	1286	+	6
AT4G00980	4	422477	424588	2111	-	58
AT4G00985	4	424716	424788	72	-	0
AT4G00990	4	426943	431821	4878	+	601
AT4G01000	4	431962	433849	1887	-	1236
AT4G01010	4	434568	437242	2674	-	114
AT4G01020	4	439085	445168	6083	+	221
AT4G01023	4	445843	446720	877	+	1
AT4G01026	4	447051	448511	1460	+	252
AT4G01030	4	447940	450642	2702	-	150
AT4G01037	4	451250	453243	1993	-	776
AT4G01040	4	453368	455548	2180	+	463
AT4G01050	4	455767	458510	2743	+	19189
AT4G01060	4	460471	461085	614	+	136
AT4G01070	4	461591	463556	1965	-	3173
AT4G01080	4	466390	468294	1904	-	1017
AT4G01090	4	470514	473792	3278	-	476
AT4G01100	4	477140	479936	2796	+	2388
AT4G01110	4	479962	481160	1198	-	6
AT4G01120	4	481596	484483	2887	-	319
AT4G01130	4	485832	488007	2175	+	109
AT4G01140	4	490748	492199	1451	-	5
AT4G01150	4	493547	494850	1303	+	32300
AT4G01160	4	494975	497006	2031	-	2
AT4G01170	4	499496	500831	1335	+	0
AT4G01180	4	501286	503394	2108	-	0
AT4G01190	4	504210	506131	1921	-	17
AT4G01200	4	506510	507626	1116	-	49
AT4G01210	4	507716	512782	5066	-	1143
AT4G01220	4	513212	515853	2641	-	218
AT4G01230	4	516263	517408	1145	-	4
AT4G01240	4	517794	521972	4178	-	2
AT4G01245	4	527590	528144	554	+	0
AT4G01250	4	522603	524216	1613	-	44
AT4G01260	4	528569	529547	978	-	0
AT4G01265	4	529821	531774	1953	-	0
AT4G01270	4	532350	534984	2634	+	93
AT4G01280	4	535210	537322	2112	+	413
AT4G01290	4	537989	543869	5880	-	2452
AT4G01310	4	543969	545547	1578	-	10745
AT4G01320	4	545795	549261	3466	+	901
AT4G01328	4	550232	550376	144	-	0
AT4G01330	4	550348	553016	2668	+	1140
AT4G01335	4	553392	554089	697	+	10
AT4G01340	4	554538	556961	2423	+	0
AT4G01350	4	560258	562438	2180	+	1
AT4G01355	4	562560	562634	74	-	0
AT4G01360	4	564759	566310	1551	+	24
AT4G01370	4	567094	569088	1994	+	1005
AT4G01380	4	569147	570076	929	-	41
AT4G01390	4	570241	571595	1354	-	1146
AT4G01400	4	572996	577276	4280	-	879
AT4G01410	4	578164	579169	1005	+	176
AT4G01420	4	580037	581518	1481	-	3
AT4G01430	4	585597	588029	2432	+	36
AT4G01440	4	596398	598718	2320	+	101
AT4G01450	4	608453	610724	2271	+	554
AT4G01455	4	611865	611932	67	-	0
AT4G01460	4	620758	622945	2187	+	684
AT4G01470	4	625091	625850	759	-	0
AT4G01480	4	626117	628055	1938	+	326
AT4G01490	4	631135	636899	5764	+	150
AT4G01500	4	639246	640940	1694	+	11
AT4G01505	4	641461	642214	753	+	0
AT4G01510	4	642732	644336	1604	+	142
AT4G01515	4	647691	649794	2103	-	0
AT4G01516	4	649861	649957	96	+	0
AT4G01520	4	656406	659178	2772	-	0
AT4G01525	4	660809	661698	889	+	104
AT4G01530	4	663407	665102	1695	+	0
AT4G01533	4	667147	669073	1926	-	2
AT4G01535	4	669338	669830	492	+	0
AT4G01540	4	670482	672789	2307	-	18
AT4G01550	4	673861	676411	2550	-	174
AT4G01560	4	677053	679237	2184	-	482
AT4G01570	4	679471	681940	2469	+	350
AT4G01575	4	681861	682601	740	-	20
AT4G01580	4	685745	686827	1082	+	106
AT4G01590	4	688812	690434	1622	-	611
AT4G01593	4	690709	692169	1460	+	239
AT4G01595	4	690725	691993	1268	-	1
AT4G01600	4	693180	694340	1160	+	165
AT4G01610	4	694694	697206	2512	+	1028
AT4G01630	4	700652	701527	875	+	4
AT4G01640	4	702562	703600	1038	+	0
AT4G01650	4	704406	706965	2559	-	260
AT4G01660	4	708543	711256	2713	+	367
AT4G01670	4	711191	712643	1452	-	15
AT4G01671	4	713215	713389	174	-	0
AT4G01680	4	716003	717579	1576	-	84
AT4G01690	4	729886	732433	2547	+	4673
AT4G01700	4	732312	733510	1198	-	172
AT4G01703	4	734251	734365	114	-	0
AT4G01710	4	735752	736604	852	+	138
AT4G01720	4	744920	748554	3634	+	116
AT4G01730	4	749573	752034	2461	+	153
AT4G01735	4	752287	752873	586	-	0
AT4G01740	4	753421	755456	2035	+	67
AT4G01750	4	756362	758590	2228	+	32
AT4G01760	4	759130	761134	2004	-	0
AT4G01770	4	764513	766865	2352	+	1
AT4G01780	4	767309	769246	1937	+	1
AT4G01790	4	769864	770835	971	+	39
AT4G01800	4	770721	776260	5539	-	7861
AT4G01810	4	776487	780355	3868	-	1033
AT4G01820	4	780733	785329	4596	-	7
AT4G01830	4	785682	790447	4765	-	1
AT4G01840	4	793260	795139	1879	+	223
AT4G01850	4	796096	798286	2190	-	4164
AT4G01860	4	801031	808060	7029	-	418
AT4G01865	4	808269	808342	73	-	0
AT4G01870	4	808375	810446	2071	-	106
AT4G01880	4	810698	812925	2227	-	328
AT4G01883	4	813067	815170	2103	+	1486
AT4G01890	4	816209	818428	2219	+	0
AT4G01895	4	819956	820379	423	+	6
AT4G01897	4	820335	821505	1170	-	345
AT4G01900	4	821684	823523	1839	+	1035
AT4G01910	4	824567	826685	2118	-	29
AT4G01915	4	827236	828607	1371	+	404
AT4G01920	4	828889	831200	2311	-	42
AT4G01925	4	833172	834340	1168	-	0
AT4G01930	4	838801	840760	1959	-	1
AT4G01935	4	841056	842364	1308	+	264
AT4G01940	4	841988	843459	1471	-	1373
AT4G01950	4	844408	846787	2379	-	705
AT4G01960	4	851209	853165	1956	-	358
AT4G01970	4	853921	857008	3087	-	0
AT4G01975	4	858635	862475	3840	-	10
AT4G01980	4	863350	864259	909	-	0
AT4G01985	4	866235	868126	1891	-	6
AT4G01990	4	871144	872913	1769	-	91
AT4G01995	4	873053	874772	1719	+	803
AT4G02000	4	874879	875903	1024	+	7
AT4G02005	4	876907	879741	2834	-	118
AT4G02010	4	881089	885399	4310	+	604
AT4G02020	4	886599	891955	5356	+	1069
AT4G02030	4	892175	897318	5143	+	565
AT4G02040	4	897546	898370	824	+	45
AT4G02050	4	898306	900870	2564	-	409
AT4G02055	4	901175	901247	72	+	0
AT4G02060	4	900635	905591	4956	+	699
AT4G02070	4	905865	913190	7325	+	281
AT4G02075	4	913418	916476	3058	-	183
AT4G02080	4	921453	922777	1324	+	1352
AT4G02090	4	923099	923916	817	+	2
AT4G02100	4	930064	932330	2266	+	182
AT4G02110	4	935085	940191	5106	+	267
AT4G02120	4	940777	944291	3514	+	1641
AT4G02130	4	944359	947085	2726	-	1003
AT4G02140	4	949459	951063	1604	-	6
AT4G02150	4	950610	953690	3080	-	460
AT4G02160	4	955100	955652	552	-	0
AT4G02170	4	958048	958641	593	+	0
AT4G02180	4	959963	963517	3554	+	0
AT4G02190	4	967371	969351	1980	+	0
AT4G02195	4	970006	972307	2301	-	151
AT4G02200	4	972706	974692	1986	+	237
AT4G02210	4	973923	976129	2206	-	140
AT4G02220	4	976277	979163	2886	+	258
AT4G02230	4	979169	980670	1501	-	1715
AT4G02235	4	980954	981711	757	+	0
AT4G02250	4	983969	984523	554	+	0
AT4G02260	4	985231	991494	6263	+	3228
AT4G02270	4	992174	993038	864	-	0
AT4G02280	4	994926	998967	4041	+	84
AT4G02290	4	1002393	1005253	2860	-	877
AT4G02300	4	1009365	1013034	3669	-	0
AT4G02310	4	1014679	1015729	1050	-	0
AT4G02312	4	1017842	1018394	552	-	0
AT4G02314	4	1018433	1020824	2391	+	0
AT4G02317	4	1021317	1021717	400	-	0
AT4G02320	4	1022724	1026118	3394	-	2
AT4G02325	4	1029681	1029780	99	-	0
AT4G02330	4	1032412	1035037	2625	+	85
AT4G02340	4	1035680	1037615	1935	+	697
AT4G02350	4	1038113	1040774	2661	+	639
AT4G02360	4	1041141	1041733	592	+	6
AT4G02370	4	1042337	1043206	869	+	315
AT4G02380	4	1046203	1046997	794	-	90
AT4G02390	4	1049956	1054065	4109	+	99
AT4G02400	4	1054198	1057998	3800	+	509
AT4G02405	4	1057853	1059671	1818	-	322
AT4G02410	4	1059888	1062153	2265	-	430
AT4G02420	4	1064362	1066372	2010	-	726
AT4G02425	4	1067279	1068785	1506	-	118
AT4G02430	4	1068973	1072215	3242	+	426
AT4G02440	4	1072480	1073779	1299	+	422
AT4G02450	4	1073752	1075893	2141	-	2623
AT4G02460	4	1076135	1080722	4587	-	149
AT4G02465	4	1080961	1081680	719	+	0
AT4G02480	4	1081758	1088846	7088	-	4986
AT4G02482	4	1092001	1092484	483	+	31
AT4G02485	4	1092680	1094597	1917	+	112
AT4G02487	4	1094944	1095226	282	-	0
AT4G02489	4	1097531	1097645	114	-	0
AT4G02490	4	1097944	1100011	2067	-	0
AT4G02500	4	1101506	1103610	2104	+	1662
AT4G02510	4	1104765	1109600	4835	+	5767
AT4G02520	4	1110451	1111660	1209	-	947
AT4G02530	4	1112140	1114029	1889	-	7828
AT4G02540	4	1117153	1119817	2664	+	578
AT4G02541	4	1119848	1119989	141	-	0
AT4G02550	4	1120420	1122223	1803	-	92
AT4G02555	4	1122602	1122678	76	+	1
AT4G02560	4	1123489	1128421	4932	-	593
AT4G02570	4	1128514	1133774	5260	+	2986
AT4G02580	4	1134466	1137156	2690	+	2571
AT4G02590	4	1137497	1140499	3002	-	652
AT4G02600	4	1143961	1147422	3461	+	695
AT4G02610	4	1147633	1149336	1703	+	296
AT4G02620	4	1149247	1151346	2099	-	1420
AT4G02630	4	1151612	1153356	1744	+	605
AT4G02640	4	1153996	1156320	2324	+	933
AT4G02650	4	1156452	1158653	2201	+	0
AT4G02655	4	1158847	1159422	575	+	0
AT4G02660	4	1159666	1174321	14655	-	146
AT4G02670	4	1176189	1178489	2300	-	19
AT4G02680	4	1181048	1184930	3882	-	1066
AT4G02690	4	1185750	1187816	2066	+	2
AT4G02700	4	1188982	1193611	4629	+	29
AT4G02710	4	1193515	1197630	4115	-	165
AT4G02715	4	1202169	1203380	1211	-	562
AT4G02720	4	1204302	1205866	1564	-	546
AT4G02725	4	1206003	1207436	1433	+	1050
AT4G02730	4	1207724	1209287	1563	+	60
AT4G02733	4	1210139	1211532	1393	-	0
AT4G02740	4	1217590	1220857	3267	-	309
AT4G02750	4	1221115	1223461	2346	-	40
AT4G02760	4	1223958	1228941	4983	-	102
AT4G02770	4	1229110	1229945	835	-	64973
AT4G02780	4	1237766	1244813	7047	-	18
AT4G02790	4	1247385	1249588	2203	+	1388
AT4G02800	4	1250014	1251681	1667	+	278
AT4G02810	4	1256161	1257212	1051	+	10
AT4G02820	4	1258567	1260665	2098	+	322
AT4G02830	4	1262244	1264101	1857	+	2
AT4G02840	4	1264626	1266486	1860	+	586
AT4G02850	4	1266462	1268612	2150	-	805
AT4G02860	4	1268712	1270525	1813	-	598
AT4G02870	4	1271653	1272746	1093	-	0
AT4G02871	4	1272780	1272933	153	-	0
AT4G02880	4	1274464	1278718	4254	+	426
AT4G02890	4	1278529	1280031	1502	-	5122
AT4G02900	4	1284065	1287747	3682	+	311
AT4G02910	4	1288485	1289615	1130	-	0
AT4G02920	4	1292522	1294861	2339	+	8361
AT4G02930	4	1295408	1298404	2996	-	1021
AT4G02940	4	1306502	1310946	4444	+	1208
AT4G02950	4	1311197	1312154	957	+	0
AT4G02960	4	1312546	1316983	4437	-	1
AT4G02970	4	1317498	1319179	1681	+	175
AT4G02980	4	1319655	1321477	1822	-	307
AT4G02990	4	1321858	1324004	2146	+	891
AT4G03000	4	1324107	1327520	3413	+	863
AT4G03010	4	1329951	1331139	1188	+	81
AT4G03020	4	1331398	1335297	3899	-	1437
AT4G03030	4	1335728	1337368	1640	-	659
AT4G03038	4	1340114	1341289	1175	-	9
AT4G03039	4	1340478	1340656	178	+	0
AT4G03040	4	1341082	1343140	2058	+	0
AT4G03050	4	1344181	1346501	2320	+	0
AT4G03060	4	1351979	1353854	1875	-	1000
AT4G03063	4	1355666	1356018	352	+	0
AT4G03070	4	1358431	1359698	1267	+	263
AT4G03080	4	1359654	1365475	5821	-	1671
AT4G03090	4	1366281	1371557	5276	-	383
AT4G03100	4	1374280	1376231	1951	+	322
AT4G03110	4	1376305	1379420	3115	-	1092
AT4G03113	4	1382552	1382741	189	-	0
AT4G03115	4	1382437	1385485	3048	-	195
AT4G03120	4	1385659	1387739	2080	+	241
AT4G03130	4	1387780	1390646	2866	-	15
AT4G03135	4	1390894	1390966	72	+	0
AT4G03140	4	1392120	1393842	1722	+	138
AT4G03150	4	1393613	1394574	961	-	468
AT4G03153	4	1394844	1395588	744	-	0
AT4G03156	4	1396001	1396784	783	-	0
AT4G03160	4	1397978	1398685	707	+	0
AT4G03165	4	1399377	1400291	914	-	0
AT4G03170	4	1400831	1401584	753	+	0
AT4G03175	4	1402186	1402864	678	-	0
AT4G03180	4	1403116	1404937	1821	+	243
AT4G03190	4	1404886	1407139	2253	-	561
AT4G03200	4	1408158	1412756	4598	+	1804
AT4G03205	4	1412784	1414902	2118	+	506
AT4G03210	4	1415948	1417352	1404	+	3660
AT4G03220	4	1417471	1419148	1677	+	0
AT4G03230	4	1419277	1423337	4060	-	411
AT4G03240	4	1423444	1424772	1328	-	241
AT4G03250	4	1424901	1427744	2843	+	201
AT4G03260	4	1428170	1431663	3493	+	3914
AT4G03270	4	1432374	1433691	1317	-	135
AT4G03280	4	1440145	1441863	1718	+	45721
AT4G03285	4	1442004	1442076	72	+	0
AT4G03290	4	1442633	1443499	866	+	0
AT4G03292	4	1444671	1445220	549	-	3
AT4G03295	4	1445878	1445954	76	-	2
AT4G03298	4	1446680	1447718	1038	+	1
AT4G03300	4	1447372	1456751	9379	+	0
AT4G03305	4	1457797	1458592	795	-	0
AT4G03310	4	1460158	1464144	3986	+	0
AT4G03320	4	1464466	1466165	1699	+	23
AT4G03330	4	1466335	1467750	1415	+	11
AT4G03340	4	1467726	1470080	2354	-	48
AT4G03350	4	1473717	1474509	792	-	0
AT4G03360	4	1474997	1475852	855	-	0
AT4G03364	4	1476898	1477524	626	-	0
AT4G03370	4	1478077	1478965	888	-	0
AT4G03376	4	1482627	1482853	226	-	0
AT4G03380	4	1485048	1490228	5180	-	0
AT4G03390	4	1490464	1495103	4639	-	891
AT4G03400	4	1497535	1499865	2330	-	687
AT4G03405	4	1501606	1501678	72	+	0
AT4G03410	4	1501167	1503561	2394	+	615
AT4G03415	4	1503572	1506500	2928	-	1253
AT4G03420	4	1511838	1514030	2192	+	332
AT4G03430	4	1517133	1520563	3430	-	1083
AT4G03435	4	1520783	1520856	73	-	0
AT4G03437	4	1522576	1523276	700	-	0
AT4G03438	4	1523305	1523503	198	-	0
AT4G03440	4	1524198	1527133	2935	-	89
AT4G03443	4	1527715	1528057	342	+	21
AT4G03445	4	1528133	1528370	237	-	13
AT4G03450	4	1529445	1531780	2335	-	101
AT4G03455	4	1535425	1535661	236	-	0
AT4G03460	4	1536403	1540111	3708	-	3
AT4G03470	4	1542058	1544283	2225	-	0
AT4G03480	4	1546023	1548871	2848	-	0
AT4G03490	4	1549175	1552784	3609	-	8
AT4G03500	4	1553091	1556571	3480	+	261
AT4G03505	4	1556887	1557319	432	-	4
AT4G03510	4	1557119	1559428	2309	-	141
AT4G03520	4	1562358	1564192	1834	-	7101
AT4G03530	4	1566067	1567192	1125	+	0
AT4G03540	4	1570041	1571483	1442	+	1
AT4G03550	4	1573347	1579696	6349	+	1102
AT4G03560	4	1580055	1585966	5911	+	3261
AT4G03565	4	1586746	1587734	988	+	0
AT4G03566	4	1588563	1589230	667	-	0
AT4G03570	4	1590412	1594105	3693	-	0
AT4G03580	4	1596984	1599091	2107	+	1
AT4G03590	4	1600779	1602950	2171	-	0
AT4G03600	4	1603701	1604508	807	-	37
AT4G03610	4	1604938	1606982	2044	+	18
AT4G03620	4	1607039	1608665	1626	-	1
AT4G03630	4	1608749	1610037	1288	+	0
AT4G03635	4	1611751	1612756	1005	+	112
AT4G03640	4	1614813	1618128	3315	+	0
AT4G03650	4	1619562	1624141	4579	+	0
AT4G03660	4	1625145	1625895	750	+	0
AT4G03670	4	1626628	1627737	1109	+	0
AT4G03680	4	1628884	1629936	1052	+	0
AT4G03690	4	1631726	1634900	3174	+	0
AT4G03695	4	1637774	1638582	808	-	0
AT4G03700	4	1641458	1642358	900	-	0
AT4G03710	4	1642839	1646823	3984	+	0
AT4G03720	4	1649052	1649442	390	+	0
AT4G03723	4	1649664	1650104	440	-	0
AT4G03726	4	1650716	1651979	1263	-	0
AT4G03728	4	1652241	1652976	735	-	0
AT4G03730	4	1653586	1655944	2358	-	0
AT4G03732	4	1656721	1657380	659	-	0
AT4G03740	4	1661991	1663515	1524	-	0
AT4G03745	4	1665241	1667033	1792	-	0
AT4G03750	4	1667203	1668888	1685	+	0
AT4G03760	4	1670637	1673055	2418	+	0
AT4G03770	4	1673684	1679372	5688	-	0
AT4G03775	4	1680652	1682830	2178	-	0
AT4G03780	4	1683482	1685576	2094	-	0
AT4G03790	4	1688257	1694030	5773	-	0
AT4G03795	4	1695205	1697152	1947	-	0
AT4G03800	4	1743790	1748332	4542	-	0
AT4G03810	4	1751258	1754393	3135	+	0
AT4G03811	4	1756583	1757097	514	+	13
AT4G03813	4	1761952	1763902	1950	+	6
AT4G03816	4	1764933	1769859	4926	-	20
AT4G03820	4	1771862	1774422	2560	-	129
AT4G03823	4	1779925	1780528	603	+	7
AT4G03824	4	1782461	1783625	1164	+	9
AT4G03825	4	1786547	1787183	636	+	0
AT4G03826	4	1788360	1789336	976	+	0
AT4G03827	4	1784401	1784530	129	-	0
AT4G03830	4	1790439	1792458	2019	+	0
AT4G03835	4	1793325	1795289	1964	-	0
AT4G03837	4	1795717	1796188	471	+	0
AT4G03840	4	1797475	1801473	3998	+	0
AT4G03850	4	1804745	1806300	1555	+	0
AT4G03860	4	1806587	1809637	3050	+	0
AT4G03865	4	1811322	1812054	732	+	0
AT4G03870	4	1813008	1815342	2334	+	0
AT4G03873	4	1819335	1820361	1026	+	0
AT4G03876	4	1823794	1824970	1176	-	0
AT4G03880	4	1828255	1830001	1746	-	0
AT4G03885	4	1831191	1834197	3006	-	0
AT4G03890	4	1836409	1837818	1409	+	0
AT4G03900	4	1838790	1842694	3904	+	0
AT4G03910	4	1843450	1845822	2372	+	0
AT4G03911	4	1847089	1847563	474	-	0
AT4G03912	4	1848888	1850019	1131	-	0
AT4G03913	4	1851304	1851949	645	-	0
AT4G03914	4	1850392	1850695	303	+	0
AT4G03916	4	1852258	1853094	836	+	0
AT4G03920	4	1855716	1861200	5484	+	0
AT4G03923	4	1865832	1866558	726	+	0
AT4G03926	4	1867901	1868186	285	+	0
AT4G03930	4	1870421	1872387	1966	+	5
AT4G03935	4	1869051	1874687	5636	-	171
AT4G03940	4	1873623	1875233	1610	+	13
AT4G03945	4	1877871	1878545	674	+	0
AT4G03950	4	1879517	1881111	1594	+	0
AT4G03960	4	1887527	1889211	1684	+	200
AT4G03965	4	1889472	1890412	940	+	11
AT4G03970	4	1892889	1897940	5051	+	0
AT4G03975	4	1898454	1898841	387	-	0
AT4G03976	4	1899710	1900085	375	+	0
AT4G03977	4	1900768	1901657	889	+	0
AT4G03978	4	1902618	1903563	945	+	0
AT4G03979	4	1904025	1904811	786	+	0
AT4G03980	4	1911556	1913525	1969	+	0
AT4G03981	4	1905877	1908724	2847	-	0
AT4G03990	4	1916460	1917816	1356	-	0
AT4G04000	4	1920422	1925005	4583	+	0
AT4G04010	4	1925651	1930396	4745	-	0
AT4G04020	4	1932143	1933950	1807	+	14420
AT4G04030	4	1936652	1937972	1320	-	0
AT4G04040	4	1939249	1942954	3705	+	2478
AT4G04050	4	1944377	1950431	6054	+	0
AT4G04070	4	1951541	1954608	3067	-	0
AT4G04077	4	1961138	1961892	754	+	0
AT4G04078	4	1961639	1961747	108	-	0
AT4G04080	4	1963357	1964423	1066	+	0
AT4G04090	4	1964979	1965650	671	+	0
AT4G04100	4	1966651	1967584	933	+	0
AT4G04105	4	1969058	1972381	3323	+	0
AT4G04110	4	1972590	1974014	1424	+	0
AT4G04120	4	1975543	1976947	1404	+	0
AT4G04130	4	1977182	1982785	5603	+	12
AT4G04140	4	1984438	1988845	4407	-	9
AT4G04145	4	1989667	1993894	4227	+	0
AT4G04150	4	1997561	1998900	1339	+	0
AT4G04155	4	2002063	2002492	429	+	0
AT4G04157	4	2003733	2007753	4020	+	0
AT4G04165	4	2008367	2009678	1311	-	0
AT4G04167	4	2010989	2012703	1714	+	0
AT4G04170	4	2013696	2018328	4632	+	0
AT4G04175	4	2018787	2019963	1176	+	0
AT4G04180	4	2020435	2023992	3557	+	62
AT4G04190	4	2024577	2026460	1883	+	31
AT4G04200	4	2027164	2028978	1814	+	332
AT4G04210	4	2030318	2031853	1535	+	1596
AT4G04220	4	2033426	2035946	2520	+	192
AT4G04221	4	2035158	2036370	1212	-	1
AT4G04223	4	2036510	2037816	1306	+	91
AT4G04230	4	2040380	2042855	2475	-	0
AT4G04245	4	2043904	2045173	1269	-	0
AT4G04250	4	2045956	2048347	2391	-	0
AT4G04255	4	2049354	2050227	873	-	0
AT4G04260	4	2054635	2055849	1214	+	1
AT4G04270	4	2057805	2060252	2447	-	0
AT4G04273	4	2061630	2062318	688	+	1
AT4G04276	4	2063723	2064128	405	+	0
AT4G04280	4	2064676	2068548	3872	-	0
AT4G04290	4	2068989	2071773	2784	+	0
AT4G04293	4	2076831	2077361	530	+	31
AT4G04296	4	2081828	2083240	1412	+	0
AT4G04300	4	2086199	2087758	1559	-	0
AT4G04310	4	2090167	2093991	3824	+	0
AT4G04313	4	2101582	2105974	4392	+	0
AT4G04315	4	2095258	2096518	1260	+	0
AT4G04316	4	2106460	2109688	3228	-	0
AT4G04320	4	2113403	2116693	3290	+	619
AT4G04330	4	2116552	2118597	2045	-	231
AT4G04340	4	2122684	2126844	4160	+	3596
AT4G04350	4	2128089	2133150	5061	+	2039
AT4G04360	4	2133138	2133935	797	-	63
AT4G04370	4	2134059	2136249	2190	-	229
AT4G04375	4	2136443	2137565	1122	+	0
AT4G04380	4	2138603	2142190	3587	+	0
AT4G04390	4	2142824	2147224	4400	+	0
AT4G04392	4	2148617	2150871	2254	-	0
AT4G04393	4	2152445	2154824	2379	+	0
AT4G04394	4	2157649	2158105	456	+	0
AT4G04395	4	2155287	2156535	1248	+	0
AT4G04396	4	2158456	2159002	546	-	0
AT4G04398	4	2159616	2160238	622	+	0
AT4G04400	4	2161215	2163867	2652	-	0
AT4G04402	4	2164006	2165404	1398	+	0
AT4G04404	4	2166972	2167980	1008	+	0
AT4G04405	4	2171190	2174337	3147	-	0
AT4G04407	4	2174764	2176015	1251	-	0
AT4G04408	4	2184058	2184400	342	-	2
AT4G04409	4	2184419	2184717	298	+	15
AT4G04410	4	2189514	2193763	4249	+	123
AT4G04420	4	2200350	2203377	3027	-	3
AT4G04423	4	2203423	2204264	841	+	4
AT4G04426	4	2206408	2208498	2090	+	0
AT4G04430	4	2208775	2210863	2088	-	0
AT4G04440	4	2212145	2214394	2249	+	0
AT4G04450	4	2218378	2221114	2736	+	11
AT4G04460	4	2224421	2227874	3453	+	57
AT4G04470	4	2227660	2229280	1620	-	395
AT4G04480	4	2229648	2230845	1197	+	3
AT4G04490	4	2231956	2234638	2682	-	79
AT4G04495	4	2236003	2237046	1043	-	0
AT4G04500	4	2238410	2240865	2455	+	25
AT4G04510	4	2242121	2244930	2809	+	4
AT4G04520	4	2246160	2249105	2945	+	0
AT4G04525	4	2250848	2251449	601	-	0
AT4G04530	4	2252064	2256557	4493	-	0
AT4G04540	4	2259579	2262138	2559	+	2
AT4G04545	4	2270610	2274896	4286	+	0
AT4G04547	4	2275919	2277953	2034	-	0
AT4G04550	4	2281318	2282656	1338	-	0
AT4G04560	4	2283664	2288386	4722	-	0
AT4G04570	4	2289958	2292755	2797	+	1149
AT4G04580	4	2293760	2294906	1146	-	1
AT4G04590	4	2298266	2300006	1740	+	0
AT4G04600	4	2303198	2307272	4074	+	0
AT4G04601	4	2309412	2309571	159	-	0
AT4G04610	4	2325002	2327013	2011	+	2458
AT4G04614	4	2327043	2328264	1221	-	279
AT4G04620	4	2328448	2330200	1752	-	234
AT4G04630	4	2331676	2332800	1124	-	189
AT4G04632	4	2339585	2340049	464	-	0
AT4G04635	4	2347902	2349156	1254	+	0
AT4G04640	4	2350497	2352018	1521	-	44110
AT4G04650	4	2353988	2355213	1225	-	0
AT4G04653	4	2356732	2356889	157	-	0
AT4G04655	4	2357417	2364944	7527	+	5
AT4G04660	4	2365561	2366755	1194	+	0
AT4G04670	4	2367565	2372216	4651	+	171
AT4G04680	4	2372265	2373327	1062	+	3
AT4G04690	4	2373998	2375135	1137	-	0
AT4G04692	4	2375601	2376364	763	-	1268
AT4G04693	4	2379439	2380744	1305	+	0
AT4G04695	4	2381633	2383996	2363	-	123
AT4G04700	4	2385275	2387986	2711	-	84
AT4G04710	4	2389597	2392887	3290	-	11
AT4G04720	4	2394457	2397759	3302	-	1036
AT4G04730	4	2401926	2402349	423	-	0
AT4G04740	4	2403608	2408737	5129	-	705
AT4G04745	4	2412753	2413328	575	-	4
AT4G04750	4	2417887	2422624	4737	+	702
AT4G04760	4	2424163	2427769	3606	+	31
AT4G04770	4	2427798	2429850	2052	-	5817
AT4G04775	4	2431023	2431702	679	+	0
AT4G04780	4	2432308	2433550	1242	+	202
AT4G04790	4	2434906	2439403	4497	-	93
AT4G04800	4	2439545	2441205	1660	+	355
AT4G04810	4	2441326	2442567	1241	+	43
AT4G04820	4	2443691	2444510	819	-	0
AT4G04830	4	2445793	2447086	1293	+	287
AT4G04840	4	2449559	2451589	2030	+	950
AT4G04850	4	2452663	2457767	5104	+	3636
AT4G04860	4	2459879	2461739	1860	+	333
AT4G04870	4	2461673	2464143	2470	-	213
AT4G04880	4	2464858	2467166	2308	-	419
AT4G04885	4	2471971	2475981	4010	+	633
AT4G04890	4	2476488	2482345	5857	-	2590
AT4G04900	4	2486217	2487779	1562	-	30
AT4G04910	4	2489416	2495766	6350	-	1015
AT4G04920	4	2497643	2505535	7892	+	521
AT4G04925	4	2506162	2506786	624	+	209
AT4G04930	4	2509132	2511145	2013	+	0
AT4G04940	4	2511027	2517193	6166	-	201
AT4G04950	4	2517665	2519977	2312	-	797
AT4G04953	4	2521329	2521530	201	-	0
AT4G04955	4	2522033	2525280	3247	-	856
AT4G04957	4	2526805	2527362	557	-	0
AT4G04960	4	2533055	2535386	2331	+	274
AT4G04970	4	2537038	2543131	6093	+	831
AT4G04972	4	2543463	2543971	508	+	0
AT4G04980	4	2544209	2547999	3790	-	0
AT4G04985	4	2548994	2549471	477	-	0
AT4G04990	4	2555089	2557046	1957	+	0
AT4G05000	4	2563043	2564740	1697	+	262
AT4G05010	4	2567473	2568162	689	+	57
AT4G05018	4	2571412	2572177	765	+	1
AT4G05020	4	2572620	2576595	3975	+	551
AT4G05030	4	2576789	2577974	1185	-	1
AT4G05040	4	2578645	2581798	3153	+	398
AT4G05048	4	2586977	2587104	127	-	1
AT4G05049	4	2587562	2587808	246	+	3
AT4G05050	4	2588003	2589386	1383	-	7349
AT4G05053	4	2589636	2590097	461	+	4
AT4G05060	4	2590064	2592163	2099	-	294
AT4G05070	4	2593594	2594119	525	-	460
AT4G05071	4	2594153	2594297	144	-	3
AT4G05073	4	2597657	2601681	4024	-	0
AT4G05076	4	2602083	2602563	480	-	0
AT4G05080	4	2603000	2604176	1176	+	0
AT4G05087	4	2608079	2608299	220	+	1
AT4G05090	4	2609141	2611762	2621	+	726
AT4G05091	4	2611780	2611981	201	+	0
AT4G05095	4	2613797	2614214	417	-	0
AT4G05100	4	2618453	2619887	1434	+	21
AT4G05105	4	2625949	2626056	107	+	0
AT4G05110	4	2626404	2628830	2426	-	246
AT4G05120	4	2632692	2635000	2308	-	82
AT4G05130	4	2636874	2638965	2091	-	47
AT4G05133	4	2644056	2648132	4076	-	0
AT4G05136	4	2649682	2649898	216	-	0
AT4G05140	4	2651014	2653208	2194	-	0
AT4G05145	4	2654175	2655066	891	+	0
AT4G05150	4	2660337	2662908	2571	+	1550
AT4G05160	4	2664384	2666707	2323	+	1060
AT4G05170	4	2667989	2669364	1375	-	24
AT4G05180	4	2671821	2673243	1422	-	70581
AT4G05190	4	2675100	2680214	5114	+	288
AT4G05200	4	2679722	2682309	2587	-	3
AT4G05210	4	2682866	2684899	2033	+	5
AT4G05220	4	2685103	2685784	681	-	20
AT4G05230	4	2687002	2687623	621	+	0
AT4G05240	4	2688199	2689018	819	+	0
AT4G05250	4	2691459	2692416	957	+	0
AT4G05260	4	2693679	2694459	780	+	0
AT4G05265	4	2694712	2694850	138	-	0
AT4G05270	4	2694938	2695328	390	+	0
AT4G05280	4	2697580	2703505	5925	+	0
AT4G05290	4	2704224	2704866	642	+	0
AT4G05300	4	2705669	2708158	2489	+	0
AT4G05303	4	2708985	2709934	949	-	0
AT4G05306	4	2710555	2713433	2878	-	0
AT4G05310	4	2714764	2716012	1248	+	0
AT4G05320	4	2718169	2720308	2139	+	20561
AT4G05330	4	2720560	2723125	2565	-	108
AT4G05340	4	2725689	2726065	376	+	0
AT4G05350	4	2726909	2727530	621	-	0
AT4G05360	4	2728203	2732337	4134	+	0
AT4G05370	4	2736134	2736584	450	+	1
AT4G05380	4	2737145	2737983	838	+	4
AT4G05390	4	2738530	2740667	2137	-	393
AT4G05400	4	2741159	2742949	1790	+	351
AT4G05410	4	2742931	2745627	2696	-	256
AT4G05420	4	2746120	2752943	6823	+	1546
AT4G05430	4	2753581	2754420	839	+	17
AT4G05440	4	2757213	2758275	1062	+	144
AT4G05450	4	2758652	2760912	2260	+	308
AT4G05460	4	2760880	2762445	1565	-	185
AT4G05470	4	2763255	2765351	2096	-	2
AT4G05475	4	2765961	2767957	1996	-	3
AT4G05490	4	2771043	2772252	1209	-	0
AT4G05494	4	2776206	2776365	159	-	0
AT4G05495	4	2776688	2777150	462	-	0
AT4G05497	4	2777902	2778801	899	-	7
AT4G05500	4	2780169	2782675	2506	-	0
AT4G05502	4	2783272	2785276	2004	-	0
AT4G05505	4	2785707	2787991	2284	+	0
AT4G05508	4	2789655	2789741	86	-	0
AT4G05510	4	2790192	2792321	2129	-	1
AT4G05520	4	2804450	2807929	3479	+	307
AT4G05523	4	2808053	2809025	972	-	0
AT4G05526	4	2811265	2814539	3274	+	0
AT4G05530	4	2816391	2818365	1974	+	766
AT4G05540	4	2818775	2821065	2290	-	2
AT4G05550	4	2822777	2824358	1581	+	0
AT4G05553	4	2826046	2826659	613	+	0
AT4G05556	4	2831748	2836347	4599	+	0
AT4G05560	4	2838006	2838401	395	+	0
AT4G05570	4	2839611	2840637	1026	-	0
AT4G05575	4	2844608	2845016	408	-	0
AT4G05580	4	2841647	2841998	351	+	0
AT4G05581	4	2848964	2849790	826	-	0
AT4G05582	4	2850478	2855344	4866	+	0
AT4G05583	4	2860475	2861486	1011	+	0
AT4G05584	4	2864900	2865581	681	+	0
AT4G05585	4	2867196	2876145	8949	-	1
AT4G05586	4	2878742	2884410	5668	+	0
AT4G05587	4	2886454	2888488	2034	+	0
AT4G05588	4	2890233	2891139	906	+	0
AT4G05589	4	2892289	2895196	2907	+	0
AT4G05590	4	2907064	2908557	1493	+	151
AT4G05591	4	2896375	2898502	2127	+	0
AT4G05592	4	2899553	2900899	1346	-	0
AT4G05593	4	2901387	2903415	2028	+	0
AT4G05594	4	2903652	2904114	462	-	0
AT4G05595	4	2910710	2912641	1931	-	0
AT4G05597	4	2914566	2915946	1380	-	0
AT4G05600	4	2916388	2917177	789	+	0
AT4G05610	4	2918152	2919196	1044	+	0
AT4G05612	4	2959093	2963744	4651	+	0
AT4G05613	4	2972190	2975280	3090	-	0
AT4G05616	4	2982095	2983691	1596	-	0
AT4G05620	4	2985050	2985449	399	-	0
AT4G05630	4	2988447	2988822	375	-	0
AT4G05631	4	2990005	2992618	2613	-	101
AT4G05632	4	3001663	3002411	748	+	0
AT4G05633	4	3002438	3004435	1997	-	0
AT4G05634	4	3004795	3007460	2665	-	0
AT4G05635	4	2995426	2999908	4482	+	0
AT4G05636	4	3013277	3013859	582	+	0
AT4G05638	4	3015179	3021314	6135	+	0
AT4G05640	4	3022683	3023685	1002	+	0
AT4G05918	4	3031726	3033391	1665	+	0
AT4G06196	4	3036285	3037404	1119	-	0
AT4G06474	4	3051194	3052774	1580	-	0
AT4G06477	4	3060974	3065294	4320	-	8
AT4G06479	4	3067502	3068769	1267	+	0
AT4G06480	4	3070995	3071793	798	-	0
AT4G06481	4	3076290	3078048	1758	-	0
AT4G06482	4	3079362	3082326	2964	-	0
AT4G06483	4	3085804	3087256	1452	+	0
AT4G06484	4	3087918	3088878	960	-	0
AT4G06485	4	3090239	3095924	5685	-	0
AT4G06486	4	3097049	3097784	735	-	0
AT4G06487	4	3099363	3105303	5940	+	1
AT4G06488	4	3106389	3111312	4923	-	0
AT4G06489	4	3115942	3116611	669	+	0
AT4G06490	4	3116893	3117334	441	+	0
AT4G06491	4	3117590	3123099	5509	-	0
AT4G06492	4	3127204	3128059	855	+	0
AT4G06493	4	3129014	3131234	2220	-	0
AT4G06494	4	3133151	3133586	435	-	0
AT4G06495	4	3133801	3135016	1215	+	13
AT4G06496	4	3136679	3137837	1158	+	1
AT4G06497	4	3138928	3144238	5310	-	0
AT4G06498	4	3145692	3147708	2016	+	0
AT4G06499	4	3154643	3158594	3951	-	0
AT4G06500	4	3160061	3165128	5067	+	0
AT4G06501	4	3165659	3166748	1089	-	0
AT4G06502	4	3167241	3168199	958	+	0
AT4G06503	4	3168782	3170879	2097	-	0
AT4G06504	4	3171710	3173348	1638	+	0
AT4G06505	4	3174259	3174880	621	-	0
AT4G06506	4	3176646	3182340	5694	-	0
AT4G06507	4	3183479	3184133	654	-	0
AT4G06508	4	3184178	3185642	1464	+	0
AT4G06509	4	3186650	3190088	3438	+	0
AT4G06510	4	3191799	3194253	2454	+	0
AT4G06511	4	3263285	3264419	1134	+	0
AT4G06512	4	3265496	3266252	756	-	0
AT4G06513	4	3269614	3270112	498	-	0
AT4G06514	4	3270838	3273054	2216	+	0
AT4G06515	4	3273216	3273969	753	-	0
AT4G06516	4	3276378	3279171	2793	+	0
AT4G06517	4	3280500	3282444	1944	+	0
AT4G06518	4	3285703	3287791	2088	-	0
AT4G06519	4	3288055	3289993	1938	-	0
AT4G06520	4	3291149	3291377	228	-	0
AT4G06521	4	3292568	3293600	1032	-	0
AT4G06522	4	3294500	3299084	4584	-	0
AT4G06523	4	3302312	3305957	3645	+	0
AT4G06524	4	3310413	3312940	2527	-	0
AT4G06525	4	3313835	3316544	2709	-	0
AT4G06526	4	3318301	3320945	2644	-	0
AT4G06527	4	3322815	3326895	4080	-	0
AT4G06528	4	3327078	3330294	3216	+	0
AT4G06529	4	3336338	3342143	5805	+	0
AT4G06530	4	3345853	3346456	603	-	0
AT4G06531	4	3348061	3348619	558	-	0
AT4G06532	4	3350165	3352838	2673	-	0
AT4G06533	4	3354038	3354641	603	-	0
AT4G06534	4	3356869	3358087	1218	+	117
AT4G06535	4	3359447	3360128	681	+	3
AT4G06536	4	3360745	3361255	510	+	49
AT4G06537	4	3363787	3365341	1554	+	1
AT4G06538	4	3366036	3368502	2466	-	2
AT4G06539	4	3371976	3374649	2673	-	0
AT4G06540	4	3374740	3378235	3495	+	0
AT4G06541	4	3378993	3379379	386	+	0
AT4G06542	4	3379396	3380776	1380	-	0
AT4G06543	4	3381882	3383463	1581	-	0
AT4G06544	4	3384112	3385926	1814	+	0
AT4G06545	4	3389187	3390433	1246	-	0
AT4G06546	4	3396230	3403881	7651	-	1
AT4G06547	4	3404978	3407879	2901	+	0
AT4G06548	4	3418262	3421997	3735	+	0
AT4G06549	4	3422872	3426337	3465	-	0
AT4G06550	4	3433103	3438960	5857	+	0
AT4G06551	4	3443529	3445107	1578	+	0
AT4G06552	4	3445390	3448714	3324	-	0
AT4G06553	4	3449948	3452669	2721	-	0
AT4G06554	4	3457792	3463732	5940	+	0
AT4G06555	4	3464127	3466017	1890	+	2
AT4G06556	4	3469499	3475244	5745	+	0
AT4G06557	4	3476599	3479077	2478	-	0
AT4G06558	4	3479354	3481490	2136	+	0
AT4G06559	4	3482499	3484512	2013	-	0
AT4G06560	4	3485954	3488228	2274	-	0
AT4G06561	4	3488536	3490597	2061	-	0
AT4G06562	4	3493209	3494235	1026	+	0
AT4G06563	4	3494244	3496224	1980	-	0
AT4G06564	4	3497431	3499171	1740	-	2
AT4G06565	4	3499291	3501241	1950	+	0
AT4G06566	4	3503597	3508199	4602	-	0
AT4G06567	4	3509750	3511385	1635	+	0
AT4G06568	4	3512135	3513542	1407	-	0
AT4G06569	4	3514354	3516778	2424	-	0
AT4G06570	4	3518687	3520916	2229	+	0
AT4G06571	4	3527426	3529997	2571	-	6
AT4G06572	4	3531601	3534841	3240	-	0
AT4G06573	4	3539457	3541365	1908	-	2
AT4G06574	4	3542461	3546124	3663	-	0
AT4G06575	4	3546465	3547080	615	-	0
AT4G06576	4	3547762	3549640	1878	+	0
AT4G06577	4	3550078	3550588	510	-	0
AT4G06578	4	3550655	3554459	3804	+	0
AT4G06579	4	3556014	3558993	2979	-	0
AT4G06580	4	3565562	3567242	1680	-	0
AT4G06581	4	3567340	3571708	4368	+	0
AT4G06582	4	3572989	3575539	2550	+	0
AT4G06583	4	3576111	3576681	570	+	0
AT4G06584	4	3577063	3583225	6162	-	0
AT4G06585	4	3584019	3588532	4513	-	0
AT4G06586	4	3274438	3275037	599	+	0
AT4G06587	4	3594143	3597062	2919	-	0
AT4G06588	4	3598433	3603301	4868	+	0
AT4G06589	4	3606643	3611806	5163	-	0
AT4G06590	4	3618925	3621115	2190	-	0
AT4G06591	4	3621938	3626273	4335	+	1
AT4G06592	4	3627034	3629397	2363	-	0
AT4G06593	4	3630263	3636212	5949	-	1
AT4G06594	4	3638797	3643477	4680	+	0
AT4G06595	4	3644184	3646515	2331	+	0
AT4G06596	4	3646550	3648116	1566	-	0
AT4G06597	4	3650675	3655554	4879	+	0
AT4G06598	4	3663484	3665981	2497	+	240
AT4G06599	4	3665924	3667547	1623	-	481
AT4G06600	4	3668043	3668724	681	-	0
AT4G06601	4	3674235	3675759	1524	-	0
AT4G06602	4	3678386	3681572	3186	+	0
AT4G06603	4	3682802	3685307	2505	+	0
AT4G06604	4	3685905	3691542	5637	-	0
AT4G06605	4	3691812	3697533	5721	+	0
AT4G06606	4	3698608	3700468	1860	+	0
AT4G06607	4	3701838	3703218	1380	+	0
AT4G06608	4	3705452	3709736	4284	+	0
AT4G06609	4	3710835	3716142	5307	-	0
AT4G06610	4	3716880	3717567	687	-	0
AT4G06611	4	3717672	3718425	753	-	0
AT4G06612	4	3721429	3722077	648	-	0
AT4G06613	4	3726949	3728845	1896	+	0
AT4G06614	4	3730026	3731235	1209	+	0
AT4G06615	4	3283783	3284823	1040	+	1
AT4G06616	4	3731893	3732487	594	+	0
AT4G06617	4	3301604	3302193	589	-	0
AT4G06618	4	3732863	3733313	450	+	0
AT4G06619	4	3306170	3306491	321	-	0
AT4G06620	4	3734286	3736036	1750	-	0
AT4G06621	4	3391520	3392717	1197	-	0
AT4G06622	4	3736669	3738067	1398	-	0
AT4G06623	4	3392801	3393575	774	+	0
AT4G06624	4	3739441	3741301	1860	-	0
AT4G06625	4	3603869	3604889	1020	-	0
AT4G06626	4	3742452	3748127	5675	-	0
AT4G06627	4	3604915	3606209	1294	+	0
AT4G06628	4	3749369	3753281	3912	-	0
AT4G06629	4	3614017	3614826	809	+	0
AT4G06630	4	3754365	3757659	3294	+	0
AT4G06631	4	3616618	3617357	739	-	0
AT4G06632	4	3760641	3762441	1800	-	0
AT4G06633	4	3637062	3637789	727	-	0
AT4G06634	4	3764288	3766578	2290	-	337
AT4G06635	4	3656667	3657409	742	+	0
AT4G06636	4	3776355	3779484	3129	+	0
AT4G06637	4	3526421	3526831	410	+	0
AT4G06638	4	3781707	3783723	2016	-	0
AT4G06639	4	3523430	3523937	507	-	0
AT4G06640	4	3784502	3789539	5037	+	0
AT4G06641	4	3763863	3764088	225	+	0
AT4G06642	4	3790099	3794683	4584	-	5
AT4G06644	4	3795730	3801568	5838	+	0
AT4G06646	4	3802901	3804011	1110	-	0
AT4G06648	4	3813568	3816028	2460	-	0
AT4G06650	4	3820471	3824475	4004	+	0
AT4G06652	4	3825310	3827950	2640	+	0
AT4G06654	4	3832287	3835071	2784	+	0
AT4G06656	4	3841926	3850392	8466	-	0
AT4G06658	4	3852324	3856095	3771	+	0
AT4G06660	4	3863283	3866601	3318	-	1
AT4G06664	4	3869798	3871808	2010	-	0
AT4G06666	4	3872761	3875569	2808	-	0
AT4G06668	4	3877279	3877888	609	+	0
AT4G06670	4	3881989	3888610	6621	+	0
AT4G06672	4	3888625	3889201	576	-	0
AT4G06674	4	3890183	3892550	2367	-	0
AT4G06676	4	3898864	3901990	3126	+	133
AT4G06678	4	3904317	3905304	987	-	0
AT4G06680	4	3906564	3907341	777	-	0
AT4G06682	4	3908145	3912063	3918	+	0
AT4G06684	4	3913061	3914818	1757	+	0
AT4G06686	4	3915378	3919648	4270	-	0
AT4G06688	4	3920692	3924437	3745	+	0
AT4G06692	4	3924575	3930656	6081	+	0
AT4G06694	4	3931411	3934516	3105	-	0
AT4G06696	4	3935822	3937394	1572	+	0
AT4G06697	4	3937486	3938244	758	-	0
AT4G06698	4	3945667	3948238	2571	-	0
AT4G06699	4	3942356	3945018	2662	-	0
AT4G06700	4	3949132	3950602	1470	-	0
AT4G06701	4	3939265	3940797	1532	-	103
AT4G06702	4	3957181	3958339	1158	-	0
AT4G06704	4	3959688	3961611	1923	-	0
AT4G06708	4	3962924	3965636	2712	-	0
AT4G06710	4	3988848	3989259	411	-	0
AT4G06712	4	3990944	3992813	1869	-	0
AT4G06714	4	3993730	3996211	2481	-	0
AT4G06716	4	3997491	3997755	264	-	0
AT4G06718	4	4017247	4018366	1119	-	0
AT4G06720	4	4019625	4021476	1851	-	0
AT4G06722	4	4022824	4024999	2175	-	0
AT4G06724	4	4026263	4026602	339	-	0
AT4G06726	4	4029120	4032111	2991	-	0
AT4G06728	4	4033356	4033704	348	-	0
AT4G06730	4	4034675	4035311	636	-	0
AT4G06732	4	4035314	4035704	390	+	0
AT4G06734	4	4036981	4039699	2718	+	0
AT4G06735	4	4040108	4040699	591	+	0
AT4G06736	4	4041129	4043094	1965	+	0
AT4G06738	4	4044835	4045363	528	+	0
AT4G06740	4	4045389	4045647	258	-	0
AT4G06742	4	4049902	4051750	1848	+	0
AT4G06744	4	4070812	4072305	1493	-	44
AT4G06746	4	4073961	4074545	584	-	13
AT4G06748	4	4077797	4079408	1611	+	1
AT4G06750	4	4084640	4086415	1775	-	0
AT4G06752	4	4099560	4103088	3528	-	0
AT4G07031	4	4106541	4107491	950	+	0
AT4G07310	4	4108476	4109489	1013	+	0
AT4G07315	4	4110264	4115453	5189	+	0
AT4G07320	4	4115731	4119835	4104	-	0
AT4G07324	4	4121887	4124050	2163	+	0
AT4G07327	4	4124212	4126048	1836	-	0
AT4G07330	4	4127540	4128870	1330	+	0
AT4G07331	4	4129688	4130948	1260	-	0
AT4G07332	4	4132300	4132813	513	+	0
AT4G07334	4	4135466	4139522	4056	+	1
AT4G07336	4	4142964	4143840	876	-	0
AT4G07338	4	4149074	4153817	4743	-	0
AT4G07339	4	4157879	4160875	2996	-	0
AT4G07340	4	4168180	4170645	2465	-	0
AT4G07350	4	4172608	4175227	2619	-	0
AT4G07355	4	4178490	4180361	1871	-	0
AT4G07360	4	4181460	4184183	2723	-	0
AT4G07370	4	4186040	4188335	2295	+	0
AT4G07380	4	4192428	4193016	588	-	0
AT4G07390	4	4195679	4197571	1892	+	536
AT4G07400	4	4197846	4199511	1665	-	113
AT4G07408	4	4201004	4201193	189	+	0
AT4G07410	4	4201248	4205224	3976	-	1081
AT4G07415	4	4211039	4214012	2973	-	0
AT4G07420	4	4214467	4215758	1291	+	0
AT4G07425	4	4217439	4218435	996	+	0
AT4G07430	4	4222367	4223527	1160	-	0
AT4G07435	4	4224488	4225576	1088	-	0
AT4G07440	4	4226982	4228287	1305	-	0
AT4G07450	4	4229154	4231220	2066	-	0
AT4G07452	4	4233771	4234467	696	+	0
AT4G07454	4	4235773	4238371	2598	-	0
AT4G07456	4	4240941	4243742	2801	+	0
AT4G07458	4	4244695	4246537	1842	+	0
AT4G07460	4	4257796	4259253	1457	+	0
AT4G07470	4	4263648	4264244	596	-	0
AT4G07475	4	4266731	4268259	1528	-	0
AT4G07480	4	4268924	4270173	1249	+	0
AT4G07485	4	4270746	4271691	945	-	1
AT4G07490	4	4272964	4274873	1909	-	0
AT4G07491	4	4275595	4278539	2944	-	0
AT4G07492	4	4280078	4282831	2753	+	0
AT4G07493	4	4283450	4283927	477	+	0
AT4G07494	4	4283942	4285470	1528	+	0
AT4G07495	4	4288709	4291409	2700	-	0
AT4G07496	4	4292652	4293196	544	+	0
AT4G07498	4	4296140	4297736	1596	+	0
AT4G07500	4	4300048	4301484	1436	-	0
AT4G07502	4	4301902	4305955	4053	-	0
AT4G07504	4	4306231	4307692	1461	+	0
AT4G07507	4	4309155	4310671	1516	+	279
AT4G07510	4	4312211	4313622	1411	+	0
AT4G07515	4	4314956	4315510	554	-	0
AT4G07516	4	4317039	4320951	3912	-	0
AT4G07517	4	4321374	4325195	3821	+	0
AT4G07518	4	4326226	4328921	2695	+	0
AT4G07519	4	4331914	4332673	759	+	0
AT4G07520	4	4341585	4345237	3652	-	0
AT4G07521	4	4333497	4334169	672	-	0
AT4G07522	4	4336636	4339125	2489	+	0
AT4G07523	4	4340663	4341077	414	+	0
AT4G07524	4	4345347	4345975	628	-	0
AT4G07525	4	4356678	4358128	1450	+	0
AT4G07526	4	4358651	4360161	1510	-	0
AT4G07528	4	4360352	4364382	4030	+	0
AT4G07530	4	4365349	4368615	3266	-	0
AT4G07540	4	4370204	4371976	1772	-	0
AT4G07550	4	4377638	4378351	713	+	0
AT4G07560	4	4380464	4381663	1199	-	0
AT4G07563	4	4382463	4385487	3024	-	0
AT4G07566	4	4386293	4388384	2091	+	0
AT4G07570	4	4389277	4390725	1448	+	0
AT4G07580	4	4394225	4396261	2036	+	0
AT4G07583	4	4398087	4398727	640	+	0
AT4G07586	4	4404031	4406056	2025	-	0
AT4G07590	4	4407228	4407894	666	-	0
AT4G07595	4	4407954	4408606	652	+	0
AT4G07600	4	4409775	4414629	4854	+	0
AT4G07605	4	4415058	4416131	1073	+	0
AT4G07620	4	4418649	4421820	3171	+	0
AT4G07630	4	4422654	4425460	2806	+	1
AT4G07640	4	4426898	4429920	3022	+	0
AT4G07650	4	4434718	4436197	1479	+	0
AT4G07660	4	4436760	4441587	4827	-	0
AT4G07662	4	4446860	4448549	1689	+	0
AT4G07664	4	4452121	4456483	4362	+	0
AT4G07666	4	4456701	4458842	2141	-	0
AT4G07668	4	4460312	4462897	2585	-	0
AT4G07670	4	4462910	4464347	1437	+	1
AT4G07675	4	4466012	4467147	1135	-	1
AT4G07680	4	4467981	4471439	3458	+	0
AT4G07685	4	4471937	4472525	588	-	0
AT4G07686	4	4474325	4474819	494	+	0
AT4G07688	4	4475334	4475873	539	-	0
AT4G07690	4	4476516	4477534	1018	+	0
AT4G07693	4	4478105	4479838	1733	-	0
AT4G07696	4	4482671	4483947	1276	-	0
AT4G07699	4	4484950	4485066	116	+	0
AT4G07700	4	4485091	4487763	2672	+	0
AT4G07703	4	4489425	4492749	3324	+	0
AT4G07706	4	4494937	4496399	1462	-	0
AT4G07713	4	4498042	4499935	1893	+	0
AT4G07720	4	4503022	4507072	4050	+	0
AT4G07725	4	4508057	4513286	5229	-	0
AT4G07730	4	4515507	4517193	1686	+	0
AT4G07733	4	4519267	4524469	5202	-	0
AT4G07736	4	4526939	4528888	1949	+	0
AT4G07738	4	4532889	4535493	2604	+	0
AT4G07740	4	4539637	4540682	1045	+	0
AT4G07742	4	4541188	4542994	1806	-	0
AT4G07744	4	4545729	4546360	631	-	0
AT4G07747	4	4547597	4547828	231	-	0
AT4G07750	4	4552266	4554269	2003	+	0
AT4G07755	4	4560550	4565947	5397	-	0
AT4G07760	4	4567162	4571912	4750	+	0
AT4G07770	4	4592805	4594743	1938	+	0
AT4G07780	4	4599521	4601757	2236	+	0
AT4G07786	4	4604906	4605014	108	-	0
AT4G07790	4	4606967	4609226	2259	+	0
AT4G07795	4	4611540	4612782	1242	+	0
AT4G07800	4	4615179	4617131	1952	+	0
AT4G07803	4	4618957	4619983	1026	+	0
AT4G07806	4	4623667	4627657	3990	-	0
AT4G07810	4	4627671	4633769	6098	+	1
AT4G07812	4	4634682	4635274	592	-	0
AT4G07820	4	4636763	4637450	687	-	0
AT4G07825	4	4643839	4645338	1499	+	452
AT4G07830	4	4645644	4648136	2492	-	6
AT4G07840	4	4652506	4655715	3209	-	1
AT4G07841	4	4660965	4661384	419	+	0
AT4G07843	4	4665412	4667500	2088	-	0
AT4G07846	4	4670303	4670732	429	+	0
AT4G07850	4	4671636	4675725	4089	+	0
AT4G07856	4	4679081	4682792	3711	-	0
AT4G07862	4	4688081	4688791	710	-	0
AT4G07868	4	4691761	4692653	892	+	0
AT4G07869	4	4693227	4693592	365	+	0
AT4G07874	4	4697428	4699601	2173	-	0
AT4G07890	4	4704732	4705830	1098	-	0
AT4G07893	4	4705913	4707698	1785	+	0
AT4G07896	4	4709081	4710125	1044	+	0
AT4G07915	4	4715845	4719661	3816	-	0
AT4G07917	4	4720837	4721570	733	+	0
AT4G07920	4	4723770	4726478	2708	+	0
AT4G07931	4	4727517	4729752	2235	-	0
AT4G07932	4	4732197	4733424	1227	+	0
AT4G07933	4	4734321	4735737	1416	-	0
AT4G07934	4	4738112	4741163	3051	-	0
AT4G07935	4	4742555	4748277	5722	-	0
AT4G07936	4	4757118	4757899	781	+	0
AT4G07937	4	4759072	4761628	2556	+	0
AT4G07938	4	4763259	4768709	5450	+	0
AT4G07939	4	4768784	4769447	663	+	0
AT4G07940	4	4792672	4794109	1437	+	0
AT4G07941	4	4770581	4773320	2739	+	0
AT4G07942	4	4773563	4776647	3084	+	0
AT4G07943	4	4783593	4784235	642	+	0
AT4G07944	4	4785037	4785708	671	+	0
AT4G07945	4	4788453	4790019	1566	+	0
AT4G07946	4	4751000	4751340	340	+	0
AT4G07947	4	4752022	4756955	4933	+	0
AT4G07950	4	4798043	4799795	1752	+	94
AT4G07960	4	4802340	4805647	3307	-	54
AT4G07965	4	4808634	4809352	718	+	1
AT4G07967	4	4810300	4815076	4776	+	0
AT4G07970	4	4816534	4819768	3234	+	0
AT4G07990	4	4825408	4829608	4200	-	358
AT4G08000	4	4831117	4833406	2289	+	0
AT4G08010	4	4833728	4834707	979	+	0
AT4G08013	4	4835508	4835941	433	+	0
AT4G08016	4	4837020	4838089	1069	+	0
AT4G08020	4	4838848	4841107	2259	+	0
AT4G08022	4	4845128	4845476	348	+	0
AT4G08025	4	4846797	4847379	582	+	0
AT4G08028	4	4851543	4851878	335	+	0
AT4G08030	4	4854179	4857467	3288	+	0
AT4G08032	4	4863246	4864116	870	+	0
AT4G08033	4	4876763	4877894	1131	-	0
AT4G08034	4	4878901	4879717	816	-	0
AT4G08035	4	4866553	4868343	1790	+	657
AT4G08036	4	4879722	4880031	309	+	0
AT4G08038	4	4880125	4880860	735	-	0
AT4G08039	4	4884847	4886035	1188	-	0
AT4G08040	4	4887111	4888939	1828	+	9
AT4G08050	4	4895658	4901632	5974	-	0
AT4G08053	4	4910488	4915180	4692	-	0
AT4G08054	4	4916407	4919899	3492	-	0
AT4G08056	4	4921229	4921928	699	-	0
AT4G08060	4	4924775	4928259	3484	-	0
AT4G08070	4	4928373	4931801	3428	-	0
AT4G08071	4	4933538	4934099	561	+	0
AT4G08072	4	4944666	4946775	2109	-	0
AT4G08073	4	4949562	4949745	183	+	0
AT4G08074	4	4949909	4950530	621	+	0
AT4G08076	4	4951478	4954812	3334	+	0
AT4G08078	4	4960142	4963962	3820	+	0
AT4G08080	4	4964225	4966272	2047	+	0
AT4G08090	4	4972737	4975935	3198	+	3
AT4G08091	4	4980950	4983509	2559	-	0
AT4G08092	4	4984425	4988683	4258	-	0
AT4G08093	4	4990160	4991619	1459	+	5
AT4G08094	4	4993174	4994696	1522	-	0
AT4G08095	4	4998059	5001542	3483	-	0
AT4G08096	4	5001484	5002942	1458	+	0
AT4G08097	4	5004095	5005932	1837	+	0
AT4G08098	4	5006540	5007166	626	+	0
AT4G08099	4	5008112	5010738	2626	-	0
AT4G08100	4	5079651	5083590	3939	+	40
AT4G08101	4	5011918	5013433	1515	-	0
AT4G08102	4	5015762	5016267	505	-	0
AT4G08103	4	5017420	5020336	2916	+	0
AT4G08104	4	5021328	5022048	720	-	0
AT4G08105	4	5023303	5026290	2987	-	0
AT4G08106	4	5027995	5028513	518	-	0
AT4G08107	4	5031640	5032335	695	-	0
AT4G08108	4	5039598	5043640	4042	-	0
AT4G08109	4	5049023	5054252	5229	-	14
AT4G08110	4	5083925	5086640	2715	-	461
AT4G08111	4	5055666	5057174	1508	-	0
AT4G08112	4	5060279	5063306	3027	-	13
AT4G08113	4	5064590	5067431	2841	+	1
AT4G08114	4	5068499	5073638	5139	-	0
AT4G08115	4	5075026	5077893	2867	-	57
AT4G08116	4	5020236	5020486	250	-	0
AT4G08120	4	5090576	5092797	2221	-	0
AT4G08130	4	5093872	5095316	1444	+	0
AT4G08131	4	5102539	5105519	2980	-	0
AT4G08132	4	5105688	5108302	2614	-	0
AT4G08134	4	5116242	5117919	1677	+	0
AT4G08135	4	5119767	5120317	550	-	0
AT4G08136	4	5123400	5125322	1922	+	0
AT4G08138	4	5129184	5133659	4475	-	0
AT4G08140	4	5135672	5136140	468	+	0
AT4G08145	4	5138484	5139725	1241	+	1
AT4G08150	4	5147699	5150966	3267	-	89
AT4G08151	4	5151862	5151979	117	-	0
AT4G08160	4	5159033	5162774	3741	-	98
AT4G08170	4	5163398	5167179	3781	-	287
AT4G08176	4	5168566	5168689	123	+	0
AT4G08180	4	5169483	5173662	4179	+	623
AT4G08190	4	5174522	5175476	954	-	0
AT4G08200	4	5182098	5182707	609	+	0
AT4G08210	4	5183812	5185873	2061	-	7
AT4G08220	4	5186609	5187572	963	+	166
AT4G08230	4	5187784	5189644	1860	-	329
AT4G08240	4	5194670	5196761	2091	+	205
AT4G08250	4	5196786	5198238	1452	+	20
AT4G08260	4	5200846	5201865	1019	+	0
AT4G08262	4	5204782	5210272	5490	+	0
AT4G08263	4	5211603	5212137	534	-	0
AT4G08264	4	5214178	5215615	1437	-	0
AT4G08267	4	5216853	5217697	844	+	0
AT4G08270	4	5218104	5218404	300	+	0
AT4G08275	4	5222993	5224001	1008	+	0
AT4G08280	4	5230325	5232196	1871	+	912
AT4G08290	4	5238905	5241034	2129	+	729
AT4G08300	4	5244890	5248342	3452	+	826
AT4G08310	4	5248863	5252150	3287	-	725
AT4G08320	4	5252810	5255200	2390	+	417
AT4G08330	4	5255119	5256705	1586	-	117
AT4G08333	4	5257565	5261087	3522	+	0
AT4G08336	4	5262298	5262867	569	+	0
AT4G08340	4	5264214	5271148	6934	-	0
AT4G08345	4	5268127	5268213	86	-	0
AT4G08347	4	5284797	5285580	783	+	0
AT4G08350	4	5286233	5292239	6006	+	1748
AT4G08351	4	5292393	5292579	186	-	0
AT4G08360	4	5295932	5296978	1046	+	0
AT4G08370	4	5301961	5303314	1353	-	0
AT4G08375	4	5303927	5308612	4685	-	0
AT4G08380	4	5311092	5312406	1314	-	0
AT4G08390	4	5314904	5317456	2552	+	3072
AT4G08395	4	5319633	5320712	1079	+	0
AT4G08400	4	5323799	5325341	1542	-	0
AT4G08405	4	5329392	5331457	2065	+	0
AT4G08406	4	5331768	5331909	141	-	0
AT4G08410	4	5339085	5341209	2124	-	0
AT4G08420	4	5342654	5343697	1043	-	0
AT4G08430	4	5347395	5350436	3041	-	0
AT4G08450	4	5365609	5371101	5492	+	3
AT4G08455	4	5375873	5377056	1183	+	150
AT4G08460	4	5377063	5380645	3582	-	616
AT4G08470	4	5383851	5387058	3207	-	632
AT4G08480	4	5387651	5391507	3856	-	439
AT4G08485	4	5394424	5394782	358	-	0
AT4G08490	4	5398501	5401591	3090	-	0
AT4G08500	4	5403752	5407301	3549	-	534
AT4G08510	4	5410295	5413453	3158	+	250
AT4G08520	4	5417347	5420530	3183	+	1038
AT4G08530	4	5421861	5422356	495	+	0
AT4G08540	4	5433644	5436524	2880	+	662
AT4G08550	4	5444344	5446891	2547	+	1
AT4G08555	4	5448132	5448523	391	+	6
AT4G08560	4	5450433	5453183	2750	+	0
AT4G08570	4	5454579	5456070	1491	-	55
AT4G08580	4	5461482	5463907	2425	+	203
AT4G08590	4	5463884	5466671	2787	-	93
AT4G08593	4	5469344	5470466	1122	+	0
AT4G08596	4	5475879	5477918	2039	-	0
AT4G08598	4	5480551	5482514	1963	-	0
AT4G08599	4	5483049	5483205	156	-	0
AT4G08600	4	5485734	5488998	3264	+	0
AT4G08602	4	5489258	5489974	716	-	0
AT4G08610	4	5491696	5494054	2358	-	0
AT4G08620	4	5500312	5506265	5953	+	0
AT4G08630	4	5506997	5511959	4962	-	0
AT4G08640	4	5513312	5514174	862	+	0
AT4G08645	4	5514497	5515676	1179	-	0
AT4G08650	4	5521747	5525857	4110	+	0
AT4G08652	4	5526391	5526701	310	-	0
AT4G08655	4	5528531	5529062	531	+	0
AT4G08657	4	5529762	5530302	540	-	0
AT4G08660	4	5532579	5535387	2808	-	0
AT4G08670	4	5536698	5538210	1512	-	0
AT4G08680	4	5542430	5544862	2432	-	0
AT4G08685	4	5550428	5551370	942	+	738
AT4G08690	4	5551314	5553151	1837	-	236
AT4G08691	4	5555315	5556616	1301	-	0
AT4G08692	4	5558041	5558705	664	-	0
AT4G08695	4	5565093	5565606	513	-	0
AT4G08700	4	5565852	5567458	1606	-	344
AT4G08710	4	5567741	5570572	2831	+	0
AT4G08720	4	5571074	5574725	3651	-	0
AT4G08730	4	5577389	5578779	1390	-	0
AT4G08740	4	5579033	5579745	712	+	0
AT4G08750	4	5580235	5583144	2909	-	0
AT4G08760	4	5584738	5591133	6395	-	0
AT4G08765	4	5591697	5596278	4581	+	0
AT4G08770	4	5598114	5600312	2198	-	5
AT4G08780	4	5604152	5608202	4050	+	1
AT4G08790	4	5608239	5611215	2976	-	205
AT4G08800	4	5614133	5615919	1786	+	0
AT4G08810	4	5616051	5617939	1888	-	913
AT4G08820	4	5621763	5623209	1446	+	0
AT4G08830	4	5623752	5627210	3458	+	0
AT4G08840	4	5631297	5633779	2482	+	0
AT4G08850	4	5636488	5640636	4148	-	1277
AT4G08860	4	5643951	5645045	1094	+	1
AT4G08867	4	5659814	5660903	1089	+	0
AT4G08868	4	5668606	5669047	441	+	0
AT4G08869	4	5657275	5657665	390	-	0
AT4G08870	4	5646438	5648727	2289	-	1806
AT4G08871	4	5651121	5651622	501	+	0
AT4G08872	4	5655272	5655963	691	+	0
AT4G08873	4	5663399	5664119	720	+	0
AT4G08874	4	5673275	5673710	435	-	9
AT4G08875	4	5673817	5674220	403	-	0
AT4G08876	4	5677394	5677728	334	+	0
AT4G08878	4	5683179	5684022	843	+	0
AT4G08880	4	5685010	5691313	6303	+	0
AT4G08890	4	5692637	5696994	4357	-	0
AT4G08895	4	5697895	5698615	720	+	0
AT4G08900	4	5703346	5705346	2000	+	584
AT4G08910	4	5712345	5713384	1039	+	31
AT4G08920	4	5724102	5727253	3151	+	5202
AT4G08930	4	5729191	5730850	1659	+	434
AT4G08940	4	5730796	5732195	1399	-	123
AT4G08945	4	5732667	5733069	402	+	0
AT4G08949	4	5739007	5739151	144	-	0
AT4G08950	4	5740296	5741524	1228	+	462
AT4G08953	4	5742883	5743345	462	-	0
AT4G08956	4	5743906	5744566	660	-	0
AT4G08960	4	5746288	5748285	1997	+	327
AT4G08967	4	5752017	5752128	111	-	0
AT4G08970	4	5753160	5755360	2200	-	0
AT4G08980	4	5758104	5760558	2454	+	1139
AT4G08990	4	5764780	5770496	5716	+	3
AT4G08991	4	5770769	5771335	566	-	33
AT4G08995	4	5772061	5772949	888	-	0
AT4G09000	4	5775209	5777481	2272	+	4644
AT4G09010	4	5777396	5779462	2066	-	12925
AT4G09012	4	5780469	5783464	2995	-	29
AT4G09020	4	5784073	5789002	4929	+	711
AT4G09030	4	5792206	5792790	584	+	205
AT4G09040	4	5794528	5797375	2847	-	1763
AT4G09060	4	5797658	5800330	2672	-	66
AT4G09070	4	5802307	5803392	1085	+	0
AT4G09080	4	5803810	5806355	2545	+	8
AT4G09090	4	5807219	5807710	491	-	0
AT4G09100	4	5811255	5811654	399	+	0
AT4G09110	4	5812487	5813396	909	+	0
AT4G09120	4	5813997	5815035	1038	+	0
AT4G09130	4	5815848	5816922	1074	+	0
AT4G09140	4	5816941	5821037	4096	-	229
AT4G09143	4	5821213	5822443	1230	+	0
AT4G09146	4	5822697	5827158	4461	+	0
AT4G09150	4	5828518	5833676	5158	+	1542
AT4G09153	4	5835094	5835412	318	+	0
AT4G09160	4	5839682	5842394	2712	+	511
AT4G09170	4	5842992	5843783	791	-	4
AT4G09180	4	5847400	5849724	2324	+	532
AT4G09190	4	5855175	5856327	1152	+	0
AT4G09200	4	5859256	5861803	2547	+	0
AT4G09205	4	5862108	5864769	2661	-	0
AT4G09210	4	5870288	5871160	872	+	0
AT4G09220	4	5872400	5872760	360	+	0
AT4G09230	4	5873201	5874506	1305	-	0
AT4G09250	4	5876577	5878978	2401	+	0
AT4G09255	4	5879362	5882074	2712	-	0
AT4G09260	4	5887591	5888463	872	+	0
AT4G09270	4	5889702	5890062	360	+	0
AT4G09280	4	5890495	5891808	1313	-	0
AT4G09290	4	5893343	5894969	1626	-	0
AT4G09300	4	5898797	5901014	2217	+	2
AT4G09310	4	5902825	5905372	2547	+	0
AT4G09313	4	5905646	5908853	3207	-	0
AT4G09316	4	5914031	5916593	2562	-	0
AT4G09320	4	5923399	5924532	1133	+	5964
AT4G09340	4	5924601	5927635	3034	-	517
AT4G09350	4	5931250	5932152	902	-	1299
AT4G09360	4	5940185	5943280	3095	+	1
AT4G09370	4	5943639	5946070	2431	+	0
AT4G09380	4	5946582	5950874	4292	-	0
AT4G09390	4	5951915	5952888	973	+	0
AT4G09400	4	5953225	5958057	4832	-	0
AT4G09410	4	5958512	5961076	2564	-	0
AT4G09420	4	5962180	5963791	1611	-	39
AT4G09425	4	5966130	5970177	4047	+	1
AT4G09430	4	5970931	5975375	4444	+	0
AT4G09432	4	5972923	5975071	2148	-	23
AT4G09440	4	5982214	5982748	534	-	0
AT4G09450	4	5983276	5984531	1255	+	0
AT4G09452	4	5985821	5986654	833	+	0
AT4G09455	4	5987418	5991819	4401	+	0
AT4G09460	4	5992965	5994258	1293	+	143
AT4G09462	4	5996802	5997266	464	+	0
AT4G09464	4	5999070	5999608	538	+	0
AT4G09465	4	6001350	6001761	411	+	0
AT4G09466	4	6003631	6004167	536	+	0
AT4G09467	4	6005904	6006442	538	+	0
AT4G09468	4	6007687	6007885	198	+	0
AT4G09470	4	6010996	6011446	450	-	0
AT4G09480	4	6013017	6014417	1400	+	15
AT4G09490	4	6015561	6016575	1014	-	43
AT4G09500	4	6018134	6019759	1625	+	175
AT4G09510	4	6021163	6023873	2710	-	615
AT4G09520	4	6024895	6027055	2160	-	269
AT4G09530	4	6029412	6029724	312	-	0
AT4G09540	4	6034706	6036406	1700	+	0
AT4G09545	4	6037568	6037937	369	+	0
AT4G09550	4	6039117	6040215	1098	+	195
AT4G09560	4	6041341	6043840	2499	-	196
AT4G09565	4	6046292	6047588	1296	+	0
AT4G09570	4	6049516	6052335	2819	+	395
AT4G09580	4	6052351	6054397	2046	-	349
AT4G09584	4	6059808	6061465	1657	+	0
AT4G09587	4	6062977	6063118	141	+	0
AT4G09590	4	6066127	6066763	636	+	0
AT4G09595	4	6067925	6072006	4081	+	0
AT4G09600	4	6072803	6073612	809	-	0
AT4G09610	4	6074769	6075645	876	-	0
AT4G09620	4	6076991	6079102	2111	-	973
AT4G09625	4	6079878	6082242	2364	-	0
AT4G09630	4	6083712	6088134	4422	+	636
AT4G09640	4	6088212	6090888	2676	-	207
AT4G09644	4	6093609	6094887	1278	-	0
AT4G09647	4	6096724	6097988	1264	-	0
AT4G09649	4	6100560	6100698	138	-	4
AT4G09650	4	6100742	6101708	966	+	41397
AT4G09660	4	6104445	6106607	2162	+	0
AT4G09670	4	6107149	6109122	1973	-	1310
AT4G09680	4	6116754	6123304	6550	+	891
AT4G09690	4	6124896	6126120	1224	+	0
AT4G09700	4	6126774	6127890	1116	+	0
AT4G09710	4	6128687	6132598	3911	+	0
AT4G09720	4	6132836	6135200	2364	+	871
AT4G09730	4	6136248	6139711	3463	+	1102
AT4G09731	4	6139716	6139851	135	+	0
AT4G09740	4	6142705	6145003	2298	-	0
AT4G09745	4	6145986	6146574	588	-	0
AT4G09750	4	6146689	6148814	2125	+	544
AT4G09760	4	6148757	6151399	2642	-	1537
AT4G09770	4	6154258	6155912	1654	-	0
AT4G09775	4	6156628	6157054	426	+	0
AT4G09780	4	6159537	6161378	1841	-	0
AT4G09784	4	6162252	6162613	361	+	0
AT4G09790	4	6163413	6164655	1242	-	0
AT4G09795	4	6169634	6170015	381	+	0
AT4G09800	4	6173714	6175200	1486	+	2946
AT4G09810	4	6175175	6177293	2118	-	194
AT4G09820	4	6182022	6186493	4471	+	54
AT4G09830	4	6188766	6190853	2087	+	733
AT4G09840	4	6190787	6191664	877	-	10
AT4G09850	4	6192511	6193130	619	+	0
AT4G09860	4	6194708	6195301	593	-	0
AT4G09870	4	6200088	6201215	1127	+	0
AT4G09875	4	6209725	6212148	2423	-	1
AT4G09880	4	6214623	6215338	715	+	0
AT4G09890	4	6218395	6218927	532	+	603
AT4G09900	4	6221663	6224134	2471	-	960
AT4G09920	4	6224690	6225905	1215	+	27
AT4G09930	4	6228555	6230079	1524	+	0
AT4G09940	4	6231785	6233397	1612	+	0
AT4G09950	4	6234761	6236312	1551	+	114
AT4G09960	4	6236374	6240932	4558	-	4
AT4G09965	4	6244739	6245686	947	-	0
AT4G09970	4	6245960	6247768	1808	+	132
AT4G09980	4	6247734	6252288	4554	-	595
AT4G09984	4	6254427	6255482	1055	-	0
AT4G09987	4	6257230	6258160	930	-	0
AT4G09990	4	6258879	6260073	1194	-	28
AT4G10000	4	6260309	6263181	2872	-	587
AT4G10010	4	6263596	6266245	2649	-	0
AT4G10020	4	6268288	6270434	2146	+	1
AT4G10030	4	6270240	6273241	3001	-	609
AT4G10040	4	6276997	6278509	1512	+	800
AT4G10050	4	6284449	6287293	2844	-	318
AT4G10060	4	6288826	6295402	6576	+	4220
AT4G10070	4	6295607	6299836	4229	-	294
AT4G10080	4	6300057	6302654	2597	-	1503
AT4G10090	4	6305367	6307518	2151	+	167
AT4G10100	4	6308682	6309546	864	+	362
AT4G10110	4	6309392	6310869	1477	-	181
AT4G10112	4	6311476	6311581	105	-	0
AT4G10115	4	6312103	6312557	454	-	0
AT4G10120	4	6314786	6319936	5150	+	6117
AT4G10130	4	6320633	6321643	1010	-	96
AT4G10140	4	6322456	6324664	2208	+	189
AT4G10150	4	6328135	6329589	1454	+	57
AT4G10160	4	6336022	6337332	1310	+	3
AT4G10170	4	6344330	6345537	1207	+	227
AT4G10180	4	6346462	6349276	2814	+	1220
AT4G10190	4	6350927	6352031	1104	+	0
AT4G10200	4	6353171	6355591	2420	+	2
AT4G10201	4	6355738	6368550	12812	+	0
AT4G10210	4	6357051	6360377	3326	+	0
AT4G10220	4	6362188	6365079	2891	+	0
AT4G10230	4	6366260	6367185	925	+	0
AT4G10240	4	6368935	6369526	591	-	0
AT4G10250	4	6370342	6371291	949	+	0
AT4G10260	4	6371376	6372770	1394	-	1
AT4G10265	4	6373096	6373536	440	-	1
AT4G10270	4	6374733	6375210	477	+	31
AT4G10280	4	6375124	6376111	987	-	128
AT4G10290	4	6379700	6381739	2039	-	0
AT4G10300	4	6384461	6386189	1728	+	2642
AT4G10310	4	6391983	6395877	3894	+	71
AT4G10320	4	6397329	6404596	7267	-	2712
AT4G10330	4	6406540	6407777	1237	+	302
AT4G10340	4	6408015	6409677	1662	+	209724
AT4G10345	4	6413009	6413342	333	+	0
AT4G10350	4	6415255	6416829	1574	-	0
AT4G10360	4	6420454	6422380	1926	+	785
AT4G10370	4	6423576	6425661	2085	-	0
AT4G10380	4	6431235	6434822	3587	-	380
AT4G10390	4	6441672	6443435	1763	-	41
AT4G10400	4	6446208	6448136	1928	-	161
AT4G10410	4	6448982	6449998	1016	-	3
AT4G10414	4	6451316	6452716	1400	-	0
AT4G10420	4	6453084	6454209	1125	-	36
AT4G10430	4	6454702	6458089	3387	-	838
AT4G10440	4	6459727	6461932	2205	-	2
AT4G10450	4	6462952	6464544	1592	-	674
AT4G10457	4	6466899	6467270	371	-	0
AT4G10460	4	6468165	6472263	4098	+	0
AT4G10465	4	6473546	6475434	1888	+	0
AT4G10470	4	6476013	6477883	1870	+	419
AT4G10480	4	6477875	6479165	1290	-	3201
AT4G10490	4	6483866	6485360	1494	+	0
AT4G10500	4	6491016	6492476	1460	+	13
AT4G10507	4	6494706	6495211	505	+	0
AT4G10510	4	6495954	6499010	3056	+	0
AT4G10520	4	6499793	6502866	3073	+	0
AT4G10530	4	6508599	6511670	3071	+	0
AT4G10540	4	6512514	6515743	3229	-	0
AT4G10550	4	6516491	6520317	3826	-	158
AT4G10560	4	6520770	6522882	2112	-	6
AT4G10570	4	6523254	6528173	4919	-	293
AT4G10580	4	6531381	6535751	4370	-	3
AT4G10590	4	6538540	6543448	4908	-	408
AT4G10595	4	6545339	6546401	1062	+	0
AT4G10596	4	6546696	6546795	99	-	0
AT4G10600	4	6547785	6548864	1079	-	47
AT4G10603	4	6550977	6551834	857	+	0
AT4G10610	4	6557176	6559595	2419	+	1087
AT4G10613	4	6560362	6561726	1364	+	0
AT4G10620	4	6564278	6566504	2226	+	152
AT4G10630	4	6566624	6567629	1005	-	63
AT4G10640	4	6571898	6574427	2529	+	4
AT4G10650	4	6574471	6576231	1760	-	10
AT4G10655	4	6578838	6579024	186	+	0
AT4G10660	4	6582534	6583488	954	+	0
AT4G10670	4	6584726	6586262	1536	+	0
AT4G10680	4	6587520	6588069	549	+	0
AT4G10690	4	6589131	6593688	4557	+	187
AT4G10695	4	6593773	6594478	705	-	2
AT4G10700	4	6597862	6598658	796	-	0
AT4G10710	4	6601988	6606354	4366	-	1439
AT4G10720	4	6607849	6609559	1710	+	0
AT4G10730	4	6609417	6614883	5466	-	1036
AT4G10740	4	6617142	6618426	1284	-	0
AT4G10750	4	6618675	6619939	1264	+	384
AT4G10760	4	6619816	6623351	3535	-	378
AT4G10767	4	6627035	6627522	487	+	0
AT4G10770	4	6628403	6632599	4196	-	2184
AT4G10780	4	6634778	6637457	2679	-	1
AT4G10790	4	6640598	6643062	2464	-	941
AT4G10800	4	6643308	6644845	1537	+	86
AT4G10810	4	6645715	6646336	621	-	364
AT4G10815	4	6646429	6646500	71	+	0
AT4G10820	4	6648008	6648909	901	-	0
AT4G10830	4	6650723	6654712	3989	+	0
AT4G10840	4	6656515	6659265	2750	+	1757
AT4G10845	4	6662594	6663964	1370	+	8
AT4G10850	4	6674997	6676981	1984	+	0
AT4G10860	4	6678899	6679436	537	-	1
AT4G10865	4	6681721	6682462	741	-	0
AT4G10870	4	6683554	6684076	522	-	0
AT4G10880	4	6685828	6686347	519	-	0
AT4G10890	4	6688832	6693761	4929	+	143
AT4G10895	4	6693906	6694718	812	-	0
AT4G10910	4	6696711	6697455	744	+	3
AT4G10920	4	6696711	6699199	2488	-	920
AT4G10925	4	6702724	6704645	1921	-	136
AT4G10930	4	6705146	6708846	3700	-	354
AT4G10940	4	6708981	6710923	1942	-	53
AT4G10950	4	6711385	6713512	2127	-	5
AT4G10955	4	6713556	6718555	4999	-	0
AT4G10960	4	6713556	6718550	4994	-	0
AT4G10970	4	6719206	6722220	3014	-	366
AT4G10980	4	6723800	6724685	885	+	0
AT4G10990	4	6724986	6729975	4989	+	1
AT4G11000	4	6731019	6732464	1445	+	24
AT4G11010	4	6732579	6734361	1782	-	4164
AT4G11020	4	6734688	6736075	1387	-	1
AT4G11030	4	6738119	6742229	4110	+	0
AT4G11040	4	6745099	6746944	1845	+	0
AT4G11050	4	6747466	6751311	3845	-	7
AT4G11060	4	6754586	6756532	1946	-	125
AT4G11070	4	6759302	6760794	1492	+	23
AT4G11080	4	6760866	6763272	2406	-	222
AT4G11090	4	6764536	6766268	1732	-	201
AT4G11100	4	6768613	6770184	1571	+	655
AT4G11110	4	6771604	6777225	5621	+	977
AT4G11120	4	6777801	6780166	2365	+	379
AT4G11130	4	6780521	6784440	3919	+	177
AT4G11140	4	6794775	6795793	1018	-	26
AT4G11150	4	6799934	6801932	1998	+	4768
AT4G11160	4	6803593	6806875	3282	+	767
AT4G11170	4	6811126	6817130	6004	+	2
AT4G11175	4	6818086	6819042	956	+	1718
AT4G11177	4	6819291	6819328	37	+	0
AT4G11180	4	6820032	6820747	715	+	0
AT4G11190	4	6826676	6827383	707	+	34
AT4G11200	4	6827757	6829496	1739	-	5
AT4G11210	4	6832690	6833245	555	+	0
AT4G11211	4	6836105	6836588	483	+	311
AT4G11213	4	6837559	6837643	84	-	0
AT4G11216	4	6837773	6837857	84	-	0
AT4G11220	4	6837910	6839795	1885	-	652
AT4G11230	4	6840490	6845591	5101	-	2
AT4G11240	4	6847111	6849300	2189	+	437
AT4G11250	4	6849577	6850567	990	+	1
AT4G11260	4	6851276	6853860	2584	-	2119
AT4G11270	4	6854363	6859664	5301	+	992
AT4G11280	4	6864096	6866116	2020	+	353
AT4G11290	4	6869952	6871661	1709	+	43
AT4G11300	4	6872150	6873541	1391	-	105
AT4G11310	4	6883550	6885517	1967	+	0
AT4G11320	4	6887253	6889059	1806	+	286
AT4G11330	4	6892054	6894149	2095	+	450
AT4G11340	4	6894207	6899130	4923	-	0
AT4G11350	4	6901681	6904244	2563	+	24
AT4G11355	4	6905484	6905557	73	-	0
AT4G11360	4	6906013	6906759	746	+	201
AT4G11370	4	6907673	6908386	713	+	8
AT4G11375	4	6914884	6919316	4432	-	0
AT4G11380	4	6920488	6925969	5481	+	1767
AT4G11385	4	6927086	6927678	592	-	1
AT4G11390	4	6927891	6930378	2487	+	0
AT4G11393	4	6932369	6932718	349	+	0
AT4G11400	4	6938716	6940539	1823	+	17
AT4G11405	4	6944726	6944798	72	+	0
AT4G11410	4	6944917	6947333	2416	-	542
AT4G11420	4	6947475	6952445	4970	-	3135
AT4G11430	4	6952798	6954242	1444	+	0
AT4G11440	4	6955600	6958553	2953	+	91
AT4G11450	4	6958680	6962046	3366	-	159
AT4G11460	4	6964467	6967093	2626	+	21
AT4G11470	4	6967728	6970161	2433	+	0
AT4G11480	4	6971407	6973799	2392	+	0
AT4G11485	4	6975281	6975945	664	-	0
AT4G11490	4	6978847	6981548	2701	+	0
AT4G11500	4	6982596	6983619	1023	+	0
AT4G11510	4	6984050	6984308	258	-	0
AT4G11521	4	6985564	6986715	1151	+	9
AT4G11530	4	6987092	6989599	2507	+	87
AT4G11540	4	6990977	6992555	1578	-	0
AT4G11550	4	6996822	6998829	2007	-	18
AT4G11560	4	6999895	7003493	3598	-	775
AT4G11570	4	7004332	7006081	1749	+	5639
AT4G11580	4	7006647	7007738	1091	-	0
AT4G11590	4	7008602	7009796	1194	+	2
AT4G11600	4	7009768	7011375	1607	-	1530
AT4G11610	4	7013728	7018049	4321	-	0
AT4G11630	4	7019699	7021348	1649	+	233
AT4G11640	4	7021769	7023318	1549	+	163
AT4G11642	4	7023452	7023806	354	-	0
AT4G11650	4	7024855	7026146	1291	-	4
AT4G11653	4	7037085	7037358	273	-	0
AT4G11655	4	7038584	7039923	1339	+	1
AT4G11660	4	7042629	7044708	2079	+	182
AT4G11670	4	7044243	7053091	8848	-	234
AT4G11680	4	7053442	7055622	2180	-	201
AT4G11690	4	7056253	7057954	1701	+	18
AT4G11700	4	7058085	7058637	552	-	3
AT4G11710	4	7061148	7062792	1644	-	0
AT4G11720	4	7063254	7066878	3624	+	8
AT4G11730	4	7067034	7070968	3934	+	0
AT4G11740	4	7071859	7075501	3642	+	646
AT4G11745	4	7075825	7076680	855	-	0
AT4G11750	4	7077389	7078550	1161	-	0
AT4G11760	4	7079315	7080445	1130	+	0
AT4G11770	4	7082278	7083469	1191	-	0
AT4G11780	4	7085969	7088212	2243	+	6
AT4G11790	4	7090352	7093475	3123	+	650
AT4G11800	4	7093541	7099697	6156	-	828
AT4G11810	4	7104509	7108450	3941	+	0
AT4G11820	4	7108914	7112480	3566	-	1162
AT4G11830	4	7115735	7121245	5510	-	1508
AT4G11840	4	7121964	7125882	3918	-	326
AT4G11845	4	7126665	7128103	1438	-	89
AT4G11850	4	7129122	7133200	4078	-	292
AT4G11860	4	7134083	7138503	4420	-	639
AT4G11870	4	7140494	7140719	225	-	0
AT4G11876	4	7142302	7142434	132	+	0
AT4G11880	4	7143114	7147391	4277	+	2
AT4G11890	4	7147864	7149921	2057	+	69
AT4G11900	4	7150240	7153571	3331	-	669
AT4G11910	4	7156251	7158042	1791	+	10
AT4G11911	4	7158149	7159440	1291	+	3
AT4G11920	4	7160275	7163382	3107	-	144
AT4G11930	4	7164903	7165722	819	+	0
AT4G11940	4	7168172	7168967	795	+	0
AT4G11945	4	7169973	7170174	201	-	0
AT4G11950	4	7173275	7174259	984	-	8
AT4G11960	4	7174885	7177840	2955	-	1224
AT4G11970	4	7180349	7183677	3328	+	221
AT4G11980	4	7183649	7185575	1926	-	391
AT4G11985	4	7185703	7185777	74	+	0
AT4G11990	4	7186095	7189875	3780	-	120
AT4G12000	4	7193269	7195152	1883	-	313
AT4G12005	4	7196546	7197106	560	+	14
AT4G12010	4	7197210	7201393	4183	-	207
AT4G12020	4	7201655	7209648	7993	+	778
AT4G12030	4	7210917	7212992	2075	+	2168
AT4G12040	4	7214702	7215989	1287	+	656
AT4G12050	4	7219823	7221328	1505	-	1
AT4G12060	4	7228006	7229941	1935	-	1857
AT4G12065	4	7232798	7232871	73	-	0
AT4G12070	4	7231821	7234501	2680	+	231
AT4G12080	4	7239218	7241494	2276	+	38
AT4G12090	4	7242164	7242924	760	-	2
AT4G12100	4	7246421	7248127	1706	-	0
AT4G12110	4	7254048	7256406	2358	+	578
AT4G12115	4	7256414	7256487	73	+	0
AT4G12120	4	7256537	7261180	4643	-	134
AT4G12130	4	7263598	7265812	2214	+	140
AT4G12135	4	7265906	7266276	370	+	0
AT4G12140	4	7266545	7267154	609	-	0
AT4G12150	4	7268836	7270267	1431	-	0
AT4G12160	4	7272210	7272655	445	+	1
AT4G12170	4	7273966	7274727	761	-	0
AT4G12180	4	7275739	7277964	2225	+	0
AT4G12190	4	7278544	7278760	216	-	0
AT4G12200	4	7279890	7280757	867	+	1
AT4G12210	4	7281307	7281919	612	-	0
AT4G12220	4	7283247	7283739	492	-	0
AT4G12230	4	7284518	7287542	3024	+	667
AT4G12240	4	7287802	7289225	1423	+	50
AT4G12250	4	7289191	7290902	1711	-	216
AT4G12260	4	7293056	7293719	663	-	0
AT4G12270	4	7297807	7299930	2123	+	0
AT4G12275	4	7300455	7301646	1191	-	0
AT4G12280	4	7301768	7302994	1226	+	0
AT4G12290	4	7304404	7307138	2734	+	205
AT4G12300	4	7307736	7309755	2019	-	348
AT4G12310	4	7310415	7312577	2162	-	784
AT4G12320	4	7314777	7316669	1892	-	2733
AT4G12330	4	7317559	7319739	2180	-	7
AT4G12334	4	7320601	7321061	460	-	0
AT4G12340	4	7321277	7322477	1200	-	620
AT4G12350	4	7324911	7326636	1725	+	6
AT4G12360	4	7327991	7329192	1201	-	0
AT4G12370	4	7331971	7332874	903	+	0
AT4G12380	4	7333510	7334469	959	-	0
AT4G12382	4	7333980	7334956	976	+	7
AT4G12390	4	7336496	7337356	860	+	488
AT4G12400	4	7338658	7341363	2705	-	142
AT4G12405	4	7341423	7341497	74	-	0
AT4G12410	4	7342955	7343590	635	-	4
AT4G12420	4	7349266	7353135	3869	-	4400
AT4G12423	4	7357155	7358643	1488	+	0
AT4G12426	4	7361586	7364457	2871	+	0
AT4G12430	4	7365256	7368730	3474	-	0
AT4G12432	4	7365256	7368730	3474	-	0
AT4G12440	4	7376267	7380151	3884	+	5
AT4G12450	4	7385801	7386810	1009	-	16
AT4G12460	4	7391276	7396509	5233	+	799
AT4G12470	4	7401108	7401907	799	-	6
AT4G12480	4	7406104	7406937	833	-	3
AT4G12490	4	7409620	7410406	786	-	11
AT4G12500	4	7414149	7414927	778	-	1
AT4G12510	4	7417235	7417803	568	-	0
AT4G12520	4	7421055	7421738	683	-	2
AT4G12530	4	7428026	7428563	537	-	1
AT4G12540	4	7429875	7431602	1727	-	57
AT4G12545	4	7434198	7434858	660	+	0
AT4G12550	4	7439114	7439805	691	+	0
AT4G12560	4	7441763	7443754	1991	+	949
AT4G12570	4	7445361	7449086	3725	+	369
AT4G12580	4	7449273	7450031	758	-	27
AT4G12590	4	7451003	7453088	2085	-	863
AT4G12600	4	7453200	7454515	1315	+	652
AT4G12610	4	7454738	7458318	3580	+	711
AT4G12617	4	7459179	7459563	384	+	0
AT4G12620	4	7459645	7462253	2608	-	131
AT4G12640	4	7462598	7467862	5264	+	411
AT4G12650	4	7467977	7470551	2574	-	2259
AT4G12670	4	7472078	7474519	2441	+	278
AT4G12680	4	7475103	7478356	3253	+	261
AT4G12690	4	7480640	7482150	1510	+	127
AT4G12700	4	7482465	7484405	1940	-	328
AT4G12710	4	7484836	7486801	1965	-	178
AT4G12720	4	7487300	7490077	2777	+	819
AT4G12730	4	7491382	7492876	1494	-	2168
AT4G12731	4	7493177	7493360	183	-	0
AT4G12735	4	7493715	7494234	519	-	2
AT4G12740	4	7494577	7497596	3019	-	20
AT4G12750	4	7497813	7504716	6903	-	162
AT4G12760	4	7504851	7506255	1404	+	166
AT4G12770	4	7506381	7511626	5245	-	578
AT4G12780	4	7512046	7517005	4959	+	787
AT4G12790	4	7517054	7519422	2368	-	894
AT4G12800	4	7521321	7522670	1349	+	111809
AT4G12810	4	7522830	7523979	1149	-	0
AT4G12820	4	7527047	7529356	2309	-	0
AT4G12825	4	7529470	7529892	422	+	0
AT4G12830	4	7531140	7533587	2447	+	2214
AT4G12840	4	7533438	7536263	2825	-	128
AT4G12850	4	7536974	7538276	1302	+	15
AT4G12860	4	7538443	7538902	459	-	0
AT4G12870	4	7542232	7543474	1242	+	38
AT4G12880	4	7544380	7545327	947	-	1192
AT4G12890	4	7546376	7547641	1265	+	7
AT4G12900	4	7548819	7549974	1155	+	178
AT4G12910	4	7550432	7553332	2900	-	642
AT4G12915	4	7558227	7559772	1545	-	0
AT4G12917	4	7563156	7563847	691	-	258
AT4G12920	4	7568285	7569455	1170	+	0
AT4G12930	4	7573280	7573706	426	-	0
AT4G12940	4	7574171	7574627	456	+	0
AT4G12950	4	7576641	7577172	531	+	0
AT4G12960	4	7583271	7584630	1359	+	2
AT4G12970	4	7586142	7586849	707	-	361
AT4G12980	4	7589394	7591102	1708	-	2931
AT4G12990	4	7594943	7595463	520	-	105
AT4G13000	4	7598092	7599257	1165	-	14
AT4G13010	4	7600550	7602729	2179	+	2688
AT4G13020	4	7603100	7607155	4055	+	1480
AT4G13030	4	7607266	7609843	2577	+	81
AT4G13040	4	7613315	7615386	2071	+	239
AT4G13050	4	7617560	7619616	2056	+	663
AT4G13060	4	7619934	7620942	1008	-	2
AT4G13070	4	7621345	7623360	2015	-	112
AT4G13075	4	7624679	7625192	513	-	0
AT4G13080	4	7626611	7628367	1756	-	0
AT4G13090	4	7631534	7632870	1336	-	0
AT4G13095	4	7634992	7635483	491	+	0
AT4G13100	4	7636437	7639037	2600	-	462
AT4G13110	4	7641377	7642598	1221	+	56
AT4G13120	4	7644088	7646587	2499	-	105
AT4G13130	4	7647388	7649831	2443	+	0
AT4G13150	4	7650222	7652289	2067	-	682
AT4G13160	4	7653646	7654925	1279	+	240
AT4G13170	4	7654943	7656594	1651	-	1054
AT4G13180	4	7657195	7658197	1002	-	183
AT4G13190	4	7659434	7661106	1672	-	16
AT4G13195	4	7662370	7663177	807	-	88
AT4G13200	4	7668146	7669214	1068	-	1231
AT4G13210	4	7669947	7673376	3429	+	45
AT4G13215	4	7673223	7673760	537	-	7
AT4G13220	4	7674287	7675313	1026	-	931
AT4G13230	4	7675652	7676680	1028	-	1
AT4G13235	4	7677865	7678247	382	-	2
AT4G13240	4	7680152	7682622	2470	+	0
AT4G13245	4	7684060	7684142	82	+	0
AT4G13250	4	7684155	7686876	2721	-	2586
AT4G13251	4	7688596	7689534	938	-	0
AT4G13252	4	7690832	7691492	660	-	0
AT4G13253	4	7691867	7692839	972	-	0
AT4G13254	4	7694250	7694756	506	-	0
AT4G13255	4	7695118	7696090	972	-	0
AT4G13256	4	7697501	7698007	506	-	0
AT4G13257	4	7698369	7699341	972	-	0
AT4G13258	4	7700752	7701280	528	-	0
AT4G13259	4	7701635	7702607	972	-	0
AT4G13260	4	7721617	7723989	2372	-	72
AT4G13261	4	7708597	7709047	450	+	0
AT4G13262	4	7709659	7710727	1068	-	0
AT4G13263	4	7711063	7711620	557	+	0
AT4G13264	4	7703903	7704812	909	-	0
AT4G13265	4	7730960	7731041	81	+	0
AT4G13266	4	7705760	7706862	1102	-	0
AT4G13270	4	7731188	7733201	2013	+	431
AT4G13280	4	7733113	7736745	3632	-	12
AT4G13285	4	7738679	7738867	188	+	0
AT4G13290	4	7740282	7742857	2575	+	3
AT4G13300	4	7742870	7746363	3493	-	0
AT4G13310	4	7750304	7753133	2829	+	0
AT4G13320	4	7753310	7754086	776	+	14
AT4G13330	4	7754247	7755955	1708	-	45
AT4G13340	4	7758609	7761057	2448	+	803
AT4G13345	4	7765072	7769688	4616	+	438
AT4G13350	4	7769769	7773815	4046	-	1233
AT4G13360	4	7775127	7777895	2768	+	1155
AT4G13370	4	7777792	7780366	2574	-	166
AT4G13380	4	7781781	7782553	772	+	0
AT4G13390	4	7783817	7785326	1509	+	0
AT4G13395	4	7785686	7786113	427	-	3
AT4G13400	4	7787690	7791284	3594	-	101
AT4G13410	4	7792218	7795824	3606	-	68
AT4G13420	4	7796849	7802251	5402	-	0
AT4G13430	4	7803932	7807871	3939	-	9625
AT4G13440	4	7810214	7810679	465	+	0
AT4G13442	4	7812744	7813967	1223	+	0
AT4G13445	4	7814201	7814274	73	+	0
AT4G13450	4	7814959	7816004	1045	-	10
AT4G13455	4	7821029	7821656	627	+	0
AT4G13460	4	7824033	7827004	2971	-	834
AT4G13470	4	7827972	7829482	1510	-	1
AT4G13480	4	7836674	7837684	1010	+	0
AT4G13490	4	7839136	7840284	1148	-	0
AT4G13493	4	7845706	7845927	221	+	182
AT4G13494	4	7846596	7846899	303	+	27
AT4G13495	4	7842966	7846774	3808	+	5524
AT4G13500	4	7856766	7857933	1167	-	1599
AT4G13505	4	7857999	7859691	1692	-	4
AT4G13510	4	7858182	7859918	1736	+	48
AT4G13520	4	7864393	7864924	531	+	1034
AT4G13530	4	7866718	7868742	2024	+	1098
AT4G13540	4	7869873	7870750	877	+	90
AT4G13550	4	7871056	7876963	5907	-	1188
AT4G13554	4	7878184	7878561	377	-	2
AT4G13555	4	7878651	7878760	109	-	0
AT4G13560	4	7879560	7880383	823	-	110
AT4G13564	4	7885250	7885462	212	-	8
AT4G13570	4	7884515	7885982	1467	+	118
AT4G13572	4	7887439	7888638	1199	+	282
AT4G13575	4	7892319	7893705	1386	-	1016
AT4G13580	4	7900373	7901328	955	+	1
AT4G13590	4	7901215	7904025	2810	-	1838
AT4G13600	4	7911178	7912892	1714	-	19
AT4G13610	4	7915021	7921231	6210	+	0
AT4G13611	4	7922355	7922657	302	+	0
AT4G13615	4	7924325	7925140	815	+	2414
AT4G13620	4	7932137	7933542	1405	+	2
AT4G13630	4	7933860	7936565	2705	-	349
AT4G13640	4	7936591	7938645	2054	-	484
AT4G13650	4	7938966	7942898	3932	-	97
AT4G13660	4	7946154	7948376	2222	+	5
AT4G13670	4	7948578	7950903	2325	+	2351
AT4G13680	4	7951490	7952781	1291	-	9
AT4G13690	4	7953351	7955769	2418	-	26
AT4G13700	4	7957071	7958919	1848	-	0
AT4G13710	4	7962429	7966518	4089	+	152
AT4G13720	4	7966951	7968925	1974	-	458
AT4G13730	4	7970199	7974248	4049	+	523
AT4G13750	4	7975190	7987620	12430	+	212
AT4G13760	4	7988057	7989648	1591	+	0
AT4G13770	4	7990484	7992311	1827	-	6937
AT4G13780	4	7993154	7998515	5361	-	1623
AT4G13790	4	7999713	8000222	509	-	0
AT4G13800	4	8001861	8004139	2278	-	675
AT4G13810	4	8005031	8007510	2479	-	659
AT4G13820	4	8007988	8010745	2757	-	32
AT4G13830	4	8011423	8012780	1357	+	1993
AT4G13840	4	8013892	8016486	2594	-	2683
AT4G13850	4	8020950	8022260	1310	+	858
AT4G13860	4	8022600	8023162	562	+	2
AT4G13870	4	8023318	8025582	2264	-	118
AT4G13880	4	8025803	8028614	2811	+	69
AT4G13885	4	8028910	8030754	1844	-	29
AT4G13890	4	8031971	8033723	1752	-	3
AT4G13900	4	8035713	8041207	5494	+	557
AT4G13918	4	8043586	8047176	3590	-	2
AT4G13920	4	8043802	8046559	2757	+	0
AT4G13930	4	8047691	8050106	2415	-	4832
AT4G13940	4	8054860	8057181	2321	+	15956
AT4G13950	4	8058071	8058675	604	-	130
AT4G13955	4	8059306	8059742	436	+	0
AT4G13960	4	8060680	8062231	1551	-	0
AT4G13965	4	8066137	8067577	1440	-	0
AT4G13968	4	8069133	8069901	768	+	0
AT4G13970	4	8070188	8075501	5313	-	411
AT4G13980	4	8076979	8079314	2335	-	238
AT4G13985	4	8080117	8081669	1552	-	1
AT4G13990	4	8084394	8086095	1701	+	185
AT4G13992	4	8087339	8089268	1929	+	27
AT4G13996	4	8090145	8090446	301	-	3
AT4G14000	4	8090816	8092672	1856	+	409
AT4G14010	4	8092832	8093382	550	-	195
AT4G14020	4	8095214	8095736	522	-	522
AT4G14030	4	8097917	8100260	2343	-	2616
AT4G14040	4	8100348	8102875	2527	-	6377
AT4G14050	4	8103644	8105521	1877	-	27
AT4G14060	4	8107336	8108307	971	+	0
AT4G14070	4	8111961	8118160	6199	-	2231
AT4G14080	4	8118536	8120358	1822	-	0
AT4G14090	4	8122187	8123835	1648	-	420
AT4G14096	4	8124414	8126514	2100	+	195
AT4G14100	4	8120717	8122417	1700	+	267
AT4G14103	4	8126914	8128833	1919	+	15
AT4G14104	4	8128707	8129534	827	-	2
AT4G14105	4	8129475	8129676	201	-	0
AT4G14110	4	8132885	8134920	2035	-	404
AT4G14120	4	8135123	8136967	1844	+	66
AT4G14130	4	8137050	8138281	1231	-	65
AT4G14135	4	8142811	8143073	262	+	0
AT4G14140	4	8146344	8152131	5787	+	4
AT4G14145	4	8152289	8153678	1389	-	160
AT4G14147	4	8153806	8156790	2984	-	109
AT4G14149	4	8157974	8158349	375	-	0
AT4G14150	4	8158571	8165008	6437	-	138
AT4G14160	4	8167425	8173368	5943	+	1850
AT4G14165	4	8174597	8175715	1118	-	1
AT4G14170	4	8176323	8178142	1819	-	25
AT4G14180	4	8178329	8183515	5186	+	23
AT4G14190	4	8183543	8185187	1644	-	327
AT4G14200	4	8185369	8188783	3414	-	382
AT4G14210	4	8190211	8195265	5054	-	4706
AT4G14220	4	8195880	8198562	2682	+	497
AT4G14225	4	8198776	8199202	426	+	1
AT4G14226	4	8199424	8199592	168	-	0
AT4G14230	4	8200666	8203238	2572	-	699
AT4G14240	4	8204346	8207408	3062	-	1186
AT4G14250	4	8208747	8213237	4490	-	0
AT4G14251	4	8213700	8213883	183	-	0
AT4G14260	4	8216320	8217571	1251	-	0
AT4G14270	4	8218377	8219322	945	+	500
AT4G14272	4	8219621	8220026	405	+	0
AT4G14276	4	8220755	8221193	438	+	0
AT4G14280	4	8222517	8225185	2668	+	0
AT4G14290	4	8225480	8230281	4801	-	81
AT4G14300	4	8231016	8233491	2475	+	1158
AT4G14301	4	8233763	8234227	464	-	0
AT4G14305	4	8235092	8236715	1623	-	13
AT4G14310	4	8236758	8240324	3566	-	385
AT4G14315	4	8240956	8241315	359	+	0
AT4G14320	4	8241731	8243910	2179	-	2292
AT4G14330	4	8244193	8247444	3251	+	238
AT4G14340	4	8248285	8251998	3713	-	524
AT4G14342	4	8253549	8255508	1959	-	710
AT4G14345	4	8255699	8255771	72	+	0
AT4G14350	4	8256085	8260787	4702	-	859
AT4G14358	4	8267495	8267825	330	+	0
AT4G14360	4	8267288	8271121	3833	-	1421
AT4G14365	4	8271463	8273765	2302	-	263
AT4G14368	4	8274169	8278810	4641	-	1
AT4G14370	4	8279640	8283263	3623	-	8
AT4G14380	4	8285765	8286772	1007	+	15
AT4G14385	4	8286985	8288800	1815	-	302
AT4G14390	4	8289643	8292083	2440	+	2
AT4G14400	4	8294445	8298602	4157	+	3677
AT4G14403	4	8299041	8299134	93	-	1
AT4G14410	4	8299758	8301667	1909	+	967
AT4G14415	4	8301724	8301798	74	-	0
AT4G14420	4	8301945	8303915	1970	-	693
AT4G14430	4	8304599	8305705	1106	-	574
AT4G14440	4	8306744	8307753	1009	-	1013
AT4G14450	4	8309473	8310058	585	+	4
AT4G14455	4	8310335	8312321	1986	+	273
AT4G14460	4	8314077	8318830	4753	+	0
AT4G14465	4	8320629	8322201	1572	+	57
AT4G14470	4	8327625	8328633	1008	+	0
AT4G14480	4	8330080	8331544	1464	-	179
AT4G14490	4	8332096	8333578	1482	-	48
AT4G14500	4	8334175	8337273	3098	+	1117
AT4G14504	4	8336206	8336331	125	+	6
AT4G14510	4	8337275	8341159	3884	-	889
AT4G14520	4	8341334	8343234	1900	+	210
AT4G14530	4	8343475	8343883	408	-	0
AT4G14540	4	8344615	8345218	603	+	1196
AT4G14548	4	8347009	8347764	755	+	50
AT4G14550	4	8347821	8350019	2198	-	541
AT4G14560	4	8361057	8361986	929	+	315
AT4G14570	4	8362183	8366653	4470	+	1397
AT4G14580	4	8367886	8369167	1281	-	44
AT4G14590	4	8374390	8375962	1572	+	23
AT4G14600	4	8376399	8378335	1936	+	135
AT4G14605	4	8378428	8380714	2286	+	615
AT4G14610	4	8380847	8383496	2649	-	92
AT4G14615	4	8383763	8385079	1316	+	469
AT4G14620	4	8389039	8390833	1794	-	0
AT4G14622	4	8389039	8390833	1794	-	0
AT4G14630	4	8392840	8393813	973	+	1
AT4G14640	4	8397711	8400076	2365	+	9
AT4G14650	4	8400573	8402911	2338	-	36
AT4G14660	4	8406334	8407845	1511	-	68
AT4G14661	4	8408275	8408671	396	-	0
AT4G14670	4	8410053	8412557	2504	+	0
AT4G14680	4	8413287	8415391	2104	-	757
AT4G14690	4	8418282	8419263	981	+	364
AT4G14695	4	8419798	8421030	1232	+	6
AT4G14700	4	8422230	8424760	2530	+	24
AT4G14710	4	8424666	8426558	1892	-	1392
AT4G14713	4	8426709	8429647	2938	-	120
AT4G14716	4	8430206	8431945	1739	-	790
AT4G14720	4	8431972	8435075	3103	-	220
AT4G14723	4	8439898	8440839	941	+	10
AT4G14730	4	8448548	8450073	1525	+	1
AT4G14740	4	8450288	8454028	3740	-	798
AT4G14743	4	8458473	8458755	282	-	0
AT4G14746	4	8462613	8464326	1713	-	116
AT4G14750	4	8470380	8472187	1807	+	162
AT4G14760	4	8475456	8481094	5638	+	1721
AT4G14770	4	8481369	8484825	3456	-	477
AT4G14780	4	8492831	8494591	1760	+	0
AT4G14785	4	8495172	8495620	448	+	0
AT4G14790	4	8496030	8500152	4122	-	269
AT4G14800	4	8500265	8502240	1975	+	696
AT4G14805	4	8502373	8503199	826	-	0
AT4G14810	4	8504144	8504509	365	+	0
AT4G14811	4	8504140	8504314	174	-	0
AT4G14815	4	8505042	8505952	910	+	0
AT4G14819	4	8507262	8507789	527	+	24
AT4G14820	4	8507793	8510038	2245	-	15
AT4G14830	4	8510907	8511928	1021	+	77
AT4G14840	4	8511486	8513727	2241	-	93
AT4G14850	4	8513858	8516360	2502	+	70
AT4G14860	4	8516530	8517079	549	+	20
AT4G14870	4	8517191	8517902	711	+	1112
AT4G14880	4	8517959	8520521	2562	-	8169
AT4G14890	4	8520831	8521456	625	+	2358
AT4G14900	4	8521521	8523705	2184	-	792
AT4G14905	4	8526370	8528010	1640	-	165
AT4G14910	4	8528166	8530334	2168	-	984
AT4G14920	4	8531042	8535842	4800	-	707
AT4G14930	4	8538585	8541899	3314	+	411
AT4G14940	4	8541878	8544566	2688	+	37
AT4G14950	4	8545170	8548055	2885	+	386
AT4G14960	4	8548491	8550453	1962	-	7744
AT4G14965	4	8551243	8553554	2311	+	452
AT4G14970	4	8553642	8561664	8022	+	156
AT4G14980	4	8561875	8563639	1764	-	0
AT4G14990	4	8565621	8569814	4193	-	944
AT4G15000	4	8571832	8572489	657	+	3610
AT4G15010	4	8572904	8575231	2327	-	300
AT4G15020	4	8575385	8578688	3303	+	578
AT4G15030	4	8578977	8581331	2354	+	279
AT4G15040	4	8581372	8584122	2750	-	3
AT4G15050	4	8588547	8590345	1798	-	0
AT4G15053	4	8591929	8593834	1905	-	0
AT4G15056	4	8595984	8597430	1446	-	0
AT4G15060	4	8599034	8601761	2727	+	0
AT4G15061	4	8602047	8602182	135	-	0
AT4G15070	4	8603423	8606141	2718	-	49
AT4G15075	4	8607776	8608519	743	+	0
AT4G15080	4	8608699	8612693	3994	-	511
AT4G15090	4	8614066	8618145	4079	+	445
AT4G15093	4	8618342	8619646	1304	+	131
AT4G15096	4	8620595	8622635	2040	+	0
AT4G15100	4	8625854	8629531	3677	+	0
AT4G15110	4	8629772	8633055	3283	-	2955
AT4G15120	4	8634724	8635561	837	+	4
AT4G15130	4	8637665	8639581	1916	+	319
AT4G15140	4	8639423	8640291	868	-	90
AT4G15150	4	8641671	8642278	607	-	0
AT4G15160	4	8646149	8647252	1103	+	12
AT4G15165	4	8648831	8650382	1551	+	28
AT4G15180	4	8651405	8662587	11182	+	1644
AT4G15200	4	8662991	8665759	2768	-	0
AT4G15210	4	8666337	8669470	3133	-	19
AT4G15215	4	8672069	8679176	7107	+	75
AT4G15230	4	8680181	8686880	6699	+	12
AT4G15233	4	8688288	8694558	6270	+	83
AT4G15236	4	8696682	8702727	6045	+	6
AT4G15240	4	8703074	8705378	2304	-	219
AT4G15242	4	8705786	8706997	1211	-	0
AT4G15248	4	8708847	8709373	526	+	182
AT4G15250	4	8709941	8711108	1167	-	0
AT4G15258	4	8713225	8713353	128	-	4
AT4G15260	4	8713688	8715339	1651	+	99
AT4G15270	4	8716600	8717796	1196	-	0
AT4G15280	4	8719181	8720618	1437	+	1
AT4G15290	4	8721486	8726669	5183	-	1
AT4G15300	4	8730722	8732748	2026	-	0
AT4G15310	4	8736720	8740047	3327	+	0
AT4G15320	4	8742638	8747981	5343	-	12
AT4G15330	4	8751386	8753157	1771	-	0
AT4G15340	4	8754479	8760589	6110	-	0
AT4G15345	4	8762188	8762305	117	+	0
AT4G15350	4	8762952	8764594	1642	+	0
AT4G15360	4	8770184	8771899	1715	+	0
AT4G15370	4	8773785	8779685	5900	-	0
AT4G15380	4	8788738	8790444	1706	+	0
AT4G15390	4	8792811	8794293	1482	-	3
AT4G15393	4	8804119	8807203	3084	+	0
AT4G15396	4	8807526	8810512	2986	+	0
AT4G15398	4	8811524	8811635	111	+	0
AT4G15400	4	8811927	8813478	1551	-	0
AT4G15410	4	8814800	8816805	2005	+	396
AT4G15415	4	8817030	8819693	2663	+	669
AT4G15417	4	8821716	8823076	1360	+	1
AT4G15420	4	8823724	8826096	2372	+	346
AT4G15430	4	8827875	8831504	3629	+	294
AT4G15440	4	8835494	8838676	3182	+	191
AT4G15450	4	8839413	8841276	1863	+	530
AT4G15460	4	8841419	8841866	447	-	0
AT4G15470	4	8843566	8845810	2244	+	1817
AT4G15475	4	8845874	8848869	2995	+	472
AT4G15480	4	8848800	8850516	1716	-	33
AT4G15490	4	8852697	8854545	1848	-	959
AT4G15500	4	8856987	8858572	1585	-	127
AT4G15510	4	8860615	8862665	2050	+	1624
AT4G15520	4	8862814	8864618	1804	+	165
AT4G15530	4	8864827	8870967	6140	-	6601
AT4G15540	4	8873354	8875344	1990	+	1261
AT4G15545	4	8875917	8877799	1882	+	8624
AT4G15550	4	8877589	8879327	1738	-	689
AT4G15560	4	8883906	8887565	3659	+	24804
AT4G15563	4	8890878	8892526	1648	+	16
AT4G15570	4	8892606	8898999	6393	+	231
AT4G15590	4	8900244	8907255	7011	-	0
AT4G15610	4	8909063	8910908	1845	+	14
AT4G15620	4	8913837	8915663	1826	+	841
AT4G15630	4	8917429	8918852	1423	+	702
AT4G15640	4	8918984	8921930	2946	-	217
AT4G15650	4	8922631	8923892	1261	+	0
AT4G15660	4	8925805	8926310	505	+	0
AT4G15670	4	8929178	8929765	587	+	0
AT4G15680	4	8931651	8932295	644	+	0
AT4G15690	4	8934323	8934921	598	+	0
AT4G15700	4	8937392	8937892	500	+	0
AT4G15710	4	8940291	8940858	567	+	3
AT4G15715	4	8945316	8945934	618	+	0
AT4G15720	4	8949459	8951540	2081	+	2
AT4G15730	4	8951532	8957632	6100	-	47
AT4G15733	4	8961719	8962119	400	+	0
AT4G15735	4	8963040	8963583	543	+	0
AT4G15740	4	8964744	8966318	1574	-	0
AT4G15750	4	8967553	8968604	1051	-	0
AT4G15755	4	8970653	8971523	870	-	0
AT4G15760	4	8972648	8974690	2042	-	255
AT4G15765	4	8975403	8977211	1808	-	85
AT4G15770	4	8978005	8978876	871	+	341
AT4G15775	4	8979655	8979728	73	+	0
AT4G15780	4	8979888	8981768	1880	-	746
AT4G15790	4	8982182	8984210	2028	+	369
AT4G15800	4	8984857	8985405	548	+	449
AT4G15802	4	8986614	8988452	1838	-	1286
AT4G15810	4	8989161	8992591	3430	-	323
AT4G15820	4	8992969	8995188	2219	+	273
AT4G15830	4	8995112	8996601	1489	-	229
AT4G15840	4	8996911	9001039	4128	+	855
AT4G15850	4	9001329	9004734	3405	+	74
AT4G15860	4	9006326	9008167	1841	-	0
AT4G15870	4	9008371	9010947	2576	-	0
AT4G15880	4	9012644	9016116	3472	+	563
AT4G15885	4	9016450	9016978	528	-	1
AT4G15890	4	9017452	9022982	5530	+	136
AT4G15900	4	9023727	9027666	3939	+	1252
AT4G15910	4	9028460	9029423	963	+	366
AT4G15920	4	9030516	9033395	2879	-	824
AT4G15930	4	9036221	9038062	1841	+	843
AT4G15940	4	9038288	9040370	2082	+	583
AT4G15950	4	9040682	9042129	1447	+	229
AT4G15953	4	9042896	9043337	441	+	8
AT4G15955	4	9043711	9045599	1888	-	149
AT4G15960	4	9045623	9047449	1826	-	79
AT4G15970	4	9049327	9051370	2043	+	0
AT4G15975	4	9052174	9053152	978	+	3
AT4G15980	4	9057465	9059983	2518	-	0
AT4G15990	4	9061268	9061676	408	-	18
AT4G16000	4	9063844	9064481	637	-	107
AT4G16008	4	9067829	9068512	683	+	253
AT4G16010	4	9069354	9072903	3549	+	0
AT4G16015	4	9073201	9074809	1608	+	37
AT4G16020	4	9075055	9078652	3597	+	1
AT4G16024	4	9080839	9081245	406	-	0
AT4G16030	4	9083446	9084727	1281	+	0
AT4G16040	4	9087181	9087454	273	-	0
AT4G16045	4	9089905	9091860	1955	+	0
AT4G16050	4	9092225	9094357	2132	+	0
AT4G16060	4	9094402	9096353	1951	+	613
AT4G16070	4	9096688	9100983	4295	-	309
AT4G16080	4	9101347	9102887	1540	-	0
AT4G16090	4	9103039	9103965	926	+	0
AT4G16095	4	9104546	9105237	691	+	0
AT4G16100	4	9105719	9108159	2440	+	141
AT4G16105	4	9108307	9108381	74	+	0
AT4G16110	4	9112685	9116164	3479	+	305
AT4G16120	4	9116301	9119317	3016	-	328
AT4G16130	4	9120866	9127938	7072	+	921
AT4G16140	4	9129015	9129841	826	+	542
AT4G16141	4	9131649	9133156	1507	-	456
AT4G16143	4	9133936	9137353	3417	-	1773
AT4G16144	4	9137788	9141572	3784	-	282
AT4G16146	4	9142403	9144583	2180	-	29
AT4G16150	4	9148058	9153292	5234	+	1255
AT4G16155	4	9153362	9157322	3960	-	2316
AT4G16160	4	9157514	9158933	1419	+	4
AT4G16162	4	9159104	9161614	2510	-	1
AT4G16165	4	9164079	9164633	554	+	0
AT4G16180	4	9165272	9170435	5163	-	832
AT4G16190	4	9171466	9173105	1639	+	5501
AT4G16195	4	9173164	9173650	486	-	0
AT4G16200	4	9175648	9176565	917	+	0
AT4G16210	4	9176672	9178048	1376	-	330
AT4G16215	4	9179243	9179833	590	-	7
AT4G16220	4	9182282	9183922	1640	+	0
AT4G16230	4	9185297	9186779	1482	+	0
AT4G16235	4	9191575	9191648	73	+	0
AT4G16240	4	9192335	9192568	233	-	2
AT4G16250	4	9195601	9199486	3885	-	339
AT4G16260	4	9200009	9201552	1543	-	8
AT4G16265	4	9202351	9204078	1727	-	112
AT4G16267	4	9204838	9205948	1110	-	0
AT4G16270	4	9205015	9206552	1537	+	6
AT4G16280	4	9206596	9214825	8229	-	678
AT4G16295	4	9215679	9216135	456	-	0
AT4G16310	4	9218635	9225264	6629	+	883
AT4G16330	4	9226121	9227953	1832	-	405
AT4G16340	4	9228184	9241317	13133	-	1715
AT4G16350	4	9242319	9243912	1593	-	7
AT4G16355	4	9244065	9244654	589	+	0
AT4G16360	4	9245077	9247251	2174	+	843
AT4G16370	4	9247301	9250091	2790	-	2516
AT4G16380	4	9254554	9256219	1665	+	1756
AT4G16390	4	9257957	9260277	2320	+	1739
AT4G16400	4	9260563	9262670	2107	+	34
AT4G16410	4	9261865	9262601	736	-	136
AT4G16420	4	9262620	9266086	3466	-	548
AT4G16430	4	9267259	9269178	1919	+	583
AT4G16440	4	9269093	9271669	2576	-	264
AT4G16442	4	9271855	9273089	1234	-	318
AT4G16444	4	9274442	9276327	1885	-	209
AT4G16447	4	9278786	9279389	603	+	111
AT4G16450	4	9280019	9280854	835	+	1581
AT4G16451	4	9280856	9281000	144	-	0
AT4G16460	4	9284909	9286773	1864	+	2
AT4G16465	4	9287208	9287282	74	+	0
AT4G16470	4	9287861	9289582	1721	-	70
AT4G16475	4	9289684	9289765	81	+	0
AT4G16480	4	9291118	9293203	2085	+	276
AT4G16490	4	9293542	9295625	2083	-	2583
AT4G16500	4	9301387	9302022	635	-	312
AT4G16510	4	9302797	9305047	2250	+	139
AT4G16515	4	9305253	9305763	510	-	71
AT4G16520	4	9306662	9308462	1800	-	2292
AT4G16530	4	9311354	9315813	4459	+	158
AT4G16540	4	9316022	9317153	1131	-	5
AT4G16550	4	9318441	9324254	5813	-	0
AT4G16560	4	9324745	9328628	3883	-	0
AT4G16563	4	9329656	9331523	1867	-	36
AT4G16566	4	9334621	9335968	1347	-	226
AT4G16570	4	9336702	9340869	4167	+	133
AT4G16580	4	9340992	9342846	1854	-	492
AT4G16590	4	9345149	9349221	4072	+	12
AT4G16600	4	9350038	9352707	2669	+	2
AT4G16610	4	9354320	9355287	967	-	8
AT4G16620	4	9358116	9360060	1944	-	19
AT4G16630	4	9361983	9366748	4765	-	348
AT4G16640	4	9367247	9368775	1528	-	7
AT4G16650	4	9372476	9376409	3933	+	700
AT4G16660	4	9376736	9381507	4771	+	2252
AT4G16670	4	9385218	9387754	2536	+	169
AT4G16680	4	9387392	9390774	3382	-	312
AT4G16690	4	9392146	9393529	1383	-	491
AT4G16695	4	9394182	9395517	1335	+	207
AT4G16700	4	9395635	9398308	2673	-	65
AT4G16710	4	9398547	9399801	1254	+	343
AT4G16720	4	9399959	9401382	1423	-	4247
AT4G16730	4	9402897	9406003	3106	+	0
AT4G16740	4	9407767	9410877	3110	+	0
AT4G16745	4	9411839	9414897	3058	+	56
AT4G16748	4	9417057	9420649	3592	-	0
AT4G16750	4	9420916	9421759	843	-	91
AT4G16760	4	9424632	9428895	4263	-	1837
AT4G16765	4	9429874	9432437	2563	-	354
AT4G16770	4	9434392	9437172	2780	-	577
AT4G16780	4	9449113	9450743	1630	+	330
AT4G16790	4	9451584	9453254	1670	-	455
AT4G16800	4	9454815	9457039	2224	-	226
AT4G16807	4	9457316	9459394	2078	-	49
AT4G16810	4	9459869	9462253	2384	-	0
AT4G16820	4	9467562	9469116	1554	+	3
AT4G16830	4	9470384	9472594	2210	+	2743
AT4G16835	4	9472762	9474803	2041	+	25
AT4G16840	4	9474884	9475523	639	+	33
AT4G16845	4	9476142	9479878	3736	+	472
AT4G16850	4	9480075	9481738	1663	+	115
AT4G16855	4	9482369	9482507	138	+	2
AT4G16860	4	9488465	9495816	7351	-	1439
AT4G16870	4	9483954	9488397	4443	-	1286
AT4G16880	4	9496184	9497313	1129	-	731
AT4G16890	4	9500505	9505455	4950	-	2943
AT4G16892	4	9506321	9508337	2016	-	50
AT4G16900	4	9511858	9516541	4683	-	412
AT4G16910	4	9509675	9511760	2085	-	37
AT4G16915	4	9516723	9518697	1974	+	1
AT4G16920	4	9519172	9525691	6519	-	25
AT4G16930	4	9529563	9530115	552	-	0
AT4G16935	4	9530698	9530924	226	+	0
AT4G16940	4	9533148	9537604	4456	-	40
AT4G16950	4	9538797	9544467	5670	-	2838
AT4G16960	4	9546342	9551007	4665	-	95
AT4G16970	4	9551427	9555784	4357	-	172
AT4G16980	4	9556977	9557812	835	+	9483
AT4G16990	4	9560134	9565555	5421	+	6237
AT4G17000	4	9566901	9569913	3012	-	151
AT4G17005	4	9574928	9575295	367	+	0
AT4G17010	4	9575811	9577967	2156	+	135
AT4G17020	4	9577775	9581439	3664	-	291
AT4G17030	4	9581585	9583290	1705	-	254
AT4G17040	4	9585704	9589362	3658	-	4864
AT4G17050	4	9589566	9592587	3021	+	1576
AT4G17060	4	9593528	9595249	1721	-	271
AT4G17070	4	9595384	9598237	2853	-	170
AT4G17080	4	9601450	9604207	2757	+	452
AT4G17085	4	9604501	9604974	473	+	92
AT4G17090	4	9604961	9607334	2373	-	5599
AT4G17098	4	9608631	9611700	3069	+	22
AT4G17100	4	9609909	9612676	2767	-	161
AT4G17140	4	9613329	9636873	23544	-	798
AT4G17150	4	9638173	9641756	3583	+	356
AT4G17160	4	9641979	9643541	1562	-	7
AT4G17170	4	9644712	9646366	1654	-	1407
AT4G17180	4	9646504	9648295	1791	+	119
AT4G17190	4	9648526	9650912	2386	-	631
AT4G17200	4	9651107	9652253	1146	+	0
AT4G17210	4	9652584	9654257	1673	-	0
AT4G17215	4	9655836	9656577	741	+	22
AT4G17220	4	9656837	9659463	2626	-	11
AT4G17230	4	9660984	9663774	2790	-	258
AT4G17240	4	9666592	9668374	1782	-	182
AT4G17245	4	9669364	9670005	641	+	304
AT4G17250	4	9670880	9673417	2537	+	277
AT4G17260	4	9673990	9675448	1458	+	199
AT4G17270	4	9676126	9678777	2651	+	748
AT4G17280	4	9678624	9680389	1765	-	12
AT4G17300	4	9681538	9684975	3437	+	1663
AT4G17310	4	9685177	9686928	1751	-	31
AT4G17330	4	9688887	9697578	8691	-	3653
AT4G17340	4	9699252	9700410	1158	+	6025
AT4G17350	4	9701131	9703574	2443	+	199
AT4G17360	4	9703546	9705468	1922	-	425
AT4G17370	4	9706057	9708261	2204	+	706
AT4G17380	4	9708683	9714135	5452	+	27
AT4G17390	4	9714091	9715612	1521	-	3989
AT4G17410	4	9715760	9721931	6171	+	372
AT4G17420	4	9722355	9724640	2285	-	363
AT4G17430	4	9724839	9726828	1989	-	220
AT4G17440	4	9727739	9729263	1524	+	59
AT4G17450	4	9732816	9737316	4500	-	0
AT4G17453	4	9738057	9738273	216	-	0
AT4G17460	4	9739662	9741146	1484	+	740
AT4G17470	4	9742758	9744860	2102	-	4
AT4G17480	4	9745005	9746966	1961	-	28
AT4G17483	4	9747343	9748892	1549	-	24
AT4G17486	4	9749727	9751709	1982	-	419
AT4G17490	4	9752823	9753867	1044	-	23
AT4G17500	4	9759324	9760340	1016	+	11
AT4G17505	4	9764375	9766315	1940	-	0
AT4G17510	4	9766970	9768770	1800	-	479
AT4G17512	4	9769476	9770200	724	-	0
AT4G17520	4	9771296	9773592	2296	+	3366
AT4G17530	4	9773547	9775607	2060	-	2597
AT4G17540	4	9775840	9777835	1995	+	333
AT4G17550	4	9777647	9779738	2091	-	585
AT4G17560	4	9780278	9782183	1905	+	4831
AT4G17565	4	9782507	9783644	1137	-	0
AT4G17570	4	9783883	9787528	3645	-	681
AT4G17580	4	9789788	9791145	1357	-	0
AT4G17585	4	9792522	9793259	737	-	0
AT4G17587	4	9796095	9797242	1147	-	0
AT4G17590	4	9800842	9802591	1749	-	0
AT4G17600	4	9803704	9804872	1168	+	4565
AT4G17610	4	9805512	9814910	9398	-	246
AT4G17612	4	9815202	9815274	72	-	0
AT4G17615	4	9816451	9819312	2861	+	169
AT4G17616	4	9819497	9821684	2187	+	246
AT4G17620	4	9821912	9825029	3117	+	519
AT4G17640	4	9825152	9827357	2205	+	799
AT4G17650	4	9827514	9829659	2145	+	401
AT4G17660	4	9831358	9833006	1648	+	7
AT4G17670	4	9833660	9834727	1067	-	148
AT4G17680	4	9842871	9844265	1394	-	83
AT4G17690	4	9846126	9847107	981	+	0
AT4G17695	4	9848031	9850704	2673	-	165
AT4G17700	4	9854321	9855745	1424	+	0
AT4G17710	4	9856295	9859288	2993	-	0
AT4G17713	4	9859794	9860208	414	-	0
AT4G17718	4	9861595	9861995	400	-	0
AT4G17720	4	9862445	9864663	2218	-	592
AT4G17730	4	9865102	9867022	1920	+	599
AT4G17740	4	9866976	9869752	2776	-	1114
AT4G17750	4	9869817	9871603	1786	-	102
AT4G17760	4	9871788	9873398	1610	+	31
AT4G17765	4	9873511	9873583	72	-	0
AT4G17770	4	9876237	9880254	4017	+	1152
AT4G17780	4	9880258	9881455	1197	-	0
AT4G17785	4	9881634	9883432	1798	-	0
AT4G17788	4	9888985	9889066	81	+	0
AT4G17790	4	9891050	9892807	1757	+	459
AT4G17800	4	9895289	9896668	1379	-	0
AT4G17810	4	9906847	9907657	810	+	434
AT4G17820	4	9909146	9912044	2898	-	0
AT4G17830	4	9915812	9918243	2431	+	1053
AT4G17840	4	9918051	9920475	2424	-	3135
AT4G17850	4	9922989	9923850	861	+	0
AT4G17860	4	9924697	9926372	1675	-	4
AT4G17870	4	9928677	9929518	841	+	905
AT4G17880	4	9933365	9935586	2221	-	1155
AT4G17890	4	9937021	9939493	2472	+	816
AT4G17895	4	9939694	9942772	3078	+	225
AT4G17900	4	9945869	9948078	2209	+	335
AT4G17905	4	9948852	9949785	933	-	35
AT4G17908	4	9950632	9951125	493	+	1
AT4G17910	4	9951172	9953979	2807	-	265
AT4G17914	4	9958158	9958733	575	+	13
AT4G17915	4	9959012	9960404	1392	-	16
AT4G17920	4	9963220	9964090	870	-	5
AT4G17930	4	9964618	9964840	222	+	0
AT4G17940	4	9965741	9966969	1228	+	646
AT4G17950	4	9966989	9969232	2243	-	397
AT4G17960	4	9970846	9972457	1611	+	145
AT4G17970	4	9975407	9977722	2315	+	252
AT4G17975	4	9978105	9978177	72	-	0
AT4G17980	4	9978849	9980038	1189	-	1
AT4G17990	4	9984385	9985805	1420	-	0
AT4G17998	4	9989475	9989613	138	-	0
AT4G18000	4	9989752	9990136	384	-	0
AT4G18010	4	9991011	9994420	3409	-	369
AT4G18020	4	10003260	10007626	4366	-	1400
AT4G18030	4	10012360	10015815	3455	-	2755
AT4G18040	4	10016566	10018228	1662	-	948
AT4G18050	4	10022204	10027415	5211	+	241
AT4G18060	4	10027479	10029899	2420	-	836
AT4G18070	4	10030631	10032963	2332	+	756
AT4G18080	4	10033209	10033935	726	-	0
AT4G18090	4	10034010	10034847	837	-	0
AT4G18100	4	10035484	10036541	1057	-	3590
AT4G18110	4	10037076	10037718	642	-	0
AT4G18120	4	10038125	10042248	4123	+	1539
AT4G18130	4	10042136	10046082	3946	-	1545
AT4G18140	4	10046574	10049438	2864	-	484
AT4G18150	4	10050210	10054031	3821	+	0
AT4G18160	4	10055695	10057736	2041	+	237
AT4G18170	4	10061372	10062841	1469	+	18
AT4G18180	4	10065625	10067317	1692	+	0
AT4G18190	4	10067809	10069338	1529	+	0
AT4G18195	4	10069693	10071115	1422	+	7
AT4G18197	4	10071633	10073236	1603	+	128
AT4G18205	4	10073757	10075271	1514	+	165
AT4G18210	4	10076078	10077748	1670	+	150
AT4G18220	4	10078767	10080109	1342	+	350
AT4G18230	4	10080351	10081939	1588	-	335
AT4G18240	4	10082107	10087203	5096	+	1827
AT4G18250	4	10087342	10091963	4621	-	64
AT4G18255	4	10093066	10093146	80	-	0
AT4G18260	4	10093523	10097503	3980	-	219
AT4G18270	4	10099207	10101897	2690	-	344
AT4G18280	4	10103995	10104733	738	+	316
AT4G18282	4	10107584	10107749	165	+	0
AT4G18290	4	10115417	10118599	3182	+	131
AT4G18300	4	10118851	10120981	2130	+	137
AT4G18310	4	10122074	10122990	916	+	0
AT4G18320	4	10124520	10125978	1458	+	0
AT4G18330	4	10126578	10128734	2156	+	0
AT4G18335	4	10128868	10129363	495	+	0
AT4G18340	4	10130049	10132061	2012	-	41
AT4G18350	4	10142649	10144445	1796	+	2
AT4G18360	4	10145918	10148682	2764	-	17
AT4G18370	4	10149128	10151218	2090	+	1662
AT4G18372	4	10151115	10152120	1005	-	99
AT4G18375	4	10152485	10155293	2808	+	113
AT4G18380	4	10157886	10159748	1862	+	357
AT4G18390	4	10162952	10165562	2610	-	1032
AT4G18395	4	10169443	10169930	487	+	1
AT4G18400	4	10169865	10171257	1392	-	131
AT4G18410	4	10171926	10174176	2250	+	0
AT4G18420	4	10174410	10174960	550	-	0
AT4G18422	4	10176149	10176590	441	-	0
AT4G18425	4	10181333	10182140	807	-	81
AT4G18430	4	10183716	10185280	1564	-	1
AT4G18440	4	10186130	10188909	2779	-	1345
AT4G18450	4	10190249	10191161	912	-	0
AT4G18460	4	10195536	10196796	1260	-	180
AT4G18465	4	10197055	10201611	4556	+	279
AT4G18470	4	10192908	10195662	2754	+	60
AT4G18480	4	10201671	10203469	1798	-	16060
AT4G18490	4	10203597	10208197	4600	+	71
AT4G18500	4	10209147	10209411	264	-	0
AT4G18501	4	10209173	10209733	560	+	9
AT4G18510	4	10211868	10212421	553	+	6
AT4G18520	4	10215119	10217204	2085	-	228
AT4G18530	4	10217337	10220500	3163	+	218
AT4G18540	4	10221202	10223028	1826	-	1
AT4G18550	4	10224920	10226862	1942	-	5
AT4G18570	4	10231217	10234693	3476	+	1348
AT4G18580	4	10234666	10236045	1379	-	116
AT4G18590	4	10236224	10237185	961	+	339
AT4G18593	4	10237571	10238836	1265	+	263
AT4G18596	4	10239016	10239851	835	+	2
AT4G18600	4	10239880	10247372	7492	-	567
AT4G18610	4	10250697	10251542	845	+	22
AT4G18620	4	10254358	10254853	495	+	0
AT4G18630	4	10257077	10258943	1866	+	68
AT4G18640	4	10259677	10263764	4087	+	284
AT4G18650	4	10263968	10265439	1471	-	0
AT4G18660	4	10273479	10274872	1393	+	1
AT4G18670	4	10275461	10278491	3030	-	928
AT4G18680	4	10281032	10281740	708	+	0
AT4G18690	4	10282761	10283803	1042	+	0
AT4G18692	4	10284400	10284667	267	+	0
AT4G18700	4	10288797	10290850	2053	-	1407
AT4G18710	4	10296272	10301228	4956	+	2485
AT4G18720	4	10299944	10301228	1284	+	0
AT4G18725	4	10302000	10302073	73	+	0
AT4G18730	4	10302162	10303382	1220	+	2420
AT4G18740	4	10303413	10304576	1163	-	770
AT4G18750	4	10304849	10307570	2721	+	48
AT4G18760	4	10308162	10309458	1296	-	224
AT4G18770	4	10311029	10313104	2075	+	1
AT4G18780	4	10312623	10316790	4167	-	238
AT4G18790	4	10317784	10319660	1876	-	0
AT4G18800	4	10319861	10321551	1690	-	235
AT4G18810	4	10322155	10325816	3661	-	2797
AT4G18815	4	10325964	10326036	72	-	0
AT4G18820	4	10330370	10334268	3898	+	764
AT4G18823	4	10334910	10335282	372	-	0
AT4G18830	4	10337204	10338612	1408	+	50
AT4G18840	4	10338718	10340356	1638	-	41
AT4G18850	4	10342062	10342242	180	-	0
AT4G18860	4	10344686	10345588	902	+	1
AT4G18870	4	10346167	10347228	1061	+	0
AT4G18880	4	10347581	10349562	1981	-	202
AT4G18890	4	10352621	10355555	2934	+	212
AT4G18900	4	10356464	10359078	2614	+	0
AT4G18905	4	10359895	10363285	3390	+	516
AT4G18910	4	10366058	10368381	2323	+	351
AT4G18920	4	10368754	10370212	1458	+	0
AT4G18930	4	10370703	10372045	1342	+	413
AT4G18940	4	10372731	10373612	881	+	0
AT4G18950	4	10375363	10378390	3027	+	510
AT4G18960	4	10382855	10388539	5684	+	43
AT4G18970	4	10388721	10390991	2270	-	2200
AT4G18975	4	10391964	10393991	2027	-	748
AT4G18980	4	10398917	10399512	595	+	2
AT4G18990	4	10401909	10404248	2339	-	0
AT4G19000	4	10405502	10407339	1837	+	10
AT4G19003	4	10407439	10409012	1573	-	275
AT4G19006	4	10409182	10411465	2283	-	673
AT4G19010	4	10411489	10414249	2760	-	120
AT4G19020	4	10414525	10421209	6684	+	1025
AT4G19030	4	10421524	10423487	1963	-	5
AT4G19035	4	10427806	10428516	710	-	0
AT4G19038	4	10430008	10430998	990	-	0
AT4G19040	4	10431519	10437431	5912	-	932
AT4G19045	4	10438023	10439900	1877	-	205
AT4G19050	4	10439983	10444121	4138	-	145
AT4G19060	4	10444915	10446300	1385	-	443
AT4G19070	4	10446339	10448190	1851	-	349
AT4G19080	4	10448812	10449796	984	-	21
AT4G19090	4	10449899	10452757	2858	+	53
AT4G19095	4	10452888	10453521	633	-	3
AT4G19100	4	10453414	10454359	945	+	645
AT4G19110	4	10454496	10459328	4832	-	0
AT4G19112	4	10454527	10459328	4801	-	0
AT4G19120	4	10460294	10464174	3880	-	696
AT4G19130	4	10466476	10469092	2616	-	24
AT4G19140	4	10469663	10471390	1727	+	277
AT4G19150	4	10471330	10472742	1412	-	360
AT4G19160	4	10477295	10480141	2846	+	2704
AT4G19170	4	10481785	10483857	2072	+	13041
AT4G19180	4	10485324	10488413	3089	-	320
AT4G19185	4	10489041	10491671	2630	-	202
AT4G19190	4	10493246	10496160	2914	+	408
AT4G19191	4	10496227	10498192	1965	+	13
AT4G19200	4	10498875	10500722	1847	+	3617
AT4G19210	4	10501199	10505217	4018	+	2581
AT4G19220	4	10505265	10508121	2856	-	15
AT4G19230	4	10521378	10523961	2583	+	44
AT4G19239	4	10527515	10527776	261	-	0
AT4G19240	4	10527799	10529092	1293	-	0
AT4G19250	4	10531503	10532190	687	+	0
AT4G19260	4	10533295	10536262	2967	+	0
AT4G19270	4	10537554	10538021	467	-	0
AT4G19280	4	10540039	10541502	1463	-	0
AT4G19290	4	10541542	10541967	425	-	0
AT4G19300	4	10542694	10543703	1009	-	0
AT4G19305	4	10545251	10545710	459	+	0
AT4G19310	4	10547771	10549252	1481	-	0
AT4G19320	4	10549347	10552972	3625	-	0
AT4G19330	4	10554981	10558675	3694	+	0
AT4G19340	4	10559609	10560884	1275	+	0
AT4G19350	4	10562022	10563757	1735	-	394
AT4G19360	4	10564158	10565437	1279	+	0
AT4G19370	4	10566149	10567838	1689	-	32
AT4G19380	4	10568364	10572412	4048	-	144
AT4G19390	4	10574767	10576428	1661	-	47
AT4G19395	4	10578651	10578755	104	+	8
AT4G19400	4	10580826	10581989	1163	-	9
AT4G19410	4	10580892	10585861	4969	-	1017
AT4G19420	4	10587165	10590588	3423	-	958
AT4G19430	4	10598444	10599151	707	-	48
AT4G19440	4	10600787	10604520	3733	-	139
AT4G19450	4	10606452	10609335	2883	+	1043
AT4G19452	4	10609554	10610200	646	-	12
AT4G19460	4	10610308	10612005	1697	-	34
AT4G19470	4	10612992	10614339	1347	-	2
AT4G19480	4	10614779	10615316	537	-	0
AT4G19490	4	10615795	10623521	7726	+	1284
AT4G19500	4	10625658	10631570	5912	+	1808
AT4G19510	4	10633684	10639001	5317	+	1494
AT4G19520	4	10639268	10647079	7811	-	770
AT4G19530	4	10651743	10657282	5539	+	2598
AT4G19540	4	10657382	10659233	1851	+	200
AT4G19550	4	10659252	10661311	2059	-	80
AT4G19560	4	10661427	10664716	3289	+	71
AT4G19570	4	10665293	10667318	2025	+	0
AT4G19580	4	10668366	10669452	1086	+	0
AT4G19590	4	10671198	10672290	1092	+	13
AT4G19600	4	10672764	10676735	3971	+	491
AT4G19610	4	10677228	10681771	4543	+	564
AT4G19620	4	10682432	10682844	412	-	0
AT4G19630	4	10683935	10684683	748	-	2
AT4G19633	4	10685516	10685997	481	-	0
AT4G19640	4	10687197	10689617	2420	-	1053
AT4G19645	4	10689845	10691724	1879	-	61
AT4G19650	4	10691673	10695701	4028	+	79
AT4G19660	4	10696265	10698243	1978	-	628
AT4G19670	4	10699237	10702040	2803	-	861
AT4G19680	4	10703361	10704816	1455	+	0
AT4G19690	4	10707425	10709015	1590	+	0
AT4G19700	4	10713560	10714707	1147	-	124
AT4G19710	4	10724854	10729768	4914	+	2766
AT4G19720	4	10730362	10731750	1388	-	1
AT4G19730	4	10733863	10734975	1112	-	0
AT4G19740	4	10739566	10740620	1054	-	1
AT4G19750	4	10745681	10747127	1446	-	0
AT4G19760	4	10750380	10752028	1648	+	0
AT4G19770	4	10753309	10754181	872	-	0
AT4G19780	4	10755049	10755970	921	-	0
AT4G19790	4	10755965	10756808	843	+	0
AT4G19800	4	10760829	10762104	1275	-	0
AT4G19810	4	10763933	10765753	1820	-	49
AT4G19820	4	10767435	10768614	1179	-	62
AT4G19829	4	10772132	10772270	138	-	0
AT4G19830	4	10772401	10774023	1622	-	1076
AT4G19840	4	10774272	10775901	1629	+	4206
AT4G19850	4	10776656	10777588	932	+	12
AT4G19860	4	10777511	10780461	2950	-	1843
AT4G19865	4	10780955	10782365	1410	-	54
AT4G19870	4	10782631	10784263	1632	-	163
AT4G19880	4	10784390	10786556	2166	-	390
AT4G19890	4	10786947	10789053	2106	-	102
AT4G19900	4	10789095	10791433	2338	-	202
AT4G19902	4	10791821	10791972	151	-	0
AT4G19905	4	10794164	10794758	594	-	0
AT4G19910	4	10795868	10796687	819	-	0
AT4G19920	4	10797216	10798388	1172	-	2
AT4G19925	4	10799874	10800726	852	-	0
AT4G19930	4	10803557	10804853	1296	+	0
AT4G19940	4	10806194	10807532	1338	+	0
AT4G19950	4	10809876	10811084	1208	+	49
AT4G19960	4	10813547	10817070	3523	+	389
AT4G19970	4	10818241	10825381	7140	+	21
AT4G19980	4	10828152	10828536	384	-	0
AT4G19985	4	10830236	10832094	1858	-	730
AT4G19990	4	10832302	10835700	3398	+	292
AT4G20000	4	10838309	10839142	833	+	3
AT4G20006	4	10840973	10841096	123	-	0
AT4G20010	4	10841982	10844124	2142	+	567
AT4G20020	4	10844130	10846147	2017	-	341
AT4G20030	4	10846314	10847392	1078	+	193
AT4G20040	4	10847298	10849115	1817	-	11
AT4G20050	4	10849781	10853346	3565	-	19
AT4G20060	4	10854789	10859330	4541	-	230
AT4G20070	4	10861454	10864696	3242	+	925
AT4G20080	4	10865294	10867619	2325	+	0
AT4G20090	4	10868399	10870382	1983	-	96
AT4G20095	4	10871642	10873615	1973	-	0
AT4G20100	4	10873998	10874865	867	-	0
AT4G20110	4	10875232	10878730	3498	+	100
AT4G20115	4	10878723	10878797	74	-	0
AT4G20130	4	10878886	10881945	3059	+	1432
AT4G20140	4	10884196	10888270	4074	+	92
AT4G20150	4	10888261	10889597	1336	-	2254
AT4G20160	4	10890982	10894971	3989	+	1
AT4G20170	4	10896678	10899141	2463	+	687
AT4G20180	4	10901102	10904404	3302	+	0
AT4G20190	4	10906507	10907677	1170	-	0
AT4G20200	4	10908671	10911151	2480	-	0
AT4G20210	4	10913612	10918282	4670	-	0
AT4G20220	4	10918675	10922396	3721	+	0
AT4G20230	4	10924120	10926758	2638	-	39
AT4G20235	4	10929145	10931277	2132	-	1
AT4G20240	4	10931492	10934212	2720	-	30
AT4G20250	4	10937989	10940528	2539	-	0
AT4G20260	4	10940745	10943561	2816	+	2844
AT4G20270	4	10949660	10953083	3423	+	1091
AT4G20280	4	10953546	10954974	1428	+	345
AT4G20290	4	10955158	10955584	426	-	3
AT4G20300	4	10955437	10959213	3776	+	768
AT4G20310	4	10961611	10964056	2445	+	265
AT4G20320	4	10974462	10979464	5002	+	132
AT4G20325	4	10979740	10982646	2906	+	108
AT4G20330	4	10982516	10984521	2005	-	530
AT4G20340	4	10984706	10987748	3042	+	220
AT4G20350	4	10988036	10989890	1854	+	61
AT4G20360	4	10989951	10991709	1758	+	41162
AT4G20362	4	10991614	10992159	545	-	18
AT4G20365	4	10993390	10998715	5325	+	0
AT4G20370	4	11000770	11002996	2226	-	6
AT4G20380	4	11004516	11006788	2272	+	535
AT4G20390	4	11007034	11008066	1032	+	24
AT4G20400	4	11008665	11013860	5195	+	682
AT4G20410	4	11013894	11016576	2682	-	852
AT4G20420	4	11016969	11017623	654	+	38
AT4G20430	4	11017628	11021280	3652	-	373
AT4G20440	4	11022074	11023755	1681	-	555
AT4G20450	4	11024053	11029008	4955	-	2
AT4G20460	4	11029735	11032677	2942	-	39
AT4G20470	4	11032331	11032754	423	-	0
AT4G20480	4	11034271	11035874	1603	-	569
AT4G20490	4	11036682	11039991	3309	+	0
AT4G20500	4	11040458	11041007	549	-	0
AT4G20510	4	11041656	11044799	3143	+	0
AT4G20520	4	11045911	11047716	1805	+	0
AT4G20530	4	11048626	11050975	2349	+	0
AT4G20540	4	11051885	11054234	2349	+	0
AT4G20550	4	11055144	11057493	2349	+	0
AT4G20560	4	11058403	11060752	2349	+	0
AT4G20570	4	11061662	11064011	2349	+	0
AT4G20580	4	11064921	11067270	2349	+	0
AT4G20590	4	11068180	11070529	2349	+	0
AT4G20600	4	11071439	11073788	2349	+	0
AT4G20610	4	11074698	11077047	2349	+	0
AT4G20620	4	11077957	11080306	2349	+	0
AT4G20630	4	11082803	11085152	2349	+	0
AT4G20640	4	11086062	11088411	2349	+	0
AT4G20650	4	11089321	11091671	2350	+	0
AT4G20670	4	11092538	11093621	1083	+	0
AT4G20680	4	11095026	11096307	1281	+	0
AT4G20690	4	11097241	11098024	783	-	1
AT4G20700	4	11098269	11100055	1786	+	0
AT4G20710	4	11100923	11101989	1066	+	0
AT4G20715	4	11103376	11104170	794	-	0
AT4G20720	4	11105317	11108053	2736	+	76
AT4G20725	4	11111762	11114366	2604	-	0
AT4G20730	4	11117797	11120595	2798	-	6
AT4G20740	4	11126150	11128334	2184	+	76
AT4G20760	4	11129014	11130770	1756	+	1077
AT4G20770	4	11130761	11133086	2325	-	5
AT4G20780	4	11133185	11133970	785	-	92
AT4G20790	4	11134774	11136423	1649	-	0
AT4G20800	4	11139608	11141311	1703	+	0
AT4G20810	4	11141426	11143597	2171	-	0
AT4G20820	4	11150159	11151758	1599	+	47
AT4G20830	4	11155452	11157806	2354	+	530
AT4G20840	4	11157915	11159535	1620	+	306
AT4G20850	4	11160720	11169889	9169	-	6767
AT4G20860	4	11172621	11174467	1846	+	100
AT4G20870	4	11174449	11176881	2432	-	597
AT4G20880	4	11179114	11180799	1685	-	356
AT4G20890	4	11182091	11184072	1981	+	1553
AT4G20900	4	11184102	11185844	1742	-	0
AT4G20910	4	11186009	11191116	5107	-	294
AT4G20920	4	11193596	11197577	3981	-	3
AT4G20930	4	11198388	11201087	2699	-	229
AT4G20940	4	11202727	11206280	3553	+	435
AT4G20960	4	11211945	11213644	1699	+	907
AT4G20970	4	11215258	11216212	954	+	15
AT4G20980	4	11216880	11219638	2758	+	1440
AT4G20990	4	11219771	11221126	1355	+	2
AT4G21000	4	11222528	11223756	1228	+	0
AT4G21010	4	11226285	11227363	1078	-	0
AT4G21020	4	11228186	11229577	1391	+	0
AT4G21030	4	11231413	11231998	585	+	0
AT4G21040	4	11234806	11235505	699	-	1
AT4G21050	4	11238440	11239073	633	+	0
AT4G21060	4	11240729	11245049	4320	+	246
AT4G21065	4	11245953	11247807	1854	+	22
AT4G21070	4	11248077	11252724	4647	+	167
AT4G21080	4	11254601	11255351	750	-	0
AT4G21090	4	11256458	11258588	2130	-	148
AT4G21100	4	11258760	11265463	6703	-	554
AT4G21105	4	11265650	11267049	1399	+	2672
AT4G21110	4	11267184	11268959	1775	+	677
AT4G21120	4	11270044	11273973	3929	+	12
AT4G21130	4	11274295	11276299	2004	+	0
AT4G21140	4	11277490	11278222	732	-	111
AT4G21150	4	11278402	11283848	5446	+	1910
AT4G21160	4	11284146	11286767	2621	+	700
AT4G21170	4	11286755	11288754	1999	-	39
AT4G21180	4	11288912	11292389	3477	+	1036
AT4G21190	4	11292191	11294009	1818	-	475
AT4G21192	4	11294179	11295430	1251	+	236
AT4G21200	4	11302684	11306601	3917	+	5
AT4G21210	4	11306944	11308742	1798	+	4461
AT4G21213	4	11309878	11310139	261	+	1
AT4G21215	4	11310384	11313709	3325	-	251
AT4G21216	4	11314440	11314593	153	-	0
AT4G21220	4	11316827	11319067	2240	-	22
AT4G21230	4	11319138	11321679	2541	-	7
AT4G21240	4	11322410	11323664	1254	+	0
AT4G21250	4	11325001	11326783	1782	+	1
AT4G21260	4	11327542	11329057	1515	+	0
AT4G21270	4	11329362	11334135	4773	-	263
AT4G21280	4	11334401	11335773	1372	+	60885
AT4G21300	4	11336478	11339052	2574	+	48
AT4G21310	4	11339047	11340070	1023	-	57
AT4G21320	4	11340361	11341877	1516	+	94
AT4G21323	4	11342493	11345632	3139	+	35
AT4G21326	4	11345973	11349653	3680	+	462
AT4G21330	4	11349921	11350694	773	+	0
AT4G21340	4	11352984	11354776	1792	+	0
AT4G21350	4	11356142	11357267	1125	-	214
AT4G21360	4	11364104	11368147	4043	-	0
AT4G21362	4	11375363	11375481	118	+	0
AT4G21363	4	11378900	11379658	758	+	0
AT4G21366	4	11383540	11383955	415	+	0
AT4G21370	4	11383883	11387136	3253	-	0
AT4G21380	4	11388924	11393226	4302	-	399
AT4G21390	4	11394354	11397583	3229	-	28
AT4G21400	4	11399130	11401709	2579	-	128
AT4G21410	4	11402313	11405056	2743	-	182
AT4G21420	4	11405811	11407512	1701	+	32
AT4G21430	4	11407803	11412159	4356	-	355
AT4G21437	4	11416813	11417404	591	-	1
AT4G21440	4	11418245	11419760	1515	-	40
AT4G21445	4	11424709	11425767	1058	+	658
AT4G21450	4	11425956	11428386	2430	+	1377
AT4G21460	4	11428509	11430732	2223	+	422
AT4G21470	4	11431104	11433322	2218	+	744
AT4G21480	4	11433302	11435284	1982	-	39
AT4G21490	4	11436494	11439326	2832	-	2
AT4G21500	4	11440935	11441734	799	-	15
AT4G21510	4	11445848	11447163	1315	-	61
AT4G21520	4	11447433	11450443	3010	-	106
AT4G21530	4	11450555	11456007	5452	+	152
AT4G21534	4	11456229	11458820	2591	+	146
AT4G21540	4	11459552	11462606	3054	+	379
AT4G21550	4	11463103	11468679	5576	+	67
AT4G21560	4	11468760	11470533	1773	-	350
AT4G21570	4	11470882	11472981	2099	-	816
AT4G21580	4	11475718	11477768	2050	+	762
AT4G21585	4	11477987	11479953	1966	+	126
AT4G21590	4	11480343	11482719	2376	+	18
AT4G21595	4	11482878	11483257	379	-	0
AT4G21600	4	11485118	11487416	2298	+	6
AT4G21605	4	11487645	11488821	1176	+	2
AT4G21610	4	11488975	11490398	1423	+	92
AT4G21620	4	11491481	11492167	686	+	387
AT4G21630	4	11492247	11495500	3253	-	0
AT4G21640	4	11496833	11500618	3785	-	1
AT4G21650	4	11501197	11504678	3481	-	592
AT4G21660	4	11505960	11509842	3882	-	1741
AT4G21670	4	11511114	11517396	6282	+	539
AT4G21680	4	11517352	11519765	2413	-	1
AT4G21690	4	11527228	11529060	1832	+	0
AT4G21700	4	11529955	11532844	2889	+	130
AT4G21705	4	11532970	11534847	1877	-	143
AT4G21710	4	11535524	11542268	6744	-	1232
AT4G21720	4	11542489	11544608	2119	+	78
AT4G21730	4	11544932	11545527	595	+	66
AT4G21740	4	11545925	11546434	509	+	187
AT4G21745	4	11548617	11550622	2005	+	3
AT4G21750	4	11555185	11560733	5548	+	2202
AT4G21760	4	11561228	11563950	2722	+	1345
AT4G21770	4	11563516	11566357	2841	-	415
AT4G21780	4	11567129	11567699	570	+	16
AT4G21790	4	11569764	11572549	2785	+	1574
AT4G21800	4	11572788	11575145	2357	+	686
AT4G21810	4	11575095	11577195	2100	-	755
AT4G21820	4	11577523	11584053	6530	+	145
AT4G21830	4	11584345	11585419	1074	-	0
AT4G21840	4	11587048	11588272	1224	-	4
AT4G21850	4	11591115	11592238	1123	-	37
AT4G21860	4	11600004	11601577	1573	-	2798
AT4G21865	4	11601904	11603276	1372	+	27
AT4G21870	4	11603567	11604331	764	-	98
AT4G21880	4	11604985	11610651	5666	+	137
AT4G21890	4	11611842	11612903	1061	-	68
AT4G21895	4	11613313	11614941	1628	-	0
AT4G21900	4	11616345	11619350	3005	-	200
AT4G21902	4	11619785	11620139	354	+	0
AT4G21903	4	11620997	11623797	2800	-	21
AT4G21910	4	11625361	11631078	5717	-	1045
AT4G21920	4	11636083	11636473	390	-	6
AT4G21926	4	11638700	11640164	1464	-	6
AT4G21930	4	11639756	11640583	827	+	29
AT4G21940	4	11640801	11643762	2961	+	180
AT4G21950	4	11644217	11644605	388	+	0
AT4G21960	4	11646173	11648462	2289	-	35470
AT4G21970	4	11653379	11654136	757	+	23
AT4G21980	4	11655588	11657034	1446	+	729
AT4G21990	4	11657007	11659167	2160	-	1146
AT4G22000	4	11659637	11660906	1269	-	451
AT4G22010	4	11663323	11666715	3392	+	1278
AT4G22020	4	11669265	11670456	1191	+	0
AT4G22030	4	11672395	11675575	3180	+	0
AT4G22040	4	11676659	11681092	4433	-	0
AT4G22050	4	11683864	11685644	1780	+	10
AT4G22060	4	11687619	11689021	1402	+	0
AT4G22065	4	11689186	11689600	414	+	0
AT4G22066	4	11690206	11690887	681	-	0
AT4G22070	4	11691377	11694392	3015	-	0
AT4G22080	4	11700554	11702666	2112	-	0
AT4G22090	4	11704002	11706042	2040	-	0
AT4G22100	4	11707369	11709932	2563	-	19
AT4G22105	4	11710217	11710608	391	-	0
AT4G22110	4	11711313	11714228	2915	-	0
AT4G22115	4	11714742	11715167	425	-	0
AT4G22120	4	11715775	11719828	4053	-	439
AT4G22130	4	11723512	11727673	4161	+	544
AT4G22140	4	11727725	11730509	2784	-	514
AT4G22150	4	11731137	11732901	1764	-	454
AT4G22160	4	11733122	11734027	905	+	218
AT4G22165	4	11734327	11735419	1092	+	0
AT4G22170	4	11736652	11737744	1092	+	1
AT4G22180	4	11738573	11739782	1209	+	0
AT4G22185	4	11740052	11741234	1182	+	0
AT4G22190	4	11741854	11743318	1464	-	965
AT4G22200	4	11746512	11750698	4186	-	1969
AT4G22210	4	11752467	11752816	349	+	0
AT4G22212	4	11753985	11754688	703	+	4
AT4G22214	4	11755309	11756195	886	+	3
AT4G22217	4	11758607	11759072	465	+	0
AT4G22220	4	11759154	11760960	1806	-	2609
AT4G22230	4	11762291	11762688	397	+	0
AT4G22233	4	11763453	11763985	532	-	2
AT4G22235	4	11763624	11764328	704	+	0
AT4G22240	4	11765802	11767304	1502	-	6224
AT4G22250	4	11767512	11768452	940	-	66
AT4G22260	4	11769753	11772516	2763	-	1098
AT4G22265	4	11774460	11774496	36	-	0
AT4G22270	4	11773327	11776039	2712	+	76
AT4G22280	4	11775968	11778123	2155	-	34
AT4G22285	4	11778762	11782680	3918	-	407
AT4G22290	4	11782904	11785816	2912	-	720
AT4G22300	4	11787312	11789280	1968	-	232
AT4G22305	4	11789331	11791191	1860	-	153
AT4G22310	4	11791320	11792876	1556	+	1724
AT4G22320	4	11792873	11794778	1905	-	83
AT4G22330	4	11797566	11799856	2290	+	637
AT4G22340	4	11799958	11803445	3487	-	324
AT4G22350	4	11803830	11807258	3428	-	202
AT4G22360	4	11807659	11810117	2458	+	430
AT4G22370	4	11810004	11811214	1210	-	7
AT4G22380	4	11811749	11813000	1251	-	246
AT4G22390	4	11813424	11815133	1709	-	24
AT4G22400	4	11816728	11817912	1184	+	0
AT4G22410	4	11818212	11820135	1923	-	0
AT4G22415	4	11820324	11825184	4860	-	0
AT4G22420	4	11825613	11826432	819	-	0
AT4G22430	4	11827621	11829041	1420	+	0
AT4G22440	4	11831023	11832268	1245	+	0
AT4G22450	4	11835591	11837644	2053	+	0
AT4G22460	4	11839159	11839561	402	-	0
AT4G22470	4	11840133	11841450	1317	-	1
AT4G22485	4	11844505	11846476	1971	-	973
AT4G22490	4	11849700	11850331	631	-	646
AT4G22505	4	11851227	11853018	1791	-	885
AT4G22510	4	11855047	11857072	2025	-	0
AT4G22513	4	11854808	11855366	558	+	283
AT4G22517	4	11856742	11857313	571	+	50
AT4G22520	4	11858613	11858970	357	+	136
AT4G22530	4	11859003	11860208	1205	-	99
AT4G22540	4	11860443	11866364	5921	-	971
AT4G22545	4	11876814	11877667	853	-	14
AT4G22550	4	11878136	11878920	784	-	92
AT4G22560	4	11880118	11881072	954	+	107
AT4G22570	4	11882125	11885421	3296	-	2236
AT4G22580	4	11889097	11890725	1628	-	288
AT4G22590	4	11893498	11896480	2982	-	0
AT4G22592	4	11893498	11896480	2982	-	0
AT4G22600	4	11900210	11901032	822	-	0
AT4G22610	4	11902104	11902642	538	-	0
AT4G22620	4	11907630	11908113	483	+	13
AT4G22630	4	11909367	11909945	578	+	0
AT4G22635	4	11910288	11910362	74	+	0
AT4G22640	4	11911599	11912107	508	+	1
AT4G22650	4	11913556	11914027	471	+	0
AT4G22660	4	11914980	11916171	1191	-	0
AT4G22666	4	11917056	11917879	823	+	1
AT4G22670	4	11918079	11920910	2831	+	2075
AT4G22680	4	11922339	11924216	1877	-	9
AT4G22690	4	11929358	11931693	2335	+	1088
AT4G22700	4	11933296	11933886	590	+	0
AT4G22710	4	11934968	11936755	1787	+	8
AT4G22720	4	11936941	11938966	2025	+	285
AT4G22730	4	11941130	11943885	2755	+	258
AT4G22740	4	11943848	11945956	2108	-	817
AT4G22745	4	11947312	11948757	1445	-	398
AT4G22750	4	11949179	11951424	2245	-	23
AT4G22753	4	11949163	11953648	4485	-	252
AT4G22754	4	11954740	11954813	73	-	0
AT4G22756	4	11954839	11956813	1974	-	341
AT4G22758	4	11958309	11960036	1727	+	46
AT4G22760	4	11960552	11962289	1737	+	19
AT4G22770	4	11963627	11965684	2057	-	12
AT4G22780	4	11968275	11971149	2874	-	135
AT4G22785	4	11974940	11975021	81	+	0
AT4G22790	4	11975030	11976748	1718	-	86
AT4G22800	4	11978004	11983071	5067	-	0
AT4G22810	4	11984139	11985702	1563	+	0
AT4G22820	4	11987704	11989006	1302	-	448
AT4G22830	4	11990063	11991428	1365	-	656
AT4G22840	4	11991496	11993770	2274	-	252
AT4G22850	4	11994013	11996229	2216	+	197
AT4G22860	4	11997392	12001631	4239	+	110
AT4G22870	4	12001883	12002801	918	-	0
AT4G22880	4	12004767	12006209	1442	-	789
AT4G22890	4	12006985	12009520	2535	+	19199
AT4G22900	4	12010176	12011356	1180	+	17
AT4G22910	4	12012676	12016011	3335	+	223
AT4G22920	4	12016524	12018492	1968	-	598
AT4G22930	4	12018883	12021591	2708	+	1140
AT4G22940	4	12021762	12023467	1705	-	8
AT4G22950	4	12023914	12027421	3507	-	9
AT4G22960	4	12030019	12033137	3118	+	6
AT4G22970	4	12033436	12043728	10292	-	175
AT4G22980	4	12043965	12045701	1736	-	124
AT4G22990	4	12048185	12051796	3611	-	599
AT4G23000	4	12054454	12060028	5574	+	195
AT4G23010	4	12060130	12062858	2728	-	458
AT4G23020	4	12066172	12068538	2366	-	357
AT4G23030	4	12072856	12074365	1509	+	17
AT4G23040	4	12075550	12078742	3192	-	210
AT4G23050	4	12080059	12084256	4197	+	537
AT4G23060	4	12087202	12090575	3373	+	238
AT4G23070	4	12090689	12092077	1388	-	0
AT4G23080	4	12096785	12098888	2103	+	0
AT4G23090	4	12100390	12101483	1093	-	0
AT4G23100	4	12102134	12107460	5326	-	6446
AT4G23103	4	12108569	12108734	165	-	0
AT4G23110	4	12110856	12111570	714	+	0
AT4G23120	4	12113307	12115523	2216	+	0
AT4G23130	4	12117540	12120134	2594	-	118
AT4G23140	4	12121382	12124205	2823	+	56
AT4G23150	4	12125730	12128332	2602	+	15
AT4G23160	4	12129484	12134187	4703	+	10
AT4G23170	4	12135092	12136157	1065	+	186
AT4G23180	4	12138136	12140921	2785	+	750
AT4G23190	4	12141031	12143833	2802	-	46
AT4G23200	4	12145379	12147934	2555	-	94
AT4G23205	4	12144242	12144958	716	-	7
AT4G23210	4	12148713	12151479	2766	-	33
AT4G23215	4	12152899	12153459	560	-	5
AT4G23220	4	12153955	12157091	3136	-	57
AT4G23230	4	12157568	12160270	2702	-	17
AT4G23240	4	12160501	12161954	1453	-	63
AT4G23250	4	12162003	12167026	5023	-	716
AT4G23260	4	12167353	12170086	2733	-	1219
AT4G23270	4	12171102	12173925	2823	+	570
AT4G23271	4	12173943	12174045	102	-	1
AT4G23280	4	12174739	12177471	2732	+	1
AT4G23290	4	12177737	12180826	3089	-	2320
AT4G23300	4	12181931	12184704	2773	+	863
AT4G23310	4	12185736	12188763	3027	+	15
AT4G23320	4	12189181	12191977	2796	-	19
AT4G23330	4	12192114	12195019	2905	+	307
AT4G23340	4	12195452	12196793	1341	-	18
AT4G23350	4	12197312	12199200	1888	-	0
AT4G23360	4	12200268	12204792	4524	-	0
AT4G23364	4	12205479	12205885	406	-	0
AT4G23370	4	12206361	12213435	7074	-	0
AT4G23375	4	12214068	12214167	99	-	0
AT4G23380	4	12214666	12216333	1667	-	0
AT4G23387	4	12217446	12217527	81	-	0
AT4G23390	4	12217805	12219713	1908	-	0
AT4G23400	4	12220742	12222371	1629	+	2551
AT4G23410	4	12223952	12225323	1371	+	43
AT4G23420	4	12225514	12228718	3204	+	51
AT4G23430	4	12229025	12231658	2633	+	822
AT4G23432	4	12233193	12233475	282	-	0
AT4G23440	4	12237764	12240826	3062	+	274
AT4G23450	4	12240802	12242706	1904	-	21
AT4G23460	4	12243670	12248950	5280	-	1052
AT4G23470	4	12249048	12251396	2348	+	1139
AT4G23490	4	12251430	12254270	2840	-	232
AT4G23493	4	12256179	12257039	860	-	8
AT4G23496	4	12257675	12258411	736	-	6
AT4G23500	4	12264589	12267196	2607	+	796
AT4G23510	4	12267515	12270543	3028	-	0
AT4G23515	4	12271381	12272842	1461	-	1
AT4G23520	4	12274456	12276219	1763	-	0
AT4G23530	4	12279074	12280851	1777	+	282
AT4G23540	4	12280412	12286420	6008	-	242
AT4G23550	4	12291819	12293096	1277	+	29
AT4G23560	4	12293331	12295859	2528	-	1
AT4G23570	4	12299822	12302719	2897	+	871
AT4G23580	4	12304245	12305397	1152	-	0
AT4G23590	4	12307125	12309647	2522	+	5
AT4G23600	4	12310618	12313212	2594	+	773
AT4G23610	4	12314024	12314829	805	+	18
AT4G23620	4	12314582	12316715	2133	-	200
AT4G23630	4	12317058	12319937	2879	+	4246
AT4G23635	4	12320109	12320193	84	+	0
AT4G23640	4	12320151	12324486	4335	-	1129
AT4G23650	4	12324757	12327459	2702	-	1896
AT4G23660	4	12327693	12331679	3986	-	238
AT4G23670	4	12332559	12333804	1245	-	17401
AT4G23680	4	12336185	12337482	1297	-	10
AT4G23690	4	12338870	12339747	877	-	74
AT4G23700	4	12342427	12346043	3616	-	5
AT4G23710	4	12350088	12351624	1536	+	639
AT4G23713	4	12352955	12353131	176	+	0
AT4G23720	4	12358674	12359857	1183	+	28
AT4G23730	4	12362483	12365098	2615	+	964
AT4G23740	4	12366385	12369338	2953	+	1501
AT4G23750	4	12376193	12378024	1831	+	295
AT4G23760	4	12381844	12383034	1190	+	140
AT4G23770	4	12383310	12384496	1186	-	194
AT4G23780	4	12386352	12386799	447	-	4
AT4G23790	4	12387839	12389791	1952	+	442
AT4G23800	4	12390166	12392710	2544	+	926
AT4G23810	4	12392369	12393982	1613	-	33
AT4G23820	4	12397037	12400091	3054	-	1536
AT4G23840	4	12400344	12403403	3059	+	94
AT4G23850	4	12403453	12408335	4882	-	4463
AT4G23860	4	12409006	12411570	2564	+	556
AT4G23870	4	12414229	12415049	820	+	44
AT4G23880	4	12415676	12416450	774	-	70
AT4G23882	4	12417552	12418893	1341	+	0
AT4G23885	4	12419393	12420467	1074	+	129
AT4G23890	4	12420413	12421464	1051	-	5111
AT4G23895	4	12422086	12426475	4389	+	222
AT4G23900	4	12424450	12426528	2078	+	9
AT4G23910	4	12426559	12429461	2902	+	263
AT4G23915	4	12429598	12429671	73	+	0
AT4G23920	4	12431276	12433864	2588	+	153
AT4G23930	4	12435945	12436712	767	-	34
AT4G23940	4	12437107	12441968	4861	+	1850
AT4G23950	4	12442046	12444547	2501	+	91
AT4G23960	4	12444764	12445323	559	+	0
AT4G23970	4	12445377	12445680	303	-	2
AT4G23980	4	12451197	12455267	4070	+	723
AT4G23990	4	12456488	12460753	4265	+	663
AT4G24000	4	12462029	12465625	3596	+	4
AT4G24010	4	12466344	12469844	3500	+	89
AT4G24015	4	12469741	12471261	1520	-	50
AT4G24020	4	12479751	12483993	4242	+	1611
AT4G24025	4	12486201	12486272	71	-	0
AT4G24026	4	12486342	12486855	513	+	0
AT4G24030	4	12486246	12486633	387	-	0
AT4G24040	4	12488182	12491235	3053	+	46
AT4G24050	4	12497054	12500128	3074	+	121
AT4G24060	4	12503781	12505646	1865	+	465
AT4G24070	4	12508894	12509095	201	+	1
AT4G24080	4	12511357	12512290	933	+	11
AT4G24090	4	12512735	12514592	1857	+	1077
AT4G24100	4	12515075	12519841	4766	+	484
AT4G24110	4	12519931	12520813	882	-	6
AT4G24120	4	12524490	12527341	2851	+	832
AT4G24130	4	12527752	12528593	841	+	179
AT4G24140	4	12529874	12533842	3968	-	69
AT4G24150	4	12535971	12539387	3416	+	6
AT4G24160	4	12539776	12542489	2713	+	332
AT4G24170	4	12543205	12546805	3600	+	6
AT4G24175	4	12546968	12548960	1992	+	99
AT4G24180	4	12550355	12551299	944	-	3
AT4G24190	4	12551716	12555909	4193	-	7600
AT4G24200	4	12556645	12560944	4299	-	365
AT4G24204	4	12561779	12562974	1195	-	0
AT4G24210	4	12563552	12564482	930	+	299
AT4G24220	4	12564944	12566755	1811	+	1890
AT4G24230	4	12566630	12568846	2216	-	357
AT4G24231	4	12568874	12569024	150	+	0
AT4G24240	4	12571765	12573725	1960	+	249
AT4G24250	4	12574811	12577583	2772	-	49
AT4G24260	4	12577870	12580133	2263	-	15
AT4G24265	4	12580558	12581165	607	-	36
AT4G24270	4	12581600	12587384	5784	-	376
AT4G24275	4	12588518	12589062	544	+	48
AT4G24280	4	12589987	12593630	3643	+	11432
AT4G24290	4	12594281	12598028	3747	+	1032
AT4G24300	4	12598979	12600213	1234	-	0
AT4G24310	4	12600892	12601675	783	+	0
AT4G24320	4	12602297	12603485	1188	-	13
AT4G24330	4	12603520	12606328	2808	-	1371
AT4G24340	4	12607446	12609252	1806	+	5
AT4G24350	4	12609527	12611468	1941	+	526
AT4G24370	4	12611395	12612131	736	-	111
AT4G24380	4	12612534	12613719	1185	+	145
AT4G24390	4	12613075	12616117	3042	-	225
AT4G24400	4	12617255	12620684	3429	+	508
AT4G24410	4	12623529	12624039	510	-	0
AT4G24415	4	12623535	12626432	2897	+	54
AT4G24420	4	12627095	12627606	511	+	0
AT4G24430	4	12630017	12633075	3058	+	43
AT4G24440	4	12633179	12634760	1581	+	410
AT4G24450	4	12635425	12642797	7372	+	706
AT4G24460	4	12642853	12645501	2648	+	780
AT4G24470	4	12645541	12647965	2424	+	525
AT4G24480	4	12649986	12654984	4998	+	315
AT4G24490	4	12655058	12658336	3278	-	516
AT4G24500	4	12658443	12660605	2162	+	208
AT4G24510	4	12660748	12662656	1908	+	784
AT4G24520	4	12662560	12667199	4639	-	1818
AT4G24530	4	12667357	12670013	2656	-	312
AT4G24540	4	12670964	12674072	3108	-	662
AT4G24550	4	12675733	12679040	3307	+	1075
AT4G24560	4	12679209	12684939	5730	-	734
AT4G24565	4	12686138	12686220	82	+	0
AT4G24570	4	12686458	12687650	1192	+	55
AT4G24580	4	12687878	12694248	6370	-	29
AT4G24590	4	12696537	12698218	1681	+	259
AT4G24600	4	12699985	12700478	493	+	1
AT4G24610	4	12700596	12708109	7513	-	426
AT4G24620	4	12708751	12712825	4074	-	4360
AT4G24630	4	12714623	12717111	2488	+	415
AT4G24640	4	12717787	12719017	1230	+	0
AT4G24644	4	12719606	12719771	165	+	0
AT4G24650	4	12720393	12721443	1050	+	0
AT4G24652	4	12722394	12722952	558	-	3
AT4G24660	4	12724742	12725637	895	-	350
AT4G24670	4	12727833	12731274	3441	-	378
AT4G24680	4	12732677	12740051	7374	+	1476
AT4G24690	4	12741032	12744533	3501	+	3168
AT4G24700	4	12744621	12745313	692	-	376
AT4G24710	4	12745546	12748995	3449	-	88
AT4G24730	4	12749277	12754096	4819	-	219
AT4G24740	4	12754528	12757786	3258	-	1335
AT4G24750	4	12758213	12760908	2695	-	2597
AT4G24760	4	12761282	12763781	2499	-	354
AT4G24770	4	12766029	12768040	2011	-	22857
AT4G24780	4	12770330	12772479	2149	-	3464
AT4G24790	4	12777557	12781688	4131	+	429
AT4G24800	4	12781761	12785197	3436	+	2004
AT4G24805	4	12785287	12786249	962	+	234
AT4G24810	4	12786129	12789791	3662	-	855
AT4G24820	4	12789029	12792722	3693	-	2252
AT4G24830	4	12792872	12795974	3102	-	1837
AT4G24840	4	12796246	12800949	4703	-	651
AT4G24860	4	12801548	12808190	6642	-	20
AT4G24880	4	12808519	12811377	2858	+	210
AT4G24890	4	12811478	12814449	2971	-	6
AT4G24900	4	12814837	12817622	2785	+	253
AT4G24910	4	12817953	12818901	948	-	33
AT4G24920	4	12819510	12820736	1226	-	638
AT4G24930	4	12821222	12823742	2520	-	2024
AT4G24940	4	12823495	12826200	2705	+	450
AT4G24950	4	12826281	12826755	474	+	0
AT4G24960	4	12827935	12829243	1308	+	662
AT4G24970	4	12831008	12835449	4441	+	177
AT4G24972	4	12837352	12839823	2471	+	390
AT4G24973	4	12840969	12841374	405	+	0
AT4G24974	4	12842849	12843363	514	+	0
AT4G24975	4	12843801	12844209	408	+	0
AT4G24977	4	12845675	12846015	340	+	0
AT4G24980	4	12846796	12848376	1580	-	0
AT4G24990	4	12849708	12851633	1925	-	530
AT4G25000	4	12851968	12853845	1877	-	40
AT4G25010	4	12854384	12856541	2157	-	3
AT4G25020	4	12860633	12861975	1342	-	60
AT4G25030	4	12864613	12866827	2214	+	1192
AT4G25040	4	12868173	12869457	1284	+	0
AT4G25050	4	12870005	12871316	1311	+	12746
AT4G25070	4	12872445	12876734	4289	+	17
AT4G25080	4	12876845	12878651	1806	+	12246
AT4G25090	4	12878770	12883701	4931	-	2
AT4G25100	4	12884299	12887011	2712	-	35314
AT4G25110	4	12887517	12890262	2745	-	18
AT4G25120	4	12890693	12898501	7808	+	126
AT4G25130	4	12898590	12900064	1474	-	5717
AT4G25140	4	12900429	12901577	1148	+	0
AT4G25150	4	12901533	12903125	1592	-	102
AT4G25160	4	12903190	12907338	4148	-	13
AT4G25170	4	12909574	12911580	2006	+	1209
AT4G25180	4	12911549	12914014	2465	-	227
AT4G25190	4	12914182	12916075	1893	-	0
AT4G25200	4	12917016	12918053	1037	+	1
AT4G25210	4	12918327	12919742	1415	+	796
AT4G25220	4	12920926	12922885	1959	+	0
AT4G25225	4	12922933	12923307	374	-	49
AT4G25230	4	12923918	12929156	5238	+	826
AT4G25235	4	12929746	12930000	254	-	0
AT4G25240	4	12930401	12933892	3491	+	103
AT4G25250	4	12934561	12935373	812	+	0
AT4G25260	4	12935709	12936658	949	-	220
AT4G25270	4	12937252	12938836	1584	-	142
AT4G25280	4	12938955	12940744	1789	-	404
AT4G25290	4	12941241	12944994	3753	-	2401
AT4G25300	4	12945172	12946778	1606	+	314
AT4G25310	4	12949663	12951234	1571	+	2
AT4G25315	4	12951343	12952870	1527	-	96
AT4G25320	4	12954076	12956543	2467	+	267
AT4G25330	4	12957833	12958714	881	+	0
AT4G25340	4	12959441	12962699	3258	-	515
AT4G25350	4	12963381	12966448	3067	-	17
AT4G25360	4	12969576	12972666	3090	+	403
AT4G25370	4	12972707	12974870	2163	+	3267
AT4G25380	4	12975935	12976328	393	-	1
AT4G25386	4	12977003	12977138	135	-	0
AT4G25390	4	12977340	12979568	2228	+	103
AT4G25400	4	12981294	12982468	1174	+	0
AT4G25410	4	12985754	12987217	1463	+	5
AT4G25420	4	12990883	12992458	1575	-	170
AT4G25430	4	12998360	13000211	1851	+	0
AT4G25433	4	13001197	13001870	673	-	13
AT4G25434	4	13003975	13005863	1888	-	55
AT4G25435	4	13006233	13006306	73	-	0
AT4G25440	4	13006726	13009608	2882	-	249
AT4G25450	4	13009694	13013971	4277	-	1688
AT4G25470	4	13015276	13016220	944	-	5
AT4G25480	4	13018213	13019121	908	-	31
AT4G25490	4	13021779	13022725	946	-	1
AT4G25500	4	13024570	13027484	2914	+	677
AT4G25510	4	13027442	13028036	594	-	8
AT4G25515	4	13028218	13031799	3581	+	138
AT4G25520	4	13032177	13036213	4036	-	589
AT4G25530	4	13038359	13042443	4084	+	0
AT4G25540	4	13042556	13048213	5657	-	48
AT4G25550	4	13048376	13051169	2793	+	748
AT4G25560	4	13052554	13053618	1064	+	0
AT4G25570	4	13053685	13055623	1938	-	3315
AT4G25580	4	13056183	13058802	2619	+	0
AT4G25585	4	13058831	13058913	82	-	0
AT4G25590	4	13058935	13060107	1172	-	0
AT4G25600	4	13060658	13062595	1937	+	154
AT4G25610	4	13063263	13067228	3965	+	151
AT4G25620	4	13067185	13069679	2494	-	368
AT4G25630	4	13074132	13076429	2297	+	518
AT4G25631	4	13075562	13075635	73	+	1
AT4G25635	4	13076573	13076657	84	-	0
AT4G25640	4	13076443	13079052	2609	-	2167
AT4G25650	4	13080900	13083197	2297	-	3642
AT4G25660	4	13083406	13085188	1782	+	503
AT4G25670	4	13085197	13087090	1893	-	1
AT4G25672	4	13085217	13087090	1873	-	0
AT4G25680	4	13088165	13090161	1996	+	462
AT4G25690	4	13090208	13091798	1590	-	0
AT4G25692	4	13090208	13091797	1589	-	0
AT4G25700	4	13093933	13095935	2002	-	1392
AT4G25707	4	13097639	13097762	123	-	8
AT4G25710	4	13098140	13099578	1438	-	149
AT4G25719	4	13099787	13101017	1230	+	0
AT4G25720	4	13099811	13102578	2767	-	240
AT4G25730	4	13102678	13106780	4102	-	660
AT4G25740	4	13107249	13108827	1578	-	1778
AT4G25750	4	13110626	13112360	1734	-	7
AT4G25760	4	13116075	13116838	763	+	35
AT4G25770	4	13117524	13120118	2594	-	456
AT4G25780	4	13121067	13121955	888	+	91
AT4G25790	4	13122151	13123347	1196	-	0
AT4G25800	4	13124897	13127953	3056	+	112
AT4G25810	4	13128642	13129884	1242	+	15
AT4G25820	4	13130296	13131788	1492	+	0
AT4G25830	4	13133528	13135024	1496	+	334
AT4G25835	4	13136106	13137859	1753	+	65
AT4G25840	4	13139014	13140960	1946	+	271
AT4G25845	4	13142087	13142821	734	+	0
AT4G25850	4	13142163	13146930	4767	+	13
AT4G25860	4	13147325	13149606	2281	+	4
AT4G25870	4	13149690	13152277	2587	-	290
AT4G25880	4	13154707	13159382	4675	+	1038
AT4G25885	4	13154710	13155033	323	-	0
AT4G25890	4	13159483	13160495	1012	-	744
AT4G25900	4	13161345	13163636	2291	+	492
AT4G25910	4	13163928	13165205	1277	+	977
AT4G25920	4	13165474	13166872	1398	+	1
AT4G25930	4	13168126	13169393	1267	+	0
AT4G25940	4	13169640	13172881	3241	-	463
AT4G25950	4	13173752	13174335	583	-	3
AT4G25960	4	13177408	13183631	6223	+	1906
AT4G25970	4	13184113	13189435	5322	+	1026
AT4G25980	4	13189392	13191507	2115	+	20
AT4G25990	4	13191689	13193543	1854	-	53
AT4G26000	4	13197245	13199836	2591	+	477
AT4G26005	4	13200278	13200401	123	-	0
AT4G26010	4	13200592	13201941	1349	+	4
AT4G26020	4	13202012	13204049	2037	-	6
AT4G26030	4	13205536	13206199	663	+	0
AT4G26040	4	13206834	13207203	369	+	0
AT4G26050	4	13210458	13213477	3019	+	0
AT4G26055	4	13214097	13214429	332	-	6
AT4G26060	4	13214745	13216461	1716	-	88
AT4G26070	4	13217648	13219933	2285	+	373
AT4G26080	4	13219960	13222284	2324	-	1381
AT4G26090	4	13224337	13227872	3535	+	11
AT4G26095	4	13224337	13227622	3285	-	0
AT4G26100	4	13227449	13230797	3348	-	805
AT4G26110	4	13232594	13235879	3285	+	1385
AT4G26120	4	13236447	13238487	2040	+	20
AT4G26130	4	13239978	13241283	1305	-	1279
AT4G26140	4	13243075	13247926	4851	-	464
AT4G26150	4	13253209	13254904	1695	+	247
AT4G26160	4	13255250	13256760	1510	+	213
AT4G26170	4	13256929	13259382	2453	+	12
AT4G26180	4	13260060	13262035	1975	-	105
AT4G26190	4	13262235	13266966	4731	-	843
AT4G26200	4	13275306	13277188	1882	+	0
AT4G26210	4	13281936	13283402	1466	+	287
AT4G26220	4	13283575	13285323	1748	+	13
AT4G26225	4	13285422	13285494	72	-	0
AT4G26230	4	13285824	13286791	967	+	1637
AT4G26240	4	13286773	13288971	2198	-	188
AT4G26250	4	13289640	13291084	1444	+	0
AT4G26255	4	13293940	13296465	2525	+	46
AT4G26260	4	13297697	13300387	2690	+	3
AT4G26270	4	13300794	13304347	3553	-	99
AT4G26280	4	13304720	13305722	1002	-	0
AT4G26288	4	13307460	13308953	1493	+	11
AT4G26290	4	13307594	13307822	228	-	0
AT4G26300	4	13307976	13313109	5133	-	1148
AT4G26310	4	13313769	13316238	2469	-	345
AT4G26320	4	13317099	13317470	371	-	3
AT4G26330	4	13320407	13323461	3054	+	2
AT4G26340	4	13324129	13325590	1461	+	0
AT4G26350	4	13326852	13328315	1463	+	0
AT4G26360	4	13328762	13332375	3613	-	0
AT4G26365	4	13332833	13332911	78	-	0
AT4G26370	4	13333723	13336230	2507	-	745
AT4G26375	4	13336336	13336410	74	-	0
AT4G26380	4	13338077	13341560	3483	+	0
AT4G26385	4	13341492	13341566	74	-	0
AT4G26390	4	13342206	13344418	2212	+	3
AT4G26400	4	13344807	13346597	1790	-	410
AT4G26410	4	13346653	13349016	2363	+	851
AT4G26420	4	13350795	13352569	1774	-	1
AT4G26430	4	13354991	13357602	2611	+	172
AT4G26440	4	13357595	13359551	1956	-	0
AT4G26450	4	13362555	13364935	2380	+	734
AT4G26455	4	13365367	13367497	2130	+	360
AT4G26460	4	13369532	13370011	479	+	0
AT4G26466	4	13367644	13368629	985	-	0
AT4G26470	4	13371065	13372460	1395	+	19
AT4G26480	4	13372421	13375963	3542	-	820
AT4G26483	4	13376646	13376970	324	-	0
AT4G26485	4	13377684	13378390	706	-	0
AT4G26488	4	13380344	13381625	1281	-	0
AT4G26490	4	13380408	13381440	1032	+	2
AT4G26500	4	13382197	13383641	1444	-	786
AT4G26510	4	13384061	13388290	4229	+	1200
AT4G26520	4	13388385	13390374	1989	+	1649
AT4G26530	4	13391292	13393107	1815	+	23322
AT4G26540	4	13394521	13398112	3591	-	550
AT4G26542	4	13395492	13397838	2346	+	0
AT4G26550	4	13402514	13404345	1831	-	154
AT4G26555	4	13404464	13406245	1781	-	991
AT4G26560	4	13406732	13407973	1241	-	0
AT4G26570	4	13408421	13411070	2649	-	737
AT4G26580	4	13411443	13413178	1735	-	25
AT4G26582	4	13413578	13414943	1365	+	4
AT4G26590	4	13413972	13417055	3083	-	61
AT4G26600	4	13419566	13423790	4224	+	249
AT4G26610	4	13424548	13427319	2771	+	501
AT4G26620	4	13427410	13429964	2554	-	482
AT4G26630	4	13430526	13435770	5244	-	4757
AT4G26640	4	13437070	13440835	3765	-	820
AT4G26650	4	13444849	13448212	3363	+	746
AT4G26660	4	13448683	13452016	3333	+	251
AT4G26670	4	13452116	13453984	1868	+	186
AT4G26675	4	13454556	13454629	73	+	0
AT4G26680	4	13454852	13456631	1779	+	56
AT4G26690	4	13456433	13460060	3627	-	1365
AT4G26700	4	13463115	13467601	4486	+	1998
AT4G26701	4	13467624	13468273	649	+	0
AT4G26710	4	13468548	13469935	1387	+	1504
AT4G26720	4	13470031	13472342	2311	-	405
AT4G26730	4	13472578	13473309	731	+	0
AT4G26740	4	13473515	13475328	1813	-	0
AT4G26750	4	13475693	13478523	2830	-	265
AT4G26760	4	13478591	13481808	3217	-	646
AT4G26770	4	13482073	13484849	2776	+	2
AT4G26780	4	13484838	13486771	1933	-	287
AT4G26790	4	13487456	13489376	1920	+	101
AT4G26795	4	13487208	13489601	2393	-	19
AT4G26800	4	13489834	13492054	2220	+	35
AT4G26810	4	13492077	13492932	855	-	41
AT4G26820	4	13493452	13494181	729	-	0
AT4G26830	4	13494571	13496487	1916	-	16
AT4G26840	4	13497325	13498730	1405	+	1331
AT4G26850	4	13499009	13501648	2639	-	15773
AT4G26860	4	13503085	13504780	1695	-	2968
AT4G26870	4	13505330	13507870	2540	+	1311
AT4G26880	4	13508264	13508723	459	-	0
AT4G26890	4	13511838	13513406	1568	+	20
AT4G26900	4	13515477	13519855	4378	+	1116
AT4G26910	4	13519810	13523225	3415	-	793
AT4G26920	4	13525030	13527172	2142	+	0
AT4G26930	4	13527769	13529172	1403	+	0
AT4G26940	4	13529424	13532699	3275	-	1002
AT4G26950	4	13533476	13534359	883	-	71
AT4G26960	4	13538742	13539653	911	-	48
AT4G26965	4	13539616	13542397	2781	+	172
AT4G26970	4	13542917	13548629	5712	+	3774
AT4G26980	4	13548545	13550722	2177	-	189
AT4G26990	4	13550905	13554386	3481	-	112
AT4G27000	4	13554603	13557854	3251	-	1833
AT4G27010	4	13557973	13568296	10323	+	179
AT4G27020	4	13568431	13571474	3043	-	420
AT4G27030	4	13571920	13573070	1150	+	936
AT4G27040	4	13572884	13575538	2654	-	495
AT4G27050	4	13575799	13578051	2252	-	438
AT4G27052	4	13579079	13579310	231	+	0
AT4G27060	4	13581400	13585155	3755	-	608
AT4G27070	4	13586339	13588821	2482	+	292
AT4G27080	4	13589071	13593585	4514	+	777
AT4G27090	4	13593904	13595252	1348	-	6098
AT4G27100	4	13595560	13598915	3355	+	237
AT4G27110	4	13599125	13601552	2427	-	0
AT4G27120	4	13601969	13604427	2458	-	478
AT4G27130	4	13604557	13606448	1891	-	392
AT4G27140	4	13607328	13608031	703	+	0
AT4G27150	4	13609340	13610075	735	+	0
AT4G27160	4	13611795	13612563	768	+	0
AT4G27170	4	13613595	13614283	688	+	0
AT4G27180	4	13614855	13619156	4301	-	1379
AT4G27190	4	13620976	13623934	2958	-	0
AT4G27200	4	13624727	13627237	2510	+	0
AT4G27210	4	13627416	13631922	4506	+	1
AT4G27220	4	13633952	13636712	2760	-	1
AT4G27230	4	13637287	13638449	1162	-	1072
AT4G27240	4	13639962	13641792	1830	+	252
AT4G27250	4	13642675	13644479	1804	-	5
AT4G27260	4	13653608	13656204	2596	+	246
AT4G27270	4	13661330	13663294	1964	-	121
AT4G27280	4	13663575	13664240	665	-	211
AT4G27290	4	13666280	13669202	2922	+	14
AT4G27300	4	13669307	13672348	3041	-	502
AT4G27310	4	13675637	13676910	1273	+	1058
AT4G27320	4	13678463	13680924	2461	-	978
AT4G27330	4	13682077	13683538	1461	-	0
AT4G27340	4	13687195	13690469	3274	-	436
AT4G27350	4	13690820	13692796	1976	-	101
AT4G27360	4	13693956	13694658	702	+	39
AT4G27370	4	13694880	13700780	5900	-	388
AT4G27380	4	13701243	13703165	1922	+	302
AT4G27390	4	13703138	13704693	1555	-	694
AT4G27395	4	13704781	13704854	73	+	0
AT4G27400	4	13705340	13706668	1328	+	0
AT4G27410	4	13707239	13709149	1910	-	180
AT4G27415	4	13710547	13711050	503	+	0
AT4G27420	4	13712198	13714797	2599	-	0
AT4G27430	4	13718678	13723324	4646	+	2925
AT4G27435	4	13723793	13725137	1344	+	97
AT4G27440	4	13725545	13727353	1808	+	9479
AT4G27450	4	13727483	13728886	1403	-	338
AT4G27460	4	13732909	13734304	1395	+	1
AT4G27470	4	13734998	13736518	1520	+	242
AT4G27480	4	13736834	13738975	2141	-	28
AT4G27490	4	13739805	13741803	1998	+	126
AT4G27500	4	13743109	13746211	3102	+	2563
AT4G27510	4	13746175	13749031	2856	-	48
AT4G27520	4	13750439	13751905	1466	-	4766
AT4G27530	4	13752632	13753257	625	+	2
AT4G27540	4	13753209	13754745	1536	-	163
AT4G27550	4	13755648	13759740	4092	+	0
AT4G27560	4	13759840	13761559	1719	-	315
AT4G27570	4	13763463	13765064	1601	-	11
AT4G27580	4	13765660	13766597	937	-	5
AT4G27585	4	13766762	13769961	3199	-	426
AT4G27590	4	13771184	13772594	1410	+	7
AT4G27595	4	13772818	13777290	4472	-	814
AT4G27597	4	13778758	13780954	2196	+	0
AT4G27600	4	13782514	13785112	2598	-	3592
AT4G27610	4	13785431	13788433	3002	-	394
AT4G27620	4	13788820	13790983	2163	-	216
AT4G27630	4	13791641	13797147	5506	-	144
AT4G27640	4	13797657	13803063	5406	-	1151
AT4G27650	4	13803296	13807935	4639	-	603
AT4G27652	4	13809832	13810356	524	+	36
AT4G27654	4	13811644	13812126	482	+	0
AT4G27657	4	13813043	13813516	473	+	47
AT4G27660	4	13817094	13818136	1042	-	21
AT4G27670	4	13818869	13819971	1102	-	0
AT4G27680	4	13821105	13823342	2237	+	641
AT4G27690	4	13823587	13826395	2808	+	236
AT4G27700	4	13826373	13827823	1450	-	5399
AT4G27710	4	13828431	13830596	2165	+	1768
AT4G27720	4	13831037	13833814	2777	+	997
AT4G27730	4	13833806	13836578	2772	-	190
AT4G27740	4	13839074	13839763	689	+	323
AT4G27745	4	13840014	13841489	1475	+	199
AT4G27750	4	13841687	13843633	1946	+	328
AT4G27760	4	13844064	13846746	2682	+	612
AT4G27765	4	13846970	13847161	191	+	0
AT4G27780	4	13847548	13849887	2339	+	192
AT4G27790	4	13850045	13851533	1488	+	0
AT4G27800	4	13851861	13854191	2330	-	3819
AT4G27810	4	13854492	13855718	1226	-	3
AT4G27820	4	13857748	13860571	2823	-	1140
AT4G27830	4	13861717	13864500	2783	-	570
AT4G27840	4	13865044	13866287	1243	-	380
AT4G27850	4	13870381	13873509	3128	+	3
AT4G27852	4	13872078	13873907	1829	-	8
AT4G27860	4	13873707	13876528	2821	+	94
AT4G27870	4	13878922	13882882	3960	+	713
AT4G27875	4	13882916	13882988	72	-	0
AT4G27880	4	13883222	13885052	1830	+	278
AT4G27885	4	13885190	13885263	73	-	0
AT4G27890	4	13886032	13888276	2244	+	0
AT4G27900	4	13890643	13893073	2430	+	158
AT4G27910	4	13894693	13900474	5781	+	295
AT4G27920	4	13901219	13901970	751	+	2
AT4G27930	4	13902634	13902978	344	-	0
AT4G27940	4	13904473	13907245	2772	+	323
AT4G27950	4	13909568	13910859	1291	-	28
AT4G27960	4	13915819	13917420	1601	-	3410
AT4G27970	4	13918289	13920132	1843	-	9
AT4G27980	4	13921676	13923570	1894	+	0
AT4G27990	4	13923772	13924692	920	-	774
AT4G28000	4	13925455	13929280	3825	+	0
AT4G28005	4	13929654	13930191	537	-	0
AT4G28010	4	13930358	13933270	2912	+	66
AT4G28020	4	13933231	13935315	2084	-	62
AT4G28025	4	13935603	13937508	1905	-	2749
AT4G28030	4	13937675	13939144	1469	-	2498
AT4G28040	4	13940345	13942436	2091	+	5
AT4G28050	4	13942256	13943732	1476	-	369
AT4G28060	4	13943871	13945773	1902	-	878
AT4G28068	4	13945737	13945842	105	+	0
AT4G28070	4	13945891	13948627	2736	+	115
AT4G28080	4	13948602	13957840	9238	-	23380
AT4G28085	4	13959969	13960574	605	+	4
AT4G28088	4	13961243	13961560	317	-	0
AT4G28090	4	13961887	13964229	2342	-	0
AT4G28100	4	13965107	13966860	1753	-	595
AT4G28110	4	13968028	13969384	1356	-	0
AT4G28130	4	13971551	13974323	2772	+	0
AT4G28140	4	13974690	13975908	1218	-	17
AT4G28150	4	13977302	13979006	1704	-	39
AT4G28160	4	13980315	13981001	686	+	4
AT4G28162	4	13980326	13980820	494	-	0
AT4G28170	4	13981634	13982837	1203	+	1
AT4G28180	4	13982795	13983717	922	-	76
AT4G28181	4	13983910	13984021	111	-	0
AT4G28190	4	13985177	13987442	2265	+	133
AT4G28200	4	13987601	13990450	2849	-	534
AT4G28210	4	13990616	13992078	1462	+	696
AT4G28220	4	13992996	13995831	2835	+	678
AT4G28230	4	13995778	13997307	1529	-	125
AT4G28240	4	13997291	13998347	1056	-	815
AT4G28250	4	14000037	14002069	2032	-	1836
AT4G28260	4	14004484	14006970	2486	+	1136
AT4G28270	4	14007538	14009019	1481	-	532
AT4G28280	4	14010684	14011558	874	+	7
AT4G28290	4	14011843	14012583	740	-	195
AT4G28300	4	14014652	14017068	2416	+	939
AT4G28310	4	14017407	14018208	801	+	197
AT4G28320	4	14018182	14020251	2069	-	80
AT4G28330	4	14022386	14022987	601	-	25
AT4G28340	4	14024533	14025655	1122	-	1
AT4G28350	4	14026576	14028622	2046	+	98
AT4G28360	4	14029008	14031040	2032	-	528
AT4G28362	4	14032489	14032561	72	+	0
AT4G28365	4	14032844	14033840	996	-	0
AT4G28370	4	14034653	14041322	6669	+	355
AT4G28380	4	14039755	14040931	1176	-	0
AT4G28390	4	14041287	14043278	1991	-	193
AT4G28395	4	14043939	14044902	963	+	0
AT4G28397	4	14045923	14046689	766	+	0
AT4G28400	4	14048291	14050335	2044	+	488
AT4G28405	4	14050133	14050801	668	-	0
AT4G28410	4	14052241	14055012	2771	+	1
AT4G28420	4	14055660	14057592	1932	+	5
AT4G28430	4	14057791	14059864	2073	+	64
AT4G28440	4	14059987	14061386	1399	+	870
AT4G28450	4	14061458	14064708	3250	-	255
AT4G28460	4	14065996	14066543	547	+	0
AT4G28470	4	14066874	14072545	5671	-	1246
AT4G28480	4	14073041	14075271	2230	+	692
AT4G28485	4	14075234	14076011	777	-	2
AT4G28490	4	14077856	14081171	3315	+	277
AT4G28500	4	14082659	14084266	1607	+	40
AT4G28510	4	14084748	14086844	2096	-	345
AT4G28520	4	14087555	14089796	2241	+	0
AT4G28530	4	14090488	14094776	4288	-	5
AT4G28540	4	14106958	14110706	3748	+	569
AT4G28550	4	14110883	14113748	2865	+	112
AT4G28556	4	14114103	14115897	1794	+	6
AT4G28560	4	14116014	14117367	1353	-	10
AT4G28564	4	14118314	14118416	102	-	0
AT4G28570	4	14119424	14122616	3192	+	530
AT4G28580	4	14123488	14125052	1564	+	0
AT4G28590	4	14125228	14126835	1607	-	152
AT4G28600	4	14129310	14132799	3489	+	644
AT4G28610	4	14132855	14135259	2404	-	1354
AT4G28620	4	14135525	14137953	2428	-	0
AT4G28630	4	14138358	14140958	2600	-	449
AT4G28640	4	14142129	14143969	1840	+	225
AT4G28650	4	14143983	14147537	3554	-	33
AT4G28652	4	14144953	14147600	2647	+	1
AT4G28660	4	14149879	14151104	1225	+	5811
AT4G28670	4	14151386	14153935	2549	+	0
AT4G28680	4	14155119	14158716	3597	+	166
AT4G28690	4	14158949	14160979	2030	+	65
AT4G28700	4	14161680	14163195	1515	+	34
AT4G28703	4	14166268	14166928	660	+	9
AT4G28706	4	14167729	14172454	4725	+	1336
AT4G28710	4	14171997	14181771	9774	+	745
AT4G28720	4	14192582	14194256	1674	+	17
AT4G28730	4	14199095	14200901	1806	+	734
AT4G28740	4	14200902	14202681	1779	+	1432
AT4G28750	4	14202757	14203961	1204	-	44441
AT4G28760	4	14207459	14212050	4591	+	1216
AT4G28770	4	14211854	14213969	2115	-	583
AT4G28775	4	14214777	14215381	604	+	0
AT4G28780	4	14215544	14217579	2035	+	2039
AT4G28790	4	14218259	14220265	2006	+	97
AT4G28800	4	14221969	14224075	2106	+	0
AT4G28811	4	14225207	14228071	2864	+	0
AT4G28815	4	14228718	14230288	1570	+	0
AT4G28820	4	14230694	14232342	1648	-	56
AT4G28830	4	14232445	14234042	1597	+	168
AT4G28840	4	14240796	14242611	1815	+	1
AT4G28850	4	14244294	14245957	1663	+	1
AT4G28860	4	14246282	14249544	3262	+	1159
AT4G28870	4	14250420	14250720	300	+	0
AT4G28880	4	14251213	14254432	3219	+	1175
AT4G28890	4	14256332	14257735	1403	-	2
AT4G28900	4	14259140	14263704	4564	+	139
AT4G28910	4	14264066	14266749	2683	-	925
AT4G28915	4	14267280	14267362	82	+	0
AT4G28920	4	14268414	14269885	1471	-	0
AT4G28930	4	14271071	14271652	581	+	0
AT4G28940	4	14274340	14277095	2755	+	5
AT4G28950	4	14277993	14279984	1991	+	94
AT4G28960	4	14280527	14282864	2337	+	0
AT4G28970	4	14283563	14287590	4027	-	0
AT4G28980	4	14288438	14290706	2268	+	603
AT4G28990	4	14291150	14293174	2024	+	127
AT4G29000	4	14293512	14297066	3554	+	223
AT4G29010	4	14297043	14302147	5104	-	3178
AT4G29020	4	14304920	14305721	801	+	2603
AT4G29030	4	14307248	14307973	725	+	1394
AT4G29033	4	14308966	14309379	413	-	0
AT4G29035	4	14310314	14310770	456	+	0
AT4G29040	4	14312302	14314600	2298	+	2486
AT4G29050	4	14314817	14316879	2062	-	59
AT4G29060	4	14317255	14321567	4312	+	16648
AT4G29070	4	14321812	14323307	1495	+	1220
AT4G29080	4	14323360	14325328	1968	-	584
AT4G29090	4	14333527	14335255	1728	+	0
AT4G29100	4	14340999	14344930	3931	+	874
AT4G29103	4	14346287	14346500	213	-	0
AT4G29110	4	14348800	14349701	901	+	243
AT4G29120	4	14350857	14352059	1202	+	740
AT4G29130	4	14352036	14355103	3067	-	2029
AT4G29140	4	14368918	14370892	1974	+	136
AT4G29150	4	14378766	14380511	1745	+	77
AT4G29160	4	14380752	14382666	1914	+	1705
AT4G29170	4	14382838	14385375	2537	+	55
AT4G29180	4	14385592	14389689	4097	+	4
AT4G29190	4	14391937	14393373	1436	-	511
AT4G29200	4	14398053	14400198	2145	-	0
AT4G29210	4	14400919	14403519	2600	+	439
AT4G29220	4	14403346	14406592	3246	-	1967
AT4G29230	4	14410337	14414956	4619	+	57
AT4G29240	4	14418604	14420250	1646	+	203
AT4G29250	4	14420688	14422281	1593	+	0
AT4G29260	4	14422151	14423603	1452	-	496
AT4G29270	4	14423661	14424882	1221	-	27
AT4G29273	4	14425440	14425813	373	-	0
AT4G29276	4	14426789	14427183	394	-	0
AT4G29280	4	14427900	14428265	365	-	0
AT4G29281	4	14429176	14429548	372	-	0
AT4G29283	4	14430222	14430601	379	-	0
AT4G29285	4	14431525	14432290	765	+	0
AT4G29290	4	14432740	14433084	344	-	0
AT4G29300	4	14433990	14434524	534	-	0
AT4G29305	4	14436283	14436631	348	-	0
AT4G29310	4	14437560	14439723	2163	-	657
AT4G29330	4	14444818	14447115	2297	+	512
AT4G29340	4	14447646	14448698	1052	+	1
AT4G29350	4	14450007	14451394	1387	+	6181
AT4G29360	4	14451408	14453915	2507	-	415
AT4G29370	4	14455601	14456738	1137	+	0
AT4G29380	4	14458821	14464859	6038	+	675
AT4G29390	4	14464986	14465983	997	-	1255
AT4G29400	4	14466294	14468143	1849	+	275
AT4G29410	4	14468243	14470167	1924	-	1535
AT4G29415	4	14470277	14470349	72	+	0
AT4G29420	4	14470458	14472232	1774	-	129
AT4G29430	4	14472399	14473621	1222	+	175
AT4G29440	4	14473756	14477935	4179	-	372
AT4G29450	4	14478836	14482626	3790	-	0
AT4G29460	4	14482874	14483936	1062	-	0
AT4G29470	4	14484338	14485817	1479	-	3
AT4G29480	4	14486040	14487777	1737	-	1390
AT4G29490	4	14487893	14491525	3632	+	710
AT4G29510	4	14491624	14494001	2377	+	493
AT4G29520	4	14493910	14495745	1835	-	310
AT4G29530	4	14496078	14497454	1376	+	94
AT4G29540	4	14497728	14499933	2205	+	77
AT4G29548	4	14501975	14502191	216	-	0
AT4G29550	4	14502211	14503847	1636	+	8
AT4G29560	4	14503872	14506014	2142	-	36
AT4G29570	4	14507397	14508482	1085	+	1
AT4G29580	4	14510146	14512186	2040	+	1
AT4G29590	4	14512548	14514492	1944	-	1889
AT4G29600	4	14515577	14516501	924	+	1
AT4G29610	4	14517447	14518329	882	+	37
AT4G29620	4	14519862	14521087	1225	+	0
AT4G29630	4	14522568	14523240	672	+	0
AT4G29640	4	14525829	14526870	1041	+	0
AT4G29650	4	14528586	14529342	756	+	3
AT4G29654	4	14531600	14532454	854	-	0
AT4G29658	4	14533446	14533830	384	-	0
AT4G29660	4	14534262	14535292	1030	-	113
AT4G29670	4	14535541	14537250	1709	-	1960
AT4G29680	4	14537780	14539594	1814	-	569
AT4G29690	4	14540906	14542481	1575	-	3
AT4G29700	4	14543456	14545138	1682	-	117
AT4G29710	4	14547000	14547402	402	-	7
AT4G29720	4	14553314	14555167	1853	-	929
AT4G29730	4	14558984	14562538	3554	-	211
AT4G29735	4	14562638	14564378	1740	-	514
AT4G29740	4	14566264	14569332	3068	+	146
AT4G29750	4	14569727	14573177	3450	+	1451
AT4G29760	4	14574113	14575148	1035	+	1
AT4G29770	4	14575717	14577643	1926	+	3
AT4G29780	4	14579703	14581700	1997	+	67
AT4G29790	4	14582987	14590575	7588	+	638
AT4G29800	4	14590783	14592573	1790	-	9
AT4G29810	4	14593038	14595292	2254	-	1012
AT4G29820	4	14595679	14597481	1802	-	142
AT4G29830	4	14597660	14599300	1640	+	396
AT4G29840	4	14599215	14601055	1840	-	1220
AT4G29850	4	14601620	14603011	1391	-	0
AT4G29860	4	14601697	14605796	4099	-	162
AT4G29870	4	14606000	14606674	674	+	413
AT4G29880	4	14607077	14608379	1302	-	8
AT4G29890	4	14608832	14610998	2166	+	351
AT4G29900	4	14610882	14619573	8691	-	1324
AT4G29905	4	14626920	14627631	711	-	1604
AT4G29910	4	14627962	14630740	2778	-	206
AT4G29920	4	14632652	14635885	3233	-	156
AT4G29930	4	14644008	14647591	3583	+	10
AT4G29940	4	14648138	14653379	5241	-	321
AT4G29950	4	14657044	14660573	3529	+	1007
AT4G29960	4	14660566	14662403	1837	-	407
AT4G29970	4	14662764	14663917	1153	-	0
AT4G29980	4	14664953	14665583	630	-	0
AT4G29990	4	14665690	14670030	4340	-	110
AT4G30000	4	14670155	14672669	2514	-	251
AT4G30010	4	14672831	14674144	1313	+	2169
AT4G30020	4	14677284	14681956	4672	+	1978
AT4G30030	4	14682209	14683484	1275	-	0
AT4G30040	4	14685601	14686885	1284	+	0
AT4G30050	4	14687028	14687776	748	-	1
AT4G30060	4	14689128	14692480	3352	-	269
AT4G30064	4	14694301	14694643	342	+	0
AT4G30067	4	14696073	14696478	405	+	0
AT4G30070	4	14697488	14698430	942	+	0
AT4G30072	4	14698730	14699140	410	+	0
AT4G30074	4	14699736	14700599	863	-	0
AT4G30080	4	14703200	14706336	3136	-	434
AT4G30090	4	14708711	14711612	2901	-	41
AT4G30097	4	14713517	14713661	144	-	23
AT4G30100	4	14714190	14720061	5871	+	1747
AT4G30110	4	14720240	14724584	4344	-	1224
AT4G30120	4	14730400	14733510	3110	-	24
AT4G30130	4	14734818	14737978	3160	+	112
AT4G30140	4	14738386	14740676	2290	-	409
AT4G30150	4	14742451	14749987	7536	+	281
AT4G30160	4	14753348	14760189	6841	+	1882
AT4G30170	4	14762840	14764627	1787	+	0
AT4G30180	4	14768935	14769648	713	+	30
AT4G30190	4	14770498	14776058	5560	-	3117
AT4G30200	4	14786632	14790501	3869	-	1630
AT4G30210	4	14796763	14800922	4159	+	3031
AT4G30220	4	14802949	14804358	1409	-	627
AT4G30230	4	14806344	14807425	1081	+	51
AT4G30240	4	14807918	14809985	2067	-	160
AT4G30250	4	14811261	14812821	1560	-	175
AT4G30260	4	14816621	14818854	2233	-	512
AT4G30270	4	14819191	14820592	1401	-	936
AT4G30280	4	14825807	14827047	1240	-	10
AT4G30290	4	14828711	14830016	1305	-	23
AT4G30300	4	14831004	14831550	546	-	0
AT4G30310	4	14831860	14835214	3354	+	1884
AT4G30320	4	14835832	14836318	486	+	0
AT4G30330	4	14836547	14838020	1473	-	239
AT4G30340	4	14838290	14841067	2777	-	371
AT4G30350	4	14847739	14851143	3404	+	337
AT4G30360	4	14854810	14858003	3193	-	365
AT4G30370	4	14858489	14859503	1014	-	7
AT4G30380	4	14860485	14860994	509	+	1
AT4G30390	4	14862008	14863185	1177	-	152
AT4G30400	4	14866945	14868628	1683	+	375
AT4G30410	4	14871108	14872176	1068	-	92
AT4G30420	4	14877068	14878914	1846	+	0
AT4G30430	4	14878782	14880331	1549	-	4
AT4G30440	4	14881854	14883480	1626	-	2118
AT4G30450	4	14886026	14886675	649	-	81
AT4G30460	4	14888979	14889802	823	-	134
AT4G30470	4	14894104	14896815	2711	+	351
AT4G30480	4	14897345	14899121	1776	+	501
AT4G30490	4	14899033	14902144	3111	-	866
AT4G30500	4	14903486	14904917	1431	+	35
AT4G30510	4	14905136	14907592	2456	-	180
AT4G30520	4	14907999	14911307	3308	-	468
AT4G30530	4	14920533	14922494	1961	+	4084
AT4G30540	4	14923326	14925106	1780	+	0
AT4G30550	4	14925409	14926861	1452	+	710
AT4G30560	4	14926833	14930156	3323	-	104
AT4G30570	4	14930676	14931951	1275	-	82
AT4G30580	4	14932333	14934528	2195	-	1301
AT4G30590	4	14935622	14936562	940	-	0
AT4G30600	4	14937839	14941018	3179	-	2079
AT4G30610	4	14944128	14948605	4477	+	740
AT4G30620	4	14948585	14950072	1487	-	682
AT4G30630	4	14950637	14952376	1739	+	245
AT4G30640	4	14952669	14953682	1013	+	1
AT4G30650	4	14954319	14954968	649	+	310
AT4G30660	4	14955372	14956171	799	+	267
AT4G30662	4	14955908	14956790	882	-	5
AT4G30670	4	14957357	14957962	605	-	3
AT4G30680	4	14958686	14960321	1635	-	98
AT4G30690	4	14960645	14962466	1821	+	1078
AT4G30700	4	14962492	14965015	2523	-	47
AT4G30710	4	14965199	14969763	4564	-	228
AT4G30720	4	14971905	14975519	3614	-	1330
AT4G30730	4	14976417	14976732	315	-	0
AT4G30740	4	14979245	14979521	276	-	1
AT4G30750	4	14981185	14982354	1169	-	357
AT4G30760	4	14982521	14983421	900	+	831
AT4G30770	4	14985640	14986872	1232	-	0
AT4G30780	4	14990340	14993069	2729	+	471
AT4G30790	4	14993085	14997785	4700	-	837
AT4G30800	4	15001133	15002671	1538	+	146
AT4G30810	4	15003450	15006212	2762	+	1109
AT4G30820	4	15006488	15008546	2058	+	160
AT4G30825	4	15009604	15012319	2715	+	803
AT4G30830	4	15015266	15016977	1711	-	19
AT4G30840	4	15017614	15019735	2121	-	87
AT4G30845	4	15019876	15020509	633	+	64
AT4G30850	4	15020181	15022445	2264	-	79
AT4G30860	4	15024471	15027616	3145	+	120
AT4G30870	4	15028426	15032634	4208	+	85
AT4G30872	4	15032977	15033256	279	-	0
AT4G30880	4	15035206	15035843	637	+	0
AT4G30890	4	15036051	15039281	3230	-	941
AT4G30900	4	15039431	15042311	2880	+	257
AT4G30910	4	15042412	15045315	2903	-	256
AT4G30920	4	15046456	15049373	2917	-	2170
AT4G30930	4	15049823	15051665	1842	-	232
AT4G30935	4	15051813	15054042	2229	-	234
AT4G30940	4	15054872	15056826	1954	+	96
AT4G30950	4	15056974	15059794	2820	-	13506
AT4G30960	4	15067052	15069010	1958	+	10319
AT4G30970	4	15069265	15074588	5323	-	0
AT4G30972	4	15074944	15075024	80	+	0
AT4G30975	4	15075041	15077572	2531	+	9
AT4G30980	4	15079242	15081657	2415	-	67
AT4G30990	4	15084097	15097920	13823	+	699
AT4G30993	4	15098066	15100558	2492	+	1738
AT4G30996	4	15101294	15102684	1390	+	613
AT4G31000	4	15103158	15105979	2821	+	313
AT4G31010	4	15106643	15108636	1993	+	164
AT4G31020	4	15108100	15110289	2189	-	19
AT4G31030	4	15111216	15111599	383	-	0
AT4G31040	4	15111476	15114126	2650	-	1394
AT4G31050	4	15114249	15115633	1384	+	132
AT4G31060	4	15116147	15117756	1609	+	103
AT4G31070	4	15118695	15120537	1842	-	12
AT4G31075	4	15120649	15120722	73	+	0
AT4G31080	4	15120887	15123486	2599	+	691
AT4G31100	4	15123780	15126531	2751	+	7
AT4G31110	4	15127245	15130021	2776	+	4
AT4G31115	4	15130074	15132035	1961	+	731
AT4G31120	4	15132010	15136639	4629	-	482
AT4G31130	4	15136934	15138840	1906	-	520
AT4G31136	4	15140458	15140569	111	+	0
AT4G31140	4	15141199	15143391	2192	+	361
AT4G31150	4	15143504	15145629	2125	-	172
AT4G31160	4	15145852	15153075	7223	+	988
AT4G31170	4	15153181	15155703	2522	-	1270
AT4G31180	4	15155878	15159589	3711	+	1610
AT4G31190	4	15159797	15160175	378	-	0
AT4G31196	4	15161172	15161415	243	+	0
AT4G31200	4	15161635	15164914	3279	-	446
AT4G31210	4	15165155	15172738	7583	+	750
AT4G31230	4	15172896	15176109	3213	-	9
AT4G31240	4	15176454	15178768	2314	-	114
AT4G31248	4	15179131	15180803	1672	+	0
AT4G31250	4	15178924	15181751	2827	-	4
AT4G31260	4	15182592	15182784	192	-	0
AT4G31265	4	15183083	15183156	73	+	0
AT4G31270	4	15183187	15184961	1774	-	92
AT4G31280	4	15185800	15186005	205	-	0
AT4G31290	4	15185885	15188484	2599	+	811
AT4G31300	4	15188747	15191217	2470	+	1739
AT4G31310	4	15191324	15192596	1272	+	963
AT4G31320	4	15193992	15194562	570	-	0
AT4G31330	4	15202295	15203431	1136	+	71
AT4G31340	4	15205479	15209601	4122	+	1904
AT4G31350	4	15212497	15215856	3359	+	504
AT4G31351	4	15217686	15217884	198	+	13
AT4G31354	4	15219147	15219345	198	+	1
AT4G31355	4	15219696	15219822	126	-	10
AT4G31360	4	15221842	15223627	1785	+	174
AT4G31370	4	15223654	15224685	1031	-	1
AT4G31380	4	15229784	15230718	934	+	0
AT4G31390	4	15233073	15237109	4036	+	2295
AT4G31398	4	15238583	15239282	699	-	2
AT4G31400	4	15237369	15239323	1954	+	60
AT4G31408	4	15242728	15242969	241	-	1
AT4G31410	4	15243722	15245838	2116	+	343
AT4G31420	4	15245812	15247927	2115	-	594
AT4G31430	4	15248455	15252837	4382	+	572
AT4G31440	4	15253730	15254870	1140	+	84
AT4G31441	4	15254876	15254999	123	+	14
AT4G31450	4	15255622	15258812	3190	-	850
AT4G31460	4	15259468	15261238	1770	-	388
AT4G31470	4	15261745	15262303	558	-	1
AT4G31480	4	15263153	15267847	4694	+	1915
AT4G31490	4	15268532	15273147	4615	+	1523
AT4G31500	4	15273470	15275310	1840	-	4394
AT4G31510	4	15276179	15277219	1040	-	247
AT4G31520	4	15278280	15281739	3459	-	11
AT4G31530	4	15282229	15284216	1987	+	2436
AT4G31540	4	15284388	15287306	2918	-	379
AT4G31550	4	15289946	15291539	1593	-	569
AT4G31560	4	15295200	15296241	1041	+	1098
AT4G31570	4	15297013	15306410	9397	+	1333
AT4G31580	4	15306653	15308347	1694	+	847
AT4G31590	4	15309505	15312591	3086	-	947
AT4G31600	4	15314883	15317135	2252	-	285
AT4G31610	4	15317498	15320020	2522	+	7
AT4G31615	4	15320296	15322194	1898	-	16
AT4G31620	4	15322451	15324681	2230	-	38
AT4G31630	4	15325342	15327220	1878	-	1
AT4G31640	4	15328356	15329689	1333	+	8
AT4G31650	4	15331139	15333321	2182	+	237
AT4G31660	4	15334012	15335630	1618	+	0
AT4G31670	4	15335866	15339591	3725	-	246
AT4G31680	4	15340288	15342081	1793	-	1
AT4G31690	4	15343326	15345161	1835	-	0
AT4G31695	4	15345711	15345747	36	-	0
AT4G31700	4	15346071	15347727	1656	-	5323
AT4G31710	4	15349120	15352962	3842	+	2
AT4G31720	4	15353951	15356352	2401	-	588
AT4G31730	4	15361090	15361850	760	+	54
AT4G31740	4	15363777	15364349	572	+	0
AT4G31750	4	15364417	15367716	3299	-	345
AT4G31760	4	15368031	15369724	1693	-	5
AT4G31770	4	15370065	15372596	2531	-	185
AT4G31780	4	15373998	15377134	3136	+	2774
AT4G31790	4	15377210	15379025	1815	+	196
AT4G31800	4	15383200	15385029	1829	+	59
AT4G31805	4	15385279	15386982	1703	+	138
AT4G31810	4	15387119	15390396	3277	-	212
AT4G31820	4	15390649	15394430	3781	-	749
AT4G31830	4	15400603	15401147	544	-	0
AT4G31840	4	15401639	15402617	978	+	454
AT4G31850	4	15403019	15406493	3474	+	1638
AT4G31860	4	15406438	15409000	2562	-	710
AT4G31870	4	15410204	15411617	1413	+	670
AT4G31875	4	15411700	15412289	589	-	56
AT4G31877	4	15413318	15415873	2555	-	6
AT4G31880	4	15419081	15424265	5184	-	1310
AT4G31890	4	15425885	15429113	3228	-	172
AT4G31895	4	15430223	15430297	74	-	0
AT4G31900	4	15431349	15438678	7329	+	1
AT4G31910	4	15441081	15443900	2819	+	31
AT4G31920	4	15444116	15446959	2843	-	598
AT4G31930	4	15449629	15450838	1209	-	100
AT4G31940	4	15451987	15454160	2173	+	0
AT4G31950	4	15455162	15457121	1959	+	0
AT4G31960	4	15459106	15459781	675	-	1
AT4G31970	4	15462407	15464358	1951	+	0
AT4G31980	4	15464904	15469204	4300	+	214
AT4G31985	4	15469894	15470559	665	+	1513
AT4G31990	4	15470750	15473856	3106	-	4894
AT4G32000	4	15473970	15476685	2715	-	197
AT4G32010	4	15479523	15485353	5830	+	637
AT4G32020	4	15487943	15489450	1507	+	5196
AT4G32030	4	15490739	15493423	2684	+	594
AT4G32040	4	15494064	15496356	2292	+	532
AT4G32050	4	15496536	15500847	4311	+	296
AT4G32060	4	15501077	15503593	2516	+	4106
AT4G32070	4	15504661	15507176	2515	-	447
AT4G32080	4	15508230	15509111	881	-	1
AT4G32090	4	15509989	15510820	831	-	0
AT4G32100	4	15511756	15512218	462	-	0
AT4G32105	4	15513219	15514087	868	-	0
AT4G32110	4	15515648	15516452	804	-	0
AT4G32120	4	15516783	15519855	3072	-	274
AT4G32130	4	15520030	15522593	2563	-	531
AT4G32140	4	15522883	15525448	2565	-	256
AT4G32150	4	15526112	15527879	1767	-	985
AT4G32160	4	15528804	15533100	4296	+	431
AT4G32170	4	15533759	15535333	1574	+	0
AT4G32175	4	15535472	15537602	2130	+	185
AT4G32180	4	15537558	15543904	6346	-	979
AT4G32190	4	15544877	15547855	2978	+	2362
AT4G32200	4	15548839	15555094	6255	+	70
AT4G32205	4	15555494	15556159	665	+	6
AT4G32208	4	15558526	15559650	1124	-	0
AT4G32210	4	15556414	15558125	1711	-	56
AT4G32212	4	15559919	15562070	2151	-	1
AT4G32215	4	15562590	15562848	258	+	0
AT4G32220	4	15563307	15565000	1693	-	0
AT4G32230	4	15565294	15566971	1677	-	0
AT4G32240	4	15568299	15569205	906	+	631
AT4G32250	4	15570043	15573323	3280	-	698
AT4G32260	4	15573635	15574737	1102	-	32228
AT4G32265	4	15576649	15576722	73	+	0
AT4G32270	4	15574867	15576543	1676	-	381
AT4G32272	4	15576846	15579880	3034	-	226
AT4G32280	4	15583386	15584769	1383	+	80
AT4G32285	4	15585679	15588088	2409	+	1313
AT4G32290	4	15589673	15591164	1491	-	188
AT4G32295	4	15592892	15594273	1381	+	169
AT4G32300	4	15599474	15602595	3121	+	342
AT4G32320	4	15602720	15605400	2680	+	818
AT4G32330	4	15608911	15612285	3374	+	2320
AT4G32340	4	15612583	15614305	1722	-	584
AT4G32342	4	15615183	15616200	1017	-	0
AT4G32350	4	15617465	15620910	3445	+	299
AT4G32360	4	15621300	15624923	3623	+	242
AT4G32370	4	15625557	15627517	1960	+	0
AT4G32375	4	15628872	15631596	2724	+	0
AT4G32378	4	15633111	15633222	111	-	0
AT4G32380	4	15633640	15635467	1827	+	0
AT4G32390	4	15636414	15638040	1626	+	1055
AT4G32400	4	15638624	15640465	1841	+	499
AT4G32410	4	15640619	15646665	6046	-	8139
AT4G32420	4	15647345	15652756	5411	-	1209
AT4G32430	4	15652891	15655474	2583	+	26
AT4G32440	4	15656680	15660223	3543	+	472
AT4G32445	4	15660369	15660475	106	+	3
AT4G32450	4	15660926	15662879	1953	+	108
AT4G32460	4	15662265	15665013	2748	-	182
AT4G32470	4	15669218	15671194	1976	-	3029
AT4G32475	4	15671392	15671463	71	+	0
AT4G32480	4	15676403	15677973	1570	+	119
AT4G32490	4	15678646	15679652	1006	-	0
AT4G32500	4	15681016	15685310	4294	+	0
AT4G32510	4	15685902	15688811	2909	-	0
AT4G32520	4	15689463	15692857	3394	-	1378
AT4G32530	4	15693113	15695100	1987	-	987
AT4G32540	4	15700903	15702960	2057	+	6
AT4G32551	4	15707480	15713662	6182	+	1452
AT4G32560	4	15713735	15716659	2924	+	288
AT4G32570	4	15716231	15718858	2627	-	1257
AT4G32580	4	15719846	15720535	689	-	1
AT4G32590	4	15721323	15722908	1585	+	2347
AT4G32600	4	15723433	15726109	2676	+	1161
AT4G32605	4	15726270	15727947	1677	-	201
AT4G32610	4	15728142	15730356	2214	-	686
AT4G32620	4	15731507	15737272	5765	+	951
AT4G32630	4	15737967	15741741	3774	+	0
AT4G32640	4	15742000	15750862	8862	+	1361
AT4G32650	4	15751321	15754854	3533	-	48
AT4G32660	4	15756127	15759314	3187	+	884
AT4G32670	4	15759242	15762925	3683	-	208
AT4G32680	4	15763236	15765114	1878	-	265
AT4G32690	4	15765401	15767106	1705	+	242
AT4G32700	4	15767316	15779697	12381	+	321
AT4G32710	4	15781044	15783461	2417	+	258
AT4G32714	4	15784673	15785169	496	+	0
AT4G32717	4	15786336	15786841	505	+	0
AT4G32720	4	15787208	15789977	2769	+	819
AT4G32730	4	15790344	15795854	5510	+	559
AT4G32750	4	15795984	15798254	2270	-	164
AT4G32760	4	15799076	15804175	5099	+	1435
AT4G32765	4	15804548	15804630	82	+	0
AT4G32770	4	15804913	15807982	3069	+	2897
AT4G32780	4	15808851	15810907	2056	+	12
AT4G32785	4	15811065	15811872	807	+	13
AT4G32790	4	15812094	15814987	2893	+	205
AT4G32800	4	15819523	15820871	1348	+	179
AT4G32810	4	15828227	15831485	3258	+	1
AT4G32820	4	15831575	15841643	10068	-	573
AT4G32830	4	15842452	15844536	2084	+	174
AT4G32840	4	15844779	15848441	3662	-	272
AT4G32850	4	15849771	15854868	5097	+	1508
AT4G32860	4	15856610	15857359	749	-	3
AT4G32870	4	15862142	15862741	599	+	186
AT4G32880	4	15863451	15868625	5174	-	738
AT4G32890	4	15875469	15876762	1293	+	72
AT4G32900	4	15878721	15881041	2320	-	431
AT4G32910	4	15881255	15885416	4161	+	442
AT4G32915	4	15885519	15886980	1461	+	609
AT4G32920	4	15887269	15896006	8737	-	709
AT4G32924	4	15897197	15897428	231	-	0
AT4G32930	4	15898834	15900289	1455	+	728
AT4G32940	4	15900269	15903268	2999	-	2975
AT4G32950	4	15904443	15906010	1567	-	22
AT4G32960	4	15908617	15910180	1563	-	312
AT4G32970	4	15910344	15914337	3993	-	244
AT4G32980	4	15914721	15918044	3323	-	1962
AT4G32990	4	15920229	15922658	2429	+	27
AT4G33000	4	15924348	15926628	2280	+	956
AT4G33010	4	15926669	15931332	4663	-	122867
AT4G33020	4	15932602	15934267	1665	-	2
AT4G33030	4	15935415	15937807	2392	+	2285
AT4G33040	4	15940560	15941330	770	-	267
AT4G33050	4	15944321	15947026	2705	-	569
AT4G33060	4	15948489	15952223	3734	+	454
AT4G33070	4	15952288	15954771	2483	-	12
AT4G33080	4	15959961	15964710	4749	+	1209
AT4G33090	4	15965740	15970456	4716	-	2946
AT4G33100	4	15971173	15972489	1316	+	54
AT4G33110	4	15972322	15974797	2475	-	1660
AT4G33120	4	15975385	15978111	2726	-	9
AT4G33130	4	15978988	15980752	1764	-	52
AT4G33140	4	15981404	15984351	2947	+	236
AT4G33145	4	15984642	15985064	422	-	1
AT4G33150	4	15985188	15991538	6350	-	201
AT4G33160	4	15994088	15995655	1567	+	84
AT4G33170	4	15995700	15998673	2973	-	21
AT4G33180	4	16000176	16002269	2093	+	283
AT4G33200	4	16002474	16014968	12494	-	1143
AT4G33210	4	16015729	16020829	5100	-	1234
AT4G33220	4	16022438	16026360	3922	+	2187
AT4G33230	4	16026590	16028754	2164	-	0
AT4G33240	4	16029208	16038067	8859	-	1491
AT4G33250	4	16038866	16040711	1845	-	1722
AT4G33260	4	16041066	16043457	2391	-	154
AT4G33270	4	16044351	16046792	2441	-	368
AT4G33280	4	16047353	16049355	2002	-	9
AT4G33290	4	16049572	16050865	1293	+	0
AT4G33300	4	16050455	16056526	6071	-	996
AT4G33310	4	16056155	16056416	261	+	14
AT4G33320	4	16057037	16057916	879	-	0
AT4G33330	4	16059753	16063070	3317	-	16
AT4G33350	4	16064547	16066767	2220	-	1068
AT4G33355	4	16067001	16067820	819	+	0
AT4G33360	4	16067671	16069374	1703	-	413
AT4G33370	4	16069668	16071405	1737	-	4
AT4G33380	4	16071801	16074994	3193	+	1252
AT4G33390	4	16075090	16077706	2616	+	2
AT4G33400	4	16077916	16080521	2605	-	331
AT4G33410	4	16080875	16083237	2362	+	385
AT4G33420	4	16084827	16086296	1469	+	79
AT4G33430	4	16086310	16090777	4467	-	637
AT4G33440	4	16091939	16094958	3019	+	137
AT4G33450	4	16095391	16096610	1219	-	0
AT4G33460	4	16098069	16100266	2197	-	418
AT4G33465	4	16100757	16101231	474	+	0
AT4G33467	4	16101463	16102196	733	-	3
AT4G33470	4	16102594	16105493	2899	-	1406
AT4G33480	4	16105610	16108646	3036	-	502
AT4G33490	4	16108642	16110877	2235	-	347
AT4G33495	4	16110711	16112597	1886	-	175
AT4G33500	4	16112657	16116348	3691	-	2463
AT4G33510	4	16116446	16118797	2351	+	3519
AT4G33520	4	16118895	16126151	7256	+	1881
AT4G33530	4	16126230	16130459	4229	-	1383
AT4G33540	4	16130823	16133960	3137	+	321
AT4G33550	4	16134439	16135056	617	+	144
AT4G33560	4	16135399	16135914	515	+	79
AT4G33565	4	16136748	16138201	1453	+	188
AT4G33580	4	16138358	16141624	3266	+	1859
AT4G33585	4	16141534	16142310	776	-	2
AT4G33590	4	16142496	16144023	1527	-	0
AT4G33600	4	16144390	16145884	1494	-	0
AT4G33610	4	16146260	16146993	733	+	10
AT4G33620	4	16147691	16152853	5162	+	189
AT4G33625	4	16152925	16154722	1797	-	831
AT4G33630	4	16155502	16159578	4076	+	2080
AT4G33640	4	16159547	16160327	780	-	557
AT4G33650	4	16160823	16166968	6145	+	798
AT4G33660	4	16167285	16167951	666	-	479
AT4G33666	4	16169047	16169535	488	+	1568
AT4G33670	4	16169522	16171561	2039	-	1007
AT4G33680	4	16171693	16174686	2993	-	3547
AT4G33690	4	16174817	16176253	1436	+	137
AT4G33700	4	16176275	16179481	3206	-	254
AT4G33710	4	16181011	16181776	765	+	0
AT4G33720	4	16182751	16183533	782	+	0
AT4G33730	4	16185097	16185616	519	+	0
AT4G33740	4	16186829	16189007	2178	+	737
AT4G33760	4	16189143	16193269	4126	-	1015
AT4G33770	4	16193421	16196428	3007	-	359
AT4G33780	4	16201830	16203641	1811	-	482
AT4G33790	4	16204156	16207947	3791	-	15
AT4G33800	4	16210008	16211409	1401	-	2
AT4G33810	4	16213323	16215594	2271	-	120
AT4G33820	4	16217003	16219525	2522	-	1
AT4G33830	4	16220323	16222676	2353	-	0
AT4G33840	4	16223500	16226153	2653	-	0
AT4G33850	4	16227075	16229424	2349	-	0
AT4G33860	4	16229947	16232334	2387	-	0
AT4G33865	4	16233208	16234196	988	-	2333
AT4G33870	4	16234669	16236492	1823	-	2
AT4G33880	4	16239362	16241137	1775	-	0
AT4G33890	4	16249642	16251379	1737	+	314
AT4G33900	4	16251571	16252711	1140	-	0
AT4G33905	4	16253814	16255612	1798	-	12
AT4G33910	4	16256732	16258771	2039	-	408
AT4G33920	4	16260662	16262981	2319	+	399
AT4G33925	4	16263236	16264226	990	+	54
AT4G33930	4	16264388	16265420	1032	-	0
AT4G33940	4	16266022	16267786	1764	+	366
AT4G33945	4	16268049	16270743	2694	+	465
AT4G33950	4	16271972	16274810	2838	+	263
AT4G33960	4	16277365	16277779	414	+	30
AT4G33970	4	16279794	16281894	2100	-	1
AT4G33980	4	16282695	16285059	2364	-	0
AT4G33985	4	16288111	16288913	802	-	11
AT4G33990	4	16290140	16292612	2472	-	36
AT4G34000	4	16295429	16298255	2826	+	3164
AT4G34020	4	16298261	16300938	2677	-	675
AT4G34030	4	16301178	16304099	2921	+	1068
AT4G34035	4	16304123	16304196	73	+	0
AT4G34040	4	16304279	16308679	4400	-	911
AT4G34050	4	16310774	16312216	1442	+	3940
AT4G34060	4	16314002	16319426	5424	+	664
AT4G34065	4	16321339	16321489	150	+	1
AT4G34070	4	16323094	16325295	2201	-	262
AT4G34071	4	16325749	16326840	1091	+	3
AT4G34080	4	16326954	16328043	1089	+	0
AT4G34090	4	16326882	16330215	3333	-	2141
AT4G34100	4	16330466	16335074	4608	+	2373
AT4G34103	4	16335337	16335669	332	+	0
AT4G34110	4	16336386	16340098	3712	+	9724
AT4G34120	4	16341008	16343118	2110	+	2157
AT4G34131	4	16343056	16344818	1762	-	14
AT4G34135	4	16345280	16347133	1853	-	136
AT4G34138	4	16348105	16349982	1877	-	292
AT4G34140	4	16350779	16354264	3485	+	517
AT4G34150	4	16354945	16357293	2348	+	1221
AT4G34160	4	16357638	16359555	1917	+	641
AT4G34170	4	16368086	16369025	939	+	0
AT4G34180	4	16369356	16371430	2074	-	795
AT4G34190	4	16372387	16373626	1239	-	7951
AT4G34200	4	16373818	16376622	2804	-	2085
AT4G34210	4	16379002	16379461	459	+	0
AT4G34215	4	16379602	16381307	1705	-	583
AT4G34220	4	16381505	16384194	2689	-	2097
AT4G34230	4	16386718	16388722	2004	-	523
AT4G34240	4	16389619	16392824	3205	+	3334
AT4G34250	4	16394707	16396495	1788	+	378
AT4G34260	4	16398027	16401810	3783	+	1655
AT4G34265	4	16402279	16403823	1544	+	639
AT4G34270	4	16403843	16406240	2397	-	462
AT4G34272	4	16406425	16406542	117	-	0
AT4G34280	4	16406997	16410785	3788	+	467
AT4G34290	4	16410831	16412385	1554	+	1192
AT4G34300	4	16412772	16413714	942	+	0
AT4G34310	4	16414112	16419735	5623	+	456
AT4G34320	4	16422165	16423948	1783	+	27
AT4G34330	4	16424712	16425890	1178	+	0
AT4G34332	4	16424715	16425890	1175	-	0
AT4G34340	4	16426638	16428010	1372	-	121
AT4G34350	4	16428479	16431114	2635	-	14383
AT4G34360	4	16431940	16433958	2018	+	52
AT4G34370	4	16434279	16437322	3043	+	434
AT4G34380	4	16438523	16440641	2118	+	1
AT4G34390	4	16441178	16445005	3827	+	459
AT4G34400	4	16445207	16447773	2566	+	28
AT4G34410	4	16451875	16453260	1385	+	0
AT4G34412	4	16452959	16454633	1674	-	91
AT4G34415	4	16454696	16454769	73	-	0
AT4G34419	4	16456518	16457225	707	+	0
AT4G34420	4	16458067	16460652	2585	+	22
AT4G34430	4	16460919	16465323	4404	+	601
AT4G34440	4	16465827	16468956	3129	+	0
AT4G34450	4	16471834	16477021	5187	+	4894
AT4G34460	4	16477105	16479528	2423	-	1197
AT4G34470	4	16480021	16480480	459	-	0
AT4G34480	4	16480933	16483995	3062	-	1441
AT4G34490	4	16484529	16487417	2888	-	1671
AT4G34500	4	16487753	16490954	3201	-	250
AT4G34510	4	16491795	16493418	1623	+	28
AT4G34520	4	16494204	16495842	1638	+	0
AT4G34530	4	16498390	16500174	1784	+	0
AT4G34540	4	16498390	16502174	3784	+	236
AT4G34550	4	16503200	16504040	840	+	158
AT4G34555	4	16504229	16505472	1243	-	333
AT4G34560	4	16507634	16508754	1120	+	414
AT4G34570	4	16511000	16514343	3343	-	285
AT4G34580	4	16515326	16519534	4208	+	32
AT4G34588	4	16521860	16523230	1370	+	0
AT4G34590	4	16521860	16523230	1370	+	0
AT4G34600	4	16529224	16530199	975	+	72
AT4G34610	4	16530345	16533034	2689	-	919
AT4G34620	4	16534854	16536171	1317	-	11239
AT4G34630	4	16536864	16537746	882	-	1023
AT4G34640	4	16538281	16541926	3645	+	1448
AT4G34650	4	16542376	16545121	2745	+	242
AT4G34660	4	16545196	16548453	3257	-	448
AT4G34670	4	16548617	16550453	1836	+	4648
AT4G34680	4	16553389	16554740	1351	+	237
AT4G34690	4	16555462	16556097	635	-	0
AT4G34695	4	16556622	16556695	73	+	0
AT4G34700	4	16556824	16558846	2022	+	2094
AT4G34710	4	16560061	16562969	2908	-	5144
AT4G34720	4	16567823	16569295	1472	-	3803
AT4G34730	4	16569395	16573680	4285	-	1528
AT4G34740	4	16574576	16576671	2095	-	1133
AT4G34750	4	16577403	16578452	1049	+	144
AT4G34760	4	16582182	16582879	697	-	620
AT4G34770	4	16591228	16591892	664	+	37
AT4G34780	4	16592396	16592717	321	-	0
AT4G34790	4	16594468	16595153	685	+	21
AT4G34800	4	16596859	16597144	285	+	12
AT4G34810	4	16599103	16599421	318	+	3
AT4G34830	4	16599604	16606027	6423	-	3833
AT4G34840	4	16606273	16608024	1751	+	172
AT4G34850	4	16608312	16609829	1517	+	11
AT4G34860	4	16609745	16612907	3162	-	100
AT4G34870	4	16614326	16615313	987	+	8588
AT4G34880	4	16615548	16617424	1876	+	5
AT4G34881	4	16617622	16618506	884	+	1263
AT4G34890	4	16618572	16625057	6485	-	991
AT4G34900	4	16625554	16631327	5773	-	511
AT4G34910	4	16631532	16635149	3617	+	274
AT4G34920	4	16635683	16636975	1292	+	1096
AT4G34930	4	16637321	16638872	1551	+	6
AT4G34940	4	16639597	16641950	2353	+	0
AT4G34950	4	16642315	16644818	2503	-	341
AT4G34960	4	16648604	16650897	2293	+	314
AT4G34970	4	16653703	16654871	1168	+	9
AT4G34975	4	16655285	16655359	74	+	0
AT4G34980	4	16656690	16659339	2649	-	2465
AT4G34990	4	16661328	16662367	1039	-	74
AT4G35000	4	16664821	16667718	2897	-	5121
AT4G35010	4	16667929	16672092	4163	-	2
AT4G35020	4	16672191	16674771	2580	+	413
AT4G35025	4	16675527	16675749	222	-	0
AT4G35030	4	16675701	16678206	2505	+	110
AT4G35040	4	16680322	16682093	1771	+	484
AT4G35050	4	16682579	16684848	2269	-	164
AT4G35060	4	16685719	16686703	984	-	82
AT4G35070	4	16694169	16695698	1529	+	91
AT4G35080	4	16698333	16700321	1988	+	579
AT4G35090	4	16700341	16703325	2984	-	50673
AT4G35100	4	16708551	16710289	1738	+	9674
AT4G35110	4	16712461	16714953	2492	-	181
AT4G35120	4	16716805	16718017	1212	+	0
AT4G35130	4	16721083	16723498	2415	-	36
AT4G35140	4	16723713	16726636	2923	-	347
AT4G35150	4	16726947	16728531	1584	-	0
AT4G35160	4	16730759	16732811	2052	-	17
AT4G35165	4	16735122	16735883	761	+	0
AT4G35170	4	16736756	16738437	1681	+	8
AT4G35180	4	16738338	16740465	2127	-	7
AT4G35190	4	16746598	16748266	1668	+	9
AT4G35200	4	16749141	16749903	762	-	0
AT4G35210	4	16751223	16752239	1016	+	0
AT4G35220	4	16752570	16754305	1735	+	592
AT4G35230	4	16755111	16758091	2980	-	891
AT4G35240	4	16760948	16767087	6139	-	502
AT4G35250	4	16771170	16773364	2194	-	8192
AT4G35260	4	16774194	16776325	2131	-	1375
AT4G35263	4	16776629	16776797	168	-	0
AT4G35270	4	16777337	16780824	3487	-	880
AT4G35280	4	16787428	16788283	855	-	0
AT4G35290	4	16789548	16793685	4137	+	513
AT4G35295	4	16795332	16796223	891	+	11
AT4G35300	4	16796255	16799777	3522	-	1458
AT4G35310	4	16801986	16804995	3009	+	1491
AT4G35320	4	16805868	16806655	787	-	563
AT4G35335	4	16807264	16810216	2952	+	455
AT4G35350	4	16810481	16812009	1528	+	559
AT4G35360	4	16812115	16814745	2630	-	778
AT4G35370	4	16815137	16817544	2407	+	1
AT4G35380	4	16819882	16826061	6179	+	7
AT4G35390	4	16829325	16830692	1367	+	5
AT4G35400	4	16831152	16831383	231	+	0
AT4G35410	4	16832480	16834009	1529	+	211
AT4G35420	4	16833932	16835619	1687	-	226
AT4G35430	4	16835988	16836421	433	-	0
AT4G35440	4	16835985	16839375	3390	-	691
AT4G35450	4	16839531	16842077	2546	+	10345
AT4G35460	4	16842187	16844082	1895	+	733
AT4G35470	4	16846300	16849150	2850	+	761
AT4G35480	4	16852073	16852947	874	-	27
AT4G35490	4	16855901	16856674	773	+	667
AT4G35500	4	16857298	16859603	2305	+	49
AT4G35510	4	16860451	16862372	1921	-	218
AT4G35519	4	16865247	16865370	123	-	0
AT4G35520	4	16865487	16871764	6277	+	24
AT4G35530	4	16871733	16873652	1919	-	158
AT4G35540	4	16873834	16875598	1764	+	91
AT4G35550	4	16875520	16877306	1786	-	314
AT4G35560	4	16881361	16887083	5722	+	402
AT4G35570	4	16887164	16888356	1192	-	759
AT4G35580	4	16888404	16890877	2473	-	633
AT4G35589	4	16892765	16892903	138	+	0
AT4G35590	4	16892908	16894865	1957	+	7
AT4G35600	4	16896201	16898876	2675	+	285
AT4G35610	4	16899409	16900225	816	-	0
AT4G35620	4	16901620	16903920	2300	+	145
AT4G35630	4	16904058	16905722	1664	+	573
AT4G35640	4	16905578	16908357	2779	-	51
AT4G35650	4	16908518	16910190	1672	+	1
AT4G35655	4	16910754	16910961	207	+	0
AT4G35660	4	16912508	16913704	1196	+	0
AT4G35670	4	16914995	16917201	2206	+	0
AT4G35680	4	16917748	16920008	2260	+	11
AT4G35690	4	16921802	16922963	1161	+	0
AT4G35700	4	16923318	16924320	1002	+	0
AT4G35710	4	16925300	16926152	852	+	1
AT4G35720	4	16927971	16929170	1199	+	3
AT4G35725	4	16929942	16930560	618	-	0
AT4G35730	4	16931038	16933356	2318	+	200
AT4G35731	4	16933546	16933949	403	+	0
AT4G35733	4	16934235	16935502	1267	+	0
AT4G35740	4	16936119	16940332	4213	+	283
AT4G35750	4	16940506	16941862	1356	-	1566
AT4G35760	4	16942320	16944677	2357	-	1775
AT4G35770	4	16944940	16946192	1252	+	208
AT4G35780	4	16946520	16950594	4074	-	816
AT4G35783	4	16952405	16952800	395	+	29
AT4G35785	4	16952962	16955277	2315	-	612
AT4G35790	4	16955517	16960170	4653	-	1425
AT4G35800	4	16960656	16968128	7472	-	2768
AT4G35810	4	16968920	16970358	1438	+	35
AT4G35820	4	16971220	16972429	1209	+	0
AT4G35830	4	16972597	16978057	5460	-	10293
AT4G35837	4	16980326	16980491	165	-	0
AT4G35840	4	16980960	16982365	1405	+	192
AT4G35850	4	16983524	16986967	3443	+	539
AT4G35860	4	16986839	16989047	2208	-	677
AT4G35870	4	16990172	16992888	2716	+	271
AT4G35880	4	16993338	16995820	2482	+	364
AT4G35890	4	16997138	17000833	3695	+	1140
AT4G35900	4	17004594	17006287	1693	+	94
AT4G35905	4	17007027	17008154	1127	-	180
AT4G35910	4	17008566	17011509	2943	-	244
AT4G35920	4	17011787	17015256	3469	-	1329
AT4G35930	4	17018928	17021060	2132	+	149
AT4G35940	4	17021571	17023764	2193	+	138
AT4G35950	4	17023836	17025863	2027	-	832
AT4G35970	4	17028605	17030293	1688	+	69
AT4G35980	4	17030571	17031696	1125	-	256
AT4G35985	4	17032267	17033862	1595	-	60
AT4G35987	4	17035027	17036963	1936	+	157
AT4G36000	4	17037582	17038713	1131	-	4
AT4G36010	4	17039062	17041141	2079	-	104
AT4G36020	4	17043111	17044396	1285	-	450
AT4G36030	4	17044944	17047315	2371	-	1
AT4G36032	4	17045091	17047297	2206	+	0
AT4G36040	4	17049170	17050274	1104	-	2078
AT4G36050	4	17051981	17055059	3078	-	173
AT4G36052	4	17052346	17053499	1153	+	0
AT4G36060	4	17055320	17056704	1384	+	40
AT4G36070	4	17056722	17059627	2905	-	0
AT4G36080	4	17059823	17078007	18184	-	1031
AT4G36090	4	17078310	17080786	2476	-	189
AT4G36100	4	17082578	17083343	765	+	1
AT4G36105	4	17083884	17085120	1236	+	39
AT4G36110	4	17089948	17090825	877	+	34
AT4G36120	4	17093087	17096573	3486	-	213
AT4G36130	4	17097564	17098879	1315	+	2076
AT4G36140	4	17098955	17104479	5524	-	451
AT4G36150	4	17104718	17108711	3993	+	169
AT4G36160	4	17110746	17114141	3395	-	32
AT4G36170	4	17113871	17119834	5963	+	0
AT4G36180	4	17120084	17123841	3757	-	318
AT4G36190	4	17123965	17127018	3053	+	1249
AT4G36195	4	17126931	17129946	3015	+	1442
AT4G36197	4	17130051	17130124	73	+	0
AT4G36210	4	17130245	17134656	4411	+	1336
AT4G36220	4	17137343	17139635	2292	-	3995
AT4G36230	4	17145585	17146251	666	+	59
AT4G36240	4	17147195	17148221	1026	-	303
AT4G36245	4	17149470	17149542	72	+	0
AT4G36250	4	17150868	17153578	2710	+	2722
AT4G36260	4	17155555	17157245	1690	-	36
AT4G36268	4	17160535	17160706	171	+	0
AT4G36270	4	17161023	17165241	4218	-	161
AT4G36280	4	17165330	17169375	4045	-	187
AT4G36290	4	17169463	17173215	3752	-	329
AT4G36350	4	17173736	17175857	2121	-	3
AT4G36360	4	17176341	17181261	4920	-	3944
AT4G36370	4	17187249	17187610	361	+	0
AT4G36380	4	17187527	17192317	4790	-	178
AT4G36390	4	17194587	17197131	2544	-	2475
AT4G36400	4	17197211	17200921	3710	+	432
AT4G36410	4	17201921	17202988	1067	+	203
AT4G36420	4	17203030	17204312	1282	-	375
AT4G36430	4	17204477	17205966	1489	-	32
AT4G36440	4	17206857	17210007	3150	-	492
AT4G36450	4	17210244	17211413	1169	-	7
AT4G36460	4	17212661	17213099	438	-	0
AT4G36470	4	17215026	17216530	1504	-	157
AT4G36480	4	17218131	17221477	3346	+	599
AT4G36490	4	17221995	17225016	3021	+	0
AT4G36500	4	17225911	17226610	699	-	355
AT4G36510	4	17228776	17229451	675	+	0
AT4G36515	4	17229553	17230296	743	-	137
AT4G36520	4	17230588	17235518	4930	-	785
AT4G36530	4	17239957	17241937	1980	-	3463
AT4G36540	4	17243582	17245296	1714	+	1560
AT4G36550	4	17245399	17248461	3062	-	288
AT4G36560	4	17252656	17252989	333	+	0
AT4G36570	4	17254659	17255716	1057	+	78
AT4G36580	4	17257944	17260775	2831	+	78
AT4G36590	4	17260936	17262227	1291	-	5
AT4G36600	4	17263665	17265100	1435	+	2
AT4G36610	4	17265389	17267314	1925	-	6
AT4G36620	4	17268905	17269743	838	-	20
AT4G36630	4	17271818	17276616	4798	-	684
AT4G36635	4	17276700	17276774	74	-	0
AT4G36640	4	17276935	17279201	2266	-	378
AT4G36648	4	17280527	17282730	2203	-	1388
AT4G36650	4	17283131	17285599	2468	-	206
AT4G36660	4	17285731	17287429	1698	-	574
AT4G36670	4	17287498	17289590	2092	-	49
AT4G36680	4	17292228	17293822	1594	-	201
AT4G36690	4	17293946	17297761	3815	-	2730
AT4G36700	4	17298199	17300367	2168	-	0
AT4G36710	4	17305757	17307643	1886	+	332
AT4G36720	4	17307768	17309867	2099	+	141
AT4G36730	4	17309611	17312488	2877	-	1251
AT4G36740	4	17314558	17316374	1816	-	2
AT4G36750	4	17324570	17326457	1887	+	571
AT4G36760	4	17326616	17330208	3592	+	725
AT4G36770	4	17330145	17331624	1479	-	70
AT4G36780	4	17332516	17334349	1833	-	654
AT4G36790	4	17336171	17338371	2200	+	160
AT4G36791	4	17338870	17339077	207	-	9
AT4G36800	4	17340949	17342759	1810	-	2819
AT4G36808	4	17343161	17343824	663	-	0
AT4G36810	4	17343373	17344865	1492	+	2783
AT4G36820	4	17346804	17347994	1190	+	5
AT4G36830	4	17349435	17350480	1045	+	51
AT4G36840	4	17351352	17352945	1593	+	167
AT4G36850	4	17353290	17355891	2601	-	162
AT4G36860	4	17358437	17361978	3541	-	443
AT4G36870	4	17368964	17373930	4966	+	665
AT4G36880	4	17374457	17376225	1768	-	19
AT4G36890	4	17379174	17381780	2606	-	590
AT4G36900	4	17388813	17389837	1024	+	157
AT4G36910	4	17390625	17393339	2714	-	401
AT4G36920	4	17400609	17403469	2860	+	373
AT4G36925	4	17403979	17404450	471	+	0
AT4G36930	4	17414126	17416294	2168	+	30
AT4G36940	4	17416854	17420252	3398	+	626
AT4G36945	4	17419917	17422130	2213	-	132
AT4G36950	4	17422571	17423901	1330	-	1
AT4G36960	4	17426920	17429765	2845	+	753
AT4G36970	4	17429743	17431685	1942	-	249
AT4G36980	4	17433600	17437069	3469	-	2599
AT4G36988	4	17440176	17442151	1975	+	0
AT4G36990	4	17440176	17442151	1975	+	0
AT4G37000	4	17442611	17443855	1244	+	1991
AT4G37010	4	17444308	17445615	1307	+	0
AT4G37020	4	17445696	17447400	1704	+	214
AT4G37022	4	17447712	17448244	532	+	6
AT4G37030	4	17451927	17454760	2833	+	17
AT4G37040	4	17455138	17457357	2219	+	1714
AT4G37050	4	17457134	17459770	2636	-	1
AT4G37060	4	17461365	17463734	2369	-	0
AT4G37070	4	17464784	17467109	2325	-	2
AT4G37080	4	17473119	17476952	3833	+	1430
AT4G37090	4	17477231	17478729	1498	+	224
AT4G37095	4	17478884	17479107	223	-	17
AT4G37100	4	17479172	17481863	2691	-	374
AT4G37110	4	17484124	17486276	2152	-	302
AT4G37120	4	17486646	17489294	2648	+	1199
AT4G37130	4	17489466	17492010	2544	+	315
AT4G37140	4	17492114	17492728	614	-	5
AT4G37150	4	17492877	17494109	1232	-	67
AT4G37160	4	17494704	17497124	2420	-	0
AT4G37170	4	17498579	17500655	2076	-	10
AT4G37175	4	17500806	17500878	72	-	0
AT4G37180	4	17504563	17506367	1804	+	997
AT4G37190	4	17507049	17509747	2698	+	230
AT4G37200	4	17509620	17511364	1744	-	2372
AT4G37210	4	17512258	17514625	2367	+	482
AT4G37220	4	17515079	17516162	1083	+	10
AT4G37225	4	17516186	17516857	671	-	19
AT4G37230	4	17516423	17517587	1164	+	6
AT4G37235	4	17517984	17519785	1801	+	5
AT4G37240	4	17524460	17525159	699	+	61
AT4G37250	4	17527649	17530506	2857	-	225
AT4G37260	4	17540489	17541799	1310	+	217
AT4G37270	4	17541770	17546484	4714	-	2143
AT4G37280	4	17546583	17549424	2841	-	519
AT4G37290	4	17549683	17550257	574	-	0
AT4G37295	4	17553559	17554105	546	+	1
AT4G37300	4	17554640	17555861	1221	+	2597
AT4G37310	4	17555926	17558943	3017	-	1152
AT4G37320	4	17559579	17561727	2148	-	195
AT4G37330	4	17562344	17564596	2252	-	922
AT4G37340	4	17564849	17566787	1938	-	0
AT4G37360	4	17567123	17568858	1735	-	0
AT4G37370	4	17569827	17571704	1877	-	42
AT4G37380	4	17572039	17573938	1899	-	135
AT4G37390	4	17579656	17582022	2366	+	38
AT4G37400	4	17584050	17586360	2310	+	157
AT4G37409	4	17590768	17592911	2143	-	0
AT4G37410	4	17590771	17592920	2149	+	5
AT4G37420	4	17593122	17594889	1767	+	0
AT4G37430	4	17597109	17598958	1849	+	40
AT4G37432	4	17597178	17598690	1512	-	1
AT4G37440	4	17601221	17604086	2865	+	843
AT4G37445	4	17604093	17604933	840	-	21
AT4G37450	4	17605757	17606755	998	-	478
AT4G37460	4	17608377	17615776	7399	-	2343
AT4G37470	4	17616658	17618473	1815	-	1339
AT4G37480	4	17619260	17621596	2336	+	313
AT4G37483	4	17621592	17621820	228	-	48
AT4G37490	4	17621885	17624285	2400	-	111
AT4G37500	4	17625387	17625915	528	+	0
AT4G37510	4	17626103	17628947	2844	-	2856
AT4G37520	4	17631561	17633249	1688	+	219
AT4G37530	4	17634783	17636288	1505	+	124
AT4G37540	4	17639532	17640665	1133	-	206
AT4G37550	4	17643569	17645830	2261	+	954
AT4G37553	4	17644897	17649055	4158	-	8
AT4G37560	4	17646407	17648684	2277	+	825
AT4G37570	4	17655172	17656557	1385	-	0
AT4G37580	4	17658611	17660878	2267	+	83
AT4G37590	4	17662841	17666428	3587	-	1557
AT4G37608	4	17668950	17670631	1681	+	24
AT4G37610	4	17670480	17672353	1873	-	152
AT4G37620	4	17674190	17674589	399	-	3
AT4G37630	4	17679278	17681202	1924	+	118
AT4G37640	4	17682976	17686941	3965	-	841
AT4G37650	4	17691785	17693760	1975	+	338
AT4G37660	4	17695495	17696270	775	+	163
AT4G37670	4	17696058	17698843	2785	-	150
AT4G37680	4	17700633	17702952	2319	+	412
AT4G37682	4	17703380	17704510	1130	+	45
AT4G37685	4	17705048	17706089	1041	+	32
AT4G37690	4	17707893	17709847	1954	+	14
AT4G37700	4	17710271	17710873	602	-	2
AT4G37705	4	17712563	17716691	4128	+	0
AT4G37710	4	17718127	17718742	615	+	2
AT4G37720	4	17718960	17719318	358	-	0
AT4G37730	4	17723665	17724915	1250	+	21
AT4G37740	4	17725336	17727730	2394	-	224
AT4G37750	4	17739513	17742401	2888	+	590
AT4G37760	4	17743886	17746678	2792	+	3365
AT4G37770	4	17752083	17754157	2074	+	17
AT4G37780	4	17758242	17759557	1315	-	1
AT4G37790	4	17768041	17769606	1565	+	758
AT4G37800	4	17775473	17777397	1924	-	3272
AT4G37810	4	17780969	17781745	776	+	82
AT4G37820	4	17785254	17787471	2217	+	691
AT4G37830	4	17787478	17788834	1356	-	2447
AT4G37840	4	17790146	17792198	2052	-	0
AT4G37850	4	17796092	17797900	1808	-	0
AT4G37860	4	17800325	17801907	1582	-	0
AT4G37870	4	17802693	17806539	3846	-	3246
AT4G37880	4	17809680	17811590	1910	+	660
AT4G37890	4	17812735	17815095	2360	-	31
AT4G37895	4	17813544	17815178	1634	+	0
AT4G37900	4	17821736	17824627	2891	-	35
AT4G37910	4	17825079	17828180	3101	-	1802
AT4G37920	4	17828432	17830465	2033	-	729
AT4G37925	4	17830561	17831554	993	-	3340
AT4G37930	4	17831730	17834927	3197	-	99360
AT4G37940	4	17835571	17838621	3050	-	0
AT4G37950	4	17844429	17849274	4845	+	0
AT4G37970	4	17849647	17852246	2599	+	70
AT4G37980	4	17852440	17854500	2060	+	3067
AT4G37990	4	17855875	17857639	1764	+	0
AT4G38000	4	17858350	17859325	975	+	3
AT4G38010	4	17859581	17861261	1680	-	15
AT4G38020	4	17861522	17863060	1538	+	314
AT4G38030	4	17863072	17866730	3658	-	0
AT4G38040	4	17867437	17869302	1865	+	436
AT4G38050	4	17869378	17872482	3104	-	105
AT4G38052	4	17872739	17872853	114	-	0
AT4G38060	4	17873484	17874804	1320	-	364
AT4G38070	4	17876534	17882569	6035	+	126
AT4G38080	4	17882963	17883612	649	+	35
AT4G38090	4	17883616	17884821	1205	-	416
AT4G38092	4	17885339	17886890	1551	+	13
AT4G38100	4	17886868	17888204	1336	-	498
AT4G38120	4	17888518	17896107	7589	-	745
AT4G38130	4	17896291	17899491	3200	-	1676
AT4G38140	4	17899867	17900305	438	-	0
AT4G38150	4	17900608	17902160	1552	-	107
AT4G38160	4	17902265	17904300	2035	+	1168
AT4G38170	4	17904557	17906821	2264	+	183
AT4G38180	4	17906513	17909677	3164	-	112
AT4G38190	4	17909918	17913641	3723	-	2
AT4G38200	4	17915292	17922732	7440	+	916
AT4G38210	4	17922755	17923973	1218	-	29
AT4G38215	4	17923331	17924252	921	+	0
AT4G38220	4	17925179	17927097	1918	+	1650
AT4G38225	4	17927197	17928901	1704	+	1656
AT4G38230	4	17928676	17931511	2835	-	142
AT4G38240	4	17931569	17935325	3756	-	483
AT4G38250	4	17935401	17937068	1667	+	1219
AT4G38260	4	17936920	17938728	1808	-	305
AT4G38270	4	17938371	17941558	3187	+	461
AT4G38280	4	17941795	17943363	1568	+	161
AT4G38290	4	17942870	17944047	1177	+	7
AT4G38300	4	17944555	17945491	936	-	59
AT4G38310	4	17948481	17948844	363	+	0
AT4G38320	4	17948691	17950522	1831	+	112
AT4G38330	4	17951469	17952763	1294	+	53
AT4G38340	4	17954709	17957828	3119	+	66
AT4G38350	4	17958176	17966962	8786	-	2221
AT4G38360	4	17967106	17969958	2852	+	789
AT4G38370	4	17969906	17971295	1389	-	248
AT4G38380	4	17971854	17975100	3246	-	81
AT4G38390	4	17975775	17978380	2605	+	0
AT4G38400	4	17978442	17979740	1298	-	156
AT4G38401	4	17979762	17979885	123	-	0
AT4G38405	4	17980416	17980557	141	-	0
AT4G38410	4	17980939	17981719	780	+	1
AT4G38420	4	17982773	17985372	2599	+	442
AT4G38430	4	17986465	17988807	2342	+	2150
AT4G38440	4	17989066	17994723	5657	+	251
AT4G38460	4	17994780	17996205	1425	+	1375
AT4G38470	4	17999431	18003681	4250	+	735
AT4G38480	4	18003915	18006140	2225	+	84
AT4G38490	4	18006287	18007372	1085	+	425
AT4G38495	4	18007356	18008071	715	-	90
AT4G38500	4	18007755	18010903	3148	+	526
AT4G38510	4	18010811	18015173	4362	-	2447
AT4G38520	4	18015735	18018306	2571	-	1050
AT4G38530	4	18020673	18022985	2312	+	48
AT4G38540	4	18023120	18025027	1907	+	6
AT4G38545	4	18022982	18025287	2305	-	26
AT4G38550	4	18025634	18028800	3166	+	55
AT4G38552	4	18025619	18028492	2873	-	21
AT4G38560	4	18029195	18031333	2138	+	44
AT4G38570	4	18031278	18033741	2463	-	249
AT4G38580	4	18034430	18035889	1459	+	182
AT4G38590	4	18036091	18040928	4837	+	1
AT4G38600	4	18041030	18049292	8262	-	3325
AT4G38620	4	18053550	18054999	1449	+	345
AT4G38630	4	18057129	18059540	2411	-	1777
AT4G38640	4	18059652	18062289	2637	-	519
AT4G38650	4	18063165	18065849	2684	+	46
AT4G38660	4	18066176	18068205	2029	-	796
AT4G38670	4	18069558	18071355	1797	-	136
AT4G38680	4	18071883	18073182	1299	-	2660
AT4G38690	4	18074474	18075765	1291	-	607
AT4G38700	4	18076458	18077177	719	-	82
AT4G38710	4	18077789	18080083	2294	-	1534
AT4G38730	4	18080232	18082537	2305	-	306
AT4G38740	4	18083394	18084251	857	-	7493
AT4G38760	4	18084907	18096166	11259	-	1576
AT4G38770	4	18096808	18098565	1757	-	14925
AT4G38780	4	18101295	18111029	9734	-	52
AT4G38781	4	18111040	18111193	153	-	0
AT4G38790	4	18111360	18113206	1846	+	339
AT4G38800	4	18113160	18115133	1973	-	2080
AT4G38810	4	18115282	18119077	3795	-	1619
AT4G38820	4	18121542	18121975	433	-	0
AT4G38825	4	18121525	18122010	485	+	1
AT4G38830	4	18122325	18124943	2618	+	3
AT4G38840	4	18124977	18125559	582	-	1469
AT4G38850	4	18126170	18126680	510	+	122
AT4G38860	4	18130267	18131060	793	+	1673
AT4G38870	4	18132582	18133863	1281	-	1
AT4G38880	4	18134115	18135714	1599	+	0
AT4G38890	4	18135799	18139206	3407	-	864
AT4G38900	4	18139294	18141983	2689	-	590
AT4G38910	4	18145238	18146928	1690	-	139
AT4G38920	4	18147210	18149267	2057	+	2837
AT4G38930	4	18149533	18151793	2260	+	437
AT4G38932	4	18151686	18152569	883	-	423
AT4G38940	4	18152686	18154114	1428	+	78
AT4G38950	4	18154394	18159936	5542	-	3231
AT4G38960	4	18161087	18163321	2234	+	492
AT4G38970	4	18163495	18165762	2267	-	136131
AT4G38980	4	18166708	18168192	1484	-	202
AT4G38990	4	18169174	18170949	1775	-	0
AT4G39000	4	18171721	18173797	2076	-	0
AT4G39010	4	18175901	18179183	3282	-	54
AT4G39020	4	18182314	18184340	2026	+	0
AT4G39030	4	18185666	18189224	3558	+	87
AT4G39040	4	18189011	18190556	1545	-	2347
AT4G39050	4	18193134	18200697	7563	+	1372
AT4G39060	4	18202606	18204634	2028	+	0
AT4G39070	4	18204854	18206509	1655	-	6
AT4G39080	4	18209398	18215056	5658	+	4713
AT4G39090	4	18215555	18217482	1927	-	4056
AT4G39100	4	18217938	18220290	2352	-	1008
AT4G39110	4	18222482	18225119	2637	-	52
AT4G39120	4	18220588	18227988	7400	-	422
AT4G39130	4	18228117	18228852	735	-	0
AT4G39140	4	18229330	18232071	2741	-	423
AT4G39150	4	18233484	18236064	2580	-	1395
AT4G39160	4	18236354	18240478	4124	+	260
AT4G39170	4	18240604	18243795	3191	+	1102
AT4G39180	4	18243725	18248805	5080	-	210
AT4G39190	4	18251810	18253073	1263	-	135
AT4G39195	4	18254988	18255024	36	-	0
AT4G39200	4	18257335	18258680	1345	+	4279
AT4G39210	4	18259608	18263417	3809	+	1276
AT4G39220	4	18263616	18265771	2155	+	325
AT4G39230	4	18265884	18267829	1945	-	114
AT4G39235	4	18268048	18269212	1164	+	170
AT4G39240	4	18269149	18270787	1638	-	455
AT4G39250	4	18271456	18271857	401	-	0
AT4G39260	4	18273898	18275079	1181	-	2177
AT4G39270	4	18276504	18279848	3344	+	465
AT4G39280	4	18280097	18284930	4833	-	1043
AT4G39290	4	18285204	18286302	1098	-	0
AT4G39300	4	18286744	18288345	1601	+	175
AT4G39320	4	18289054	18289857	803	+	17
AT4G39330	4	18291217	18293383	2166	+	6186
AT4G39340	4	18293128	18293512	384	-	8
AT4G39345	4	18293779	18293851	72	+	0
AT4G39350	4	18296796	18302192	5396	+	4015
AT4G39360	4	18302889	18303619	730	+	1
AT4G39361	4	18304890	18305010	120	+	21
AT4G39363	4	18305255	18305375	120	+	37
AT4G39364	4	18305414	18305536	122	+	37
AT4G39366	4	18305584	18305704	120	+	46
AT4G39370	4	18306134	18308842	2708	+	175
AT4G39380	4	18309153	18312724	3571	-	91
AT4G39390	4	18315574	18318142	2568	+	206
AT4G39400	4	18324660	18328826	4166	+	3701
AT4G39403	4	18329093	18329699	606	-	2
AT4G39404	4	18329733	18330012	279	-	1
AT4G39410	4	18332877	18334789	1912	-	32
AT4G39420	4	18339286	18355093	15807	+	1320
AT4G39460	4	18355782	18358980	3198	-	1484
AT4G39470	4	18359372	18361170	1798	-	277
AT4G39480	4	18362257	18364209	1952	+	11
AT4G39490	4	18365048	18366888	1840	+	0
AT4G39500	4	18366949	18368359	1410	-	2
AT4G39510	4	18368802	18370652	1850	-	776
AT4G39520	4	18370967	18374204	3237	-	1125
AT4G39530	4	18374735	18377240	2505	-	26
AT4G39540	4	18378224	18380417	2193	+	1123
AT4G39550	4	18380525	18381905	1380	-	61
AT4G39560	4	18382290	18383817	1527	-	163
AT4G39570	4	18384099	18385544	1445	-	159
AT4G39580	4	18385683	18386811	1128	-	6
AT4G39590	4	18387330	18388732	1402	-	0
AT4G39600	4	18389435	18390539	1104	-	42
AT4G39610	4	18393569	18394745	1176	-	0
AT4G39615	4	18395027	18395099	72	+	0
AT4G39620	4	18395293	18397578	2285	+	528
AT4G39630	4	18397590	18399387	1797	-	71
AT4G39640	4	18399954	18402963	3009	+	766
AT4G39650	4	18403559	18406025	2466	+	0
AT4G39660	4	18406764	18409564	2800	+	920
AT4G39670	4	18410171	18411000	829	+	6
AT4G39672	4	18411264	18411338	74	+	0
AT4G39675	4	18413774	18414240	466	+	3
AT4G39680	4	18414305	18417530	3225	-	3002
AT4G39690	4	18417655	18421971	4316	+	773
AT4G39700	4	18424264	18424906	642	+	2
AT4G39710	4	18427038	18428412	1374	-	3452
AT4G39720	4	18429891	18430950	1059	-	29
AT4G39730	4	18432898	18433695	797	+	2633
AT4G39740	4	18435292	18437136	1844	-	136
AT4G39745	4	18437805	18438665	860	+	0
AT4G39750	4	18439137	18439578	441	+	0
AT4G39753	4	18440111	18441445	1334	+	0
AT4G39756	4	18441755	18443000	1245	+	0
AT4G39760	4	18443678	18444788	1110	+	0
AT4G39770	4	18448979	18451293	2314	-	331
AT4G39780	4	18457956	18459180	1224	-	325
AT4G39790	4	18462189	18464824	2635	-	42
AT4G39795	4	18466564	18467449	885	+	46
AT4G39800	4	18469347	18471967	2620	-	12058
AT4G39810	4	18474607	18475735	1128	-	34
AT4G39820	4	18476006	18477943	1937	-	333
AT4G39830	4	18478928	18481343	2415	+	18
AT4G39838	4	18484874	18486365	1491	-	0
AT4G39840	4	18484900	18486814	1914	+	111
AT4G39850	4	18488436	18497136	8700	+	1564
AT4G39860	4	18499752	18501642	1890	+	457
AT4G39865	4	18501711	18501784	73	-	0
AT4G39870	4	18501876	18504466	2590	+	345
AT4G39880	4	18504536	18505338	802	+	619
AT4G39890	4	18505961	18507586	1625	+	38
AT4G39900	4	18508369	18510553	2184	-	783
AT4G39910	4	18511574	18514338	2764	-	762
AT4G39917	4	18515212	18515602	390	+	0
AT4G39920	4	18515748	18517274	1526	+	172
AT4G39925	4	18517408	18518052	644	-	32
AT4G39930	4	18518342	18518983	641	-	28
AT4G39940	4	18519716	18521568	1852	+	2850
AT4G39950	4	18525245	18527579	2334	+	1052
AT4G39952	4	18527679	18530007	2328	+	27
AT4G39955	4	18530542	18532259	1717	+	43
AT4G39960	4	18533754	18536618	2864	+	2075
AT4G39970	4	18536537	18538506	1969	-	3822
AT4G39980	4	18539574	18542093	2519	+	1390
AT4G39985	4	18542170	18542244	74	+	0
AT4G39986	4	18542348	18542465	117	-	0
AT4G39990	4	18542550	18543978	1428	+	574
AT4G40000	4	18543892	18547523	3631	-	64
AT4G40010	4	18548703	18551056	2353	-	26
AT4G40011	4	18551197	18551404	207	-	0
AT4G40020	4	18553452	18555300	1848	-	3
AT4G40030	4	18555576	18556972	1396	-	5433
AT4G40040	4	18557186	18558743	1557	-	5841
AT4G40042	4	18559102	18559844	742	+	148
AT4G40045	4	18559783	18560657	874	-	464
AT4G40050	4	18560859	18563838	2979	-	912
AT4G40060	4	18571358	18573084	1726	-	1191
AT4G40065	4	18574502	18575585	1083	-	27
AT4G40070	4	18576417	18577774	1357	+	35
AT4G40080	4	18579313	18580717	1404	+	5
AT4G40085	4	18579241	18580377	1136	-	0
AT4G40090	4	18580837	18581585	748	-	0
AT4G40100	4	18583243	18584524	1281	+	0
AT5G01010	5	1222	5061	3839	-	1394
AT5G01015	5	5255	5891	636	-	310
AT5G01020	5	5916	8444	2528	-	1309
AT5G01030	5	9868	13235	3367	+	501
AT5G01040	5	13127	16173	3046	-	12
AT5G01050	5	18085	20812	2727	-	0
AT5G01060	5	22739	24847	2108	+	1
AT5G01070	5	25093	25799	706	-	9
AT5G01075	5	26847	27449	602	-	109
AT5G01080	5	28531	29086	555	-	0
AT5G01090	5	32831	34326	1495	+	858
AT5G01100	5	34595	37948	3353	-	20
AT5G01110	5	41767	44375	2608	-	44
AT5G01120	5	44812	47127	2315	+	27
AT5G01130	5	47569	49512	1943	+	0
AT5G01140	5	49890	51437	1547	+	0
AT5G01150	5	51987	53817	1830	+	3
AT5G01160	5	54009	55856	1847	+	354
AT5G01170	5	58161	60136	1975	+	276
AT5G01175	5	60207	61214	1007	+	23
AT5G01180	5	61016	63848	2832	-	22
AT5G01185	5	65274	69924	4650	-	0
AT5G01190	5	72391	74756	2365	+	24
AT5G01200	5	77115	78543	1428	+	28
AT5G01210	5	84473	86275	1802	+	0
AT5G01215	5	84306	86215	1909	-	0
AT5G01220	5	86584	89986	3402	-	2138
AT5G01225	5	91919	92324	405	+	2
AT5G01230	5	92600	95701	3101	-	179
AT5G01240	5	97893	101835	3942	+	1054
AT5G01250	5	102292	103770	1478	-	5
AT5G01260	5	105324	107405	2081	+	700
AT5G01270	5	107645	112311	4666	-	837
AT5G01280	5	114010	116237	2227	-	0
AT5G01290	5	117306	121569	4263	+	533
AT5G01300	5	121482	122525	1043	-	23
AT5G01310	5	125303	128960	3657	+	207
AT5G01320	5	129301	131625	2324	-	39
AT5G01330	5	132318	134862	2544	-	11
AT5G01335	5	135830	141287	5457	+	19
AT5G01340	5	143054	144720	1666	-	234
AT5G01350	5	145635	147200	1565	-	1154
AT5G01360	5	147481	149367	1886	-	36
AT5G01365	5	150354	150427	73	-	0
AT5G01370	5	152529	154467	1938	+	201
AT5G01380	5	155638	157601	1963	-	6
AT5G01390	5	160263	162299	2036	-	264
AT5G01400	5	162549	171072	8523	-	881
AT5G01410	5	172317	173614	1297	-	7610
AT5G01420	5	174798	176214	1416	-	25
AT5G01430	5	176446	178623	2177	-	157
AT5G01440	5	179821	181321	1500	+	0
AT5G01445	5	181876	182581	705	-	23
AT5G01450	5	183327	186448	3121	-	248
AT5G01460	5	186693	190457	3764	+	803
AT5G01470	5	190927	192611	1684	+	212
AT5G01480	5	192989	194231	1242	+	34
AT5G01490	5	195540	198524	2984	+	0
AT5G01500	5	198942	201552	2610	+	472
AT5G01510	5	201605	205386	3781	+	314
AT5G01520	5	206431	208611	2180	+	306
AT5G01530	5	208936	210445	1509	+	133978
AT5G01540	5	210978	213472	2494	-	0
AT5G01542	5	211256	213471	2215	+	0
AT5G01550	5	214516	216583	2067	-	11
AT5G01560	5	218137	220530	2393	-	497
AT5G01570	5	221366	222836	1470	+	18
AT5G01580	5	222759	223852	1093	-	31
AT5G01590	5	224173	226926	2753	+	3619
AT5G01595	5	227023	230013	2990	+	24
AT5G01600	5	227952	230051	2099	-	2497
AT5G01610	5	230986	232205	1219	+	79
AT5G01620	5	232564	234916	2352	+	278
AT5G01630	5	234850	240911	6061	-	139
AT5G01640	5	241382	242225	843	-	22
AT5G01650	5	242549	244111	1562	-	1211
AT5G01660	5	244503	249147	4644	-	32
AT5G01670	5	251813	253960	2147	+	233
AT5G01680	5	253995	256640	2645	-	0
AT5G01690	5	257409	260345	2936	+	0
AT5G01700	5	260725	263451	2726	-	30
AT5G01710	5	263510	265633	2123	-	0
AT5G01712	5	263510	265633	2123	-	0
AT5G01715	5	267184	269354	2170	+	7
AT5G01720	5	266722	270483	3761	-	183
AT5G01730	5	272831	277561	4730	-	30
AT5G01732	5	272838	276426	3588	+	0
AT5G01734	5	278989	279142	153	-	0
AT5G01740	5	280721	281445	724	+	18
AT5G01747	5	287585	287734	149	+	1
AT5G01750	5	289764	291326	1562	+	4290
AT5G01760	5	291711	294304	2593	+	10
AT5G01770	5	294312	301984	7672	-	597
AT5G01780	5	302266	304188	1922	-	437
AT5G01790	5	304896	305696	800	-	433
AT5G01800	5	306967	308908	1941	+	913
AT5G01810	5	309433	312097	2664	+	1740
AT5G01820	5	313192	315000	1808	-	2357
AT5G01830	5	320694	323169	2475	+	82
AT5G01840	5	324551	325516	965	+	93
AT5G01849	5	331772	331904	132	+	0
AT5G01850	5	332336	334470	2134	+	186
AT5G01860	5	335629	336277	648	+	0
AT5G01870	5	337176	337820	644	+	107
AT5G01880	5	338898	340253	1355	+	98
AT5G01881	5	339837	340266	429	+	2
AT5G01890	5	341542	345127	3585	-	672
AT5G01900	5	351007	352069	1062	-	1
AT5G01910	5	357794	358799	1005	-	76
AT5G01920	5	359106	362904	3798	+	2783
AT5G01930	5	361080	362901	1821	-	3
AT5G01940	5	363593	364769	1176	-	16
AT5G01950	5	364901	370186	5285	-	686
AT5G01960	5	370399	372969	2570	+	759
AT5G01970	5	372904	374954	2050	-	202
AT5G01980	5	375214	377208	1994	+	313
AT5G01990	5	377230	379911	2681	-	273
AT5G02000	5	380154	380595	441	-	0
AT5G02010	5	383152	385850	2698	+	225
AT5G02020	5	386017	388123	2106	-	87
AT5G02021	5	388714	388828	114	-	0
AT5G02025	5	389892	389963	71	-	0
AT5G02030	5	395633	399041	3408	+	269
AT5G02035	5	400382	400502	120	+	0
AT5G02040	5	400898	402951	2053	+	327
AT5G02050	5	402986	404323	1337	-	400
AT5G02060	5	404563	405811	1248	+	82
AT5G02070	5	405894	408220	2326	-	87
AT5G02080	5	409810	411557	1747	+	61
AT5G02090	5	412030	412698	668	-	31
AT5G02100	5	413519	416225	2706	+	126
AT5G02110	5	417021	418666	1645	+	2
AT5G02120	5	419090	419773	683	+	4235
AT5G02130	5	419657	422032	2375	-	147
AT5G02140	5	423383	424437	1054	+	12
AT5G02150	5	424290	426079	1789	-	268
AT5G02160	5	426225	427297	1072	+	5556
AT5G02170	5	427832	430695	2863	+	10
AT5G02180	5	430876	433741	2865	+	789
AT5G02190	5	435210	436897	1687	+	37
AT5G02200	5	437459	438894	1435	+	18
AT5G02210	5	439252	439874	622	-	0
AT5G02220	5	441706	442146	440	-	15
AT5G02230	5	448104	450654	2550	+	872
AT5G02240	5	451422	453157	1735	+	3723
AT5G02244	5	453813	454294	481	+	2
AT5G02250	5	454782	459527	4745	+	905
AT5G02260	5	463157	465246	2089	+	108
AT5G02270	5	467107	469110	2003	-	537
AT5G02280	5	469297	470285	988	+	330
AT5G02290	5	470181	472784	2603	-	552
AT5G02310	5	474278	482783	8505	+	1928
AT5G02320	5	483122	486434	3312	-	64
AT5G02330	5	487271	489242	1971	-	0
AT5G02340	5	492254	494150	1896	-	0
AT5G02350	5	495310	497266	1956	-	1
AT5G02360	5	500625	502329	1704	-	0
AT5G02370	5	503407	507244	3837	+	170
AT5G02380	5	506497	507244	747	-	13804
AT5G02385	5	508429	508502	73	-	0
AT5G02390	5	508629	511710	3081	-	4
AT5G02400	5	513560	515896	2336	+	57
AT5G02410	5	517211	519756	2545	-	274
AT5G02420	5	523388	524076	688	+	17
AT5G02430	5	526591	529839	3248	+	132
AT5G02435	5	530821	530895	74	+	0
AT5G02440	5	531027	532938	1911	+	61
AT5G02450	5	533105	534656	1551	+	2594
AT5G02460	5	539248	541112	1864	-	75
AT5G02470	5	542357	544900	2543	-	163
AT5G02480	5	547562	549912	2350	+	2653
AT5G02490	5	550034	552647	2613	-	441
AT5G02500	5	553744	556442	2698	-	28613
AT5G02502	5	558284	559235	951	-	173
AT5G02505	5	559329	559401	72	-	0
AT5G02510	5	560134	560860	726	+	3
AT5G02520	5	561324	564142	2818	+	66
AT5G02530	5	564084	565883	1799	-	1057
AT5G02540	5	568523	570920	2397	+	115
AT5G02550	5	573053	573558	505	-	51
AT5G02560	5	575381	576606	1225	+	351
AT5G02570	5	576741	577140	399	-	14
AT5G02580	5	579851	580787	936	+	1
AT5G02590	5	583085	584179	1094	+	279
AT5G02600	5	584161	586906	2745	-	498
AT5G02610	5	587507	588800	1293	+	1233
AT5G02615	5	588892	588966	74	-	0
AT5G02620	5	589526	591677	2151	+	762
AT5G02630	5	591770	593187	1417	+	90
AT5G02640	5	594178	594867	689	-	11
AT5G02650	5	597503	599786	2283	+	124
AT5G02660	5	600498	602658	2160	+	0
AT5G02670	5	602721	604606	1885	-	237
AT5G02680	5	604917	608193	3276	+	127
AT5G02690	5	607189	607704	515	+	55
AT5G02700	5	609380	611679	2299	-	0
AT5G02710	5	612569	614499	1930	+	588
AT5G02720	5	613781	614313	532	-	12
AT5G02725	5	614643	614725	82	+	0
AT5G02730	5	615609	616227	618	+	0
AT5G02740	5	616431	618618	2187	+	545
AT5G02750	5	620093	621179	1086	+	5
AT5G02760	5	625253	627124	1871	+	320
AT5G02770	5	627033	629255	2222	-	2534
AT5G02780	5	630875	632683	1808	+	3
AT5G02790	5	632795	635125	2330	+	6267
AT5G02800	5	635227	637503	2276	-	514
AT5G02810	5	637896	641977	4081	-	3847
AT5G02811	5	642070	642220	150	+	0
AT5G02815	5	642399	642481	82	-	0
AT5G02820	5	642557	644394	1837	+	162
AT5G02830	5	644278	648466	4188	-	2881
AT5G02840	5	648703	651972	3269	+	1770
AT5G02850	5	652109	653673	1564	+	279
AT5G02860	5	654101	656561	2460	+	368
AT5G02870	5	657785	659733	1948	+	6101
AT5G02880	5	662063	669107	7044	+	1660
AT5G02890	5	670064	671471	1407	-	511
AT5G02900	5	674059	675569	1510	+	0
AT5G02910	5	677067	679263	2196	+	154
AT5G02920	5	680540	681777	1237	+	0
AT5G02930	5	682576	684480	1904	+	2
AT5G02940	5	684473	689702	5229	-	2787
AT5G02950	5	690781	693010	2229	+	123
AT5G02960	5	693078	694515	1437	-	5341
AT5G02970	5	694968	697637	2669	+	538
AT5G02980	5	697992	699000	1008	+	0
AT5G02990	5	700168	702630	2462	+	0
AT5G03000	5	703267	704437	1170	+	0
AT5G03010	5	704583	705538	955	+	11
AT5G03020	5	707256	708396	1140	+	5
AT5G03030	5	708317	709703	1386	-	309
AT5G03040	5	710101	712994	2893	-	2596
AT5G03050	5	715028	716321	1293	-	205
AT5G03060	5	716721	718014	1293	-	14
AT5G03070	5	718203	721539	3336	-	191
AT5G03080	5	721866	723400	1534	+	433
AT5G03090	5	725280	725962	682	+	0
AT5G03100	5	726821	728742	1921	+	84
AT5G03110	5	730291	731448	1157	+	135
AT5G03120	5	733978	734943	965	+	284
AT5G03130	5	736089	736669	580	+	47
AT5G03140	5	737589	740016	2427	-	668
AT5G03150	5	745643	749007	3364	+	97
AT5G03160	5	750108	752805	2697	+	594
AT5G03170	5	752749	753657	908	-	254
AT5G03180	5	753950	756646	2696	-	268
AT5G03190	5	758373	760382	2009	+	2459
AT5G03200	5	760318	761803	1485	-	191
AT5G03204	5	762286	762397	111	-	0
AT5G03210	5	762786	763321	535	-	24
AT5G03220	5	767488	768857	1369	-	136
AT5G03230	5	769513	770385	872	+	456
AT5G03240	5	771724	773515	1791	-	3729
AT5G03250	5	774400	777048	2648	+	71
AT5G03260	5	777020	779424	2404	-	344
AT5G03270	5	781869	783997	2128	+	23
AT5G03280	5	787427	793356	5929	+	1144
AT5G03285	5	793513	793717	204	+	74
AT5G03290	5	793973	796182	2209	+	1342
AT5G03300	5	796441	799176	2735	+	2211
AT5G03310	5	799223	799706	483	-	1
AT5G03320	5	802026	804398	2372	+	345
AT5G03330	5	806963	809779	2816	+	321
AT5G03340	5	809947	813228	3281	-	716
AT5G03345	5	814084	815619	1535	+	331
AT5G03350	5	815673	816658	985	-	734
AT5G03360	5	817863	825149	7286	+	26
AT5G03370	5	825572	827043	1471	-	461
AT5G03377	5	820168	821016	848	-	12
AT5G03380	5	832103	834412	2309	-	883
AT5G03390	5	834987	836751	1764	+	80
AT5G03400	5	837918	839202	1284	-	0
AT5G03406	5	839884	841875	1991	+	137
AT5G03415	5	842288	845419	3131	+	311
AT5G03420	5	845640	848914	3274	+	1315
AT5G03430	5	848863	853142	4279	-	1813
AT5G03435	5	853364	855693	2329	-	6
AT5G03440	5	856871	858428	1557	-	119
AT5G03445	5	858535	858572	37	+	0
AT5G03450	5	858768	862297	3529	-	235
AT5G03452	5	862396	862469	73	-	0
AT5G03455	5	862558	864108	1550	+	603
AT5G03460	5	864280	865678	1398	+	390
AT5G03470	5	866448	869024	2576	+	180
AT5G03480	5	869207	870855	1648	-	2
AT5G03490	5	871459	873057	1598	+	302
AT5G03495	5	873330	875251	1921	-	53
AT5G03500	5	876520	878364	1844	-	146
AT5G03510	5	880224	881305	1081	+	60
AT5G03520	5	883446	885425	1979	+	1077
AT5G03530	5	885521	887390	1869	-	299
AT5G03540	5	889565	894167	4602	+	1253
AT5G03545	5	894705	895400	695	+	152
AT5G03550	5	895812	896145	333	-	0
AT5G03552	5	897019	897356	337	-	16
AT5G03555	5	898240	900159	1919	-	971
AT5G03560	5	900459	902762	2303	-	350
AT5G03570	5	903755	906664	2909	+	0
AT5G03580	5	906955	907422	467	-	0
AT5G03590	5	908562	910149	1587	+	0
AT5G03600	5	912806	914226	1420	+	0
AT5G03610	5	915464	918485	3021	+	405
AT5G03620	5	918737	921874	3137	+	29
AT5G03630	5	922165	924683	2518	-	878
AT5G03640	5	927914	930781	2867	+	17
AT5G03650	5	931903	937641	5738	+	4345
AT5G03660	5	937976	940058	2082	+	1105
AT5G03668	5	947100	948967	1867	-	0
AT5G03670	5	947145	950171	3026	+	99
AT5G03680	5	957743	961032	3289	+	68
AT5G03690	5	963147	965050	1903	-	204
AT5G03700	5	965873	967322	1449	-	39
AT5G03705	5	970798	970879	81	-	0
AT5G03710	5	971106	971627	521	+	0
AT5G03720	5	971785	973683	1898	-	22
AT5G03730	5	974497	979849	5352	-	831
AT5G03740	5	981875	984200	2325	+	1116
AT5G03745	5	984366	984449	83	+	0
AT5G03750	5	984795	985497	702	+	0
AT5G03760	5	985674	990549	4875	-	3149
AT5G03770	5	995159	997848	2689	+	88
AT5G03775	5	998941	999014	73	+	0
AT5G03780	5	999101	1001029	1928	-	108
AT5G03790	5	1004982	1006373	1391	+	23
AT5G03795	5	1007389	1010473	3084	-	19
AT5G03800	5	1010779	1013586	2807	-	138
AT5G03810	5	1013938	1015345	1407	-	0
AT5G03820	5	1015802	1017263	1461	-	0
AT5G03830	5	1018337	1020460	2123	+	275
AT5G03837	5	1023527	1023683	156	-	0
AT5G03840	5	1024640	1025812	1172	-	2
AT5G03850	5	1028339	1029121	782	-	1826
AT5G03858	5	1031563	1032032	469	-	0
AT5G03860	5	1032102	1034973	2871	-	3
AT5G03870	5	1035657	1036967	1310	-	95
AT5G03880	5	1038507	1041480	2973	-	6337
AT5G03890	5	1047149	1047689	540	+	13
AT5G03900	5	1048294	1052387	4093	+	1727
AT5G03905	5	1052579	1054274	1695	+	274
AT5G03910	5	1054077	1057172	3095	-	1275
AT5G03920	5	1058145	1058769	624	+	0
AT5G03930	5	1059503	1060154	651	+	2
AT5G03940	5	1060133	1063319	3186	-	4313
AT5G03944	5	1064610	1064808	198	-	0
AT5G03950	5	1066205	1066964	759	+	0
AT5G03960	5	1068259	1069978	1719	-	5
AT5G03970	5	1071567	1073423	1856	-	172
AT5G03980	5	1074204	1075289	1085	-	0
AT5G03990	5	1075670	1077549	1879	+	183
AT5G03995	5	1077482	1078304	822	-	36
AT5G04000	5	1079036	1079869	833	-	7
AT5G04010	5	1080104	1081074	970	-	0
AT5G04020	5	1081610	1086546	4936	-	427
AT5G04030	5	1088461	1088692	231	-	0
AT5G04040	5	1089341	1093179	3838	+	832
AT5G04045	5	1093678	1094230	552	+	0
AT5G04047	5	1095056	1095702	646	-	0
AT5G04050	5	1096015	1098920	2905	+	107
AT5G04060	5	1099117	1102058	2941	+	484
AT5G04070	5	1102089	1104446	2357	+	177
AT5G04080	5	1104523	1105398	875	+	182
AT5G04090	5	1105409	1108266	2857	-	550
AT5G04110	5	1110445	1114867	4422	-	402
AT5G04120	5	1120002	1121775	1773	+	0
AT5G04130	5	1121827	1128091	6264	-	666
AT5G04140	5	1129851	1138442	8591	+	64208
AT5G04150	5	1138558	1139476	918	-	4
AT5G04160	5	1142781	1144912	2131	-	447
AT5G04170	5	1145430	1147781	2351	+	523
AT5G04180	5	1147647	1149284	1637	-	1
AT5G04190	5	1150891	1152481	1590	+	160
AT5G04200	5	1153789	1155040	1251	+	173
AT5G04210	5	1155054	1155724	670	-	0
AT5G04220	5	1155864	1158877	3013	-	321
AT5G04230	5	1160633	1163898	3265	+	606
AT5G04235	5	1164286	1168411	4125	-	216
AT5G04238	5	1169216	1169411	195	-	29
AT5G04240	5	1169543	1174878	5335	+	669
AT5G04250	5	1176004	1178700	2696	+	39
AT5G04260	5	1178643	1180036	1393	-	473
AT5G04267	5	1182162	1182294	132	-	0
AT5G04270	5	1182717	1184765	2048	-	107
AT5G04275	5	1188210	1188299	89	-	7
AT5G04280	5	1192273	1195662	3389	+	703
AT5G04290	5	1196068	1202653	6585	+	652
AT5G04310	5	1203202	1207352	4150	-	39
AT5G04320	5	1209196	1212578	3382	+	316
AT5G04330	5	1212601	1214439	1838	-	49
AT5G04340	5	1216130	1217106	976	-	23
AT5G04347	5	1219827	1220612	785	+	0
AT5G04350	5	1220828	1221269	441	+	0
AT5G04360	5	1221565	1228678	7113	+	1256
AT5G04370	5	1231696	1234147	2451	+	1
AT5G04380	5	1234882	1236317	1435	+	2
AT5G04386	5	1238102	1238219	117	+	0
AT5G04390	5	1239099	1240517	1418	+	8
AT5G04400	5	1241554	1243358	1804	+	0
AT5G04410	5	1243757	1246684	2927	+	1421
AT5G04420	5	1246603	1249943	3340	-	602
AT5G04430	5	1250250	1253865	3615	-	3051
AT5G04440	5	1254843	1256953	2110	+	1827
AT5G04460	5	1259530	1264025	4495	+	510
AT5G04470	5	1266624	1267416	792	-	104
AT5G04480	5	1271512	1277985	6473	-	632
AT5G04490	5	1279759	1281669	1910	+	1117
AT5G04500	5	1283467	1286359	2892	+	1
AT5G04510	5	1286865	1289908	3043	+	828
AT5G04520	5	1290011	1291063	1052	-	99
AT5G04530	5	1291821	1293688	1867	-	724
AT5G04540	5	1296441	1302444	6003	-	502
AT5G04550	5	1303179	1306116	2937	-	1343
AT5G04560	5	1309192	1318401	9209	+	1451
AT5G04590	5	1319355	1322526	3171	+	8426
AT5G04600	5	1323635	1325627	1992	+	786
AT5G04610	5	1325587	1326928	1341	-	10
AT5G04620	5	1327114	1330091	2977	+	246
AT5G04630	5	1330577	1332107	1530	+	3
AT5G04640	5	1332824	1333793	969	+	0
AT5G04650	5	1334402	1334956	554	+	0
AT5G04660	5	1335994	1337670	1676	+	166
AT5G04670	5	1337838	1340884	3046	-	415
AT5G04680	5	1346237	1348857	2620	-	92
AT5G04690	5	1349642	1352525	2883	-	71
AT5G04700	5	1354239	1356754	2515	-	68
AT5G04710	5	1356989	1360247	3258	-	1073
AT5G04720	5	1360711	1363884	3173	+	499
AT5G04730	5	1364100	1367394	3294	-	0
AT5G04740	5	1368541	1371480	2939	-	1612
AT5G04750	5	1372146	1373619	1473	+	964
AT5G04760	5	1373529	1374787	1258	-	166
AT5G04770	5	1379067	1382419	3352	+	38
AT5G04780	5	1384539	1386447	1908	+	43
AT5G04781	5	1386685	1387731	1046	+	2
AT5G04790	5	1388154	1388319	165	-	10
AT5G04800	5	1388482	1389865	1383	+	995
AT5G04810	5	1390033	1393930	3897	+	2828
AT5G04820	5	1399618	1400784	1166	+	145
AT5G04830	5	1402044	1403961	1917	-	1445
AT5G04840	5	1405293	1407934	2641	+	73
AT5G04850	5	1408018	1409893	1875	-	461
AT5G04853	5	1410526	1410703	177	-	0
AT5G04860	5	1411564	1414677	3113	-	159
AT5G04870	5	1416782	1420338	3556	-	938
AT5G04880	5	1420726	1422582	1856	-	190
AT5G04885	5	1422798	1426879	4081	+	486
AT5G04890	5	1427172	1428454	1282	+	174
AT5G04895	5	1428723	1434769	6046	+	110
AT5G04900	5	1434773	1437330	2557	+	829
AT5G04910	5	1437613	1438770	1157	+	240
AT5G04920	5	1438958	1441983	3025	-	887
AT5G04930	5	1444869	1449817	4948	+	1419
AT5G04940	5	1454166	1456990	2824	-	495
AT5G04950	5	1457644	1458890	1246	-	518
AT5G04960	5	1461906	1463969	2063	+	0
AT5G04970	5	1464144	1467041	2897	-	2
AT5G04980	5	1468574	1470772	2198	-	113
AT5G04990	5	1471480	1473964	2484	-	578
AT5G05000	5	1474112	1476409	2297	-	522
AT5G05010	5	1476582	1480197	3615	+	3495
AT5G05020	5	1480771	1481636	865	-	0
AT5G05025	5	1483124	1483538	414	-	0
AT5G05030	5	1484176	1486065	1889	-	0
AT5G05040	5	1487259	1487968	709	-	0
AT5G05050	5	1491638	1493457	1819	+	0
AT5G05060	5	1493718	1495085	1367	-	469
AT5G05070	5	1496854	1498544	1690	+	0
AT5G05080	5	1498552	1500784	2232	-	1276
AT5G05090	5	1503231	1504494	1263	+	301
AT5G05100	5	1505121	1507224	2103	-	645
AT5G05110	5	1507418	1508867	1449	-	265
AT5G05113	5	1509732	1509990	258	-	0
AT5G05120	5	1511231	1511837	606	+	0
AT5G05130	5	1512119	1515079	2960	+	59
AT5G05140	5	1519912	1522667	2755	+	346
AT5G05150	5	1524840	1526199	1359	-	1
AT5G05160	5	1527974	1530062	2088	+	289
AT5G05170	5	1530173	1535414	5241	-	8615
AT5G05180	5	1536225	1538492	2267	+	244
AT5G05190	5	1541520	1544137	2617	+	119
AT5G05200	5	1544006	1547164	3158	-	4674
AT5G05210	5	1547422	1549791	2369	+	527
AT5G05220	5	1550266	1550928	662	+	0
AT5G05230	5	1551387	1553805	2418	+	334
AT5G05240	5	1553813	1556556	2743	-	150
AT5G05250	5	1557036	1557998	962	-	114
AT5G05260	5	1559777	1561765	1988	-	0
AT5G05270	5	1563319	1565007	1688	+	1008
AT5G05280	5	1565446	1566391	945	-	0
AT5G05282	5	1565446	1566391	945	-	0
AT5G05290	5	1568693	1569864	1171	+	1
AT5G05300	5	1570101	1570410	309	-	1
AT5G05310	5	1571151	1574579	3428	+	213
AT5G05320	5	1575005	1576731	1726	-	3
AT5G05330	5	1576981	1578754	1773	-	85
AT5G05340	5	1578950	1580875	1925	-	9
AT5G05350	5	1585296	1587517	2221	+	33
AT5G05360	5	1588304	1589365	1061	+	399
AT5G05365	5	1590035	1590861	826	+	58
AT5G05370	5	1590796	1591903	1107	-	369
AT5G05380	5	1592129	1593026	897	+	42
AT5G05390	5	1594752	1597042	2290	+	6
AT5G05400	5	1597744	1600369	2625	-	33
AT5G05410	5	1602204	1603926	1722	+	15
AT5G05420	5	1604039	1604823	784	-	13
AT5G05430	5	1605274	1606703	1429	-	7
AT5G05435	5	1606551	1607656	1105	+	36
AT5G05440	5	1609249	1610446	1197	+	41
AT5G05450	5	1612005	1615356	3351	+	440
AT5G05460	5	1615528	1618902	3374	+	172
AT5G05470	5	1620457	1622340	1883	+	282
AT5G05480	5	1622171	1624270	2099	-	140
AT5G05490	5	1624205	1629269	5064	+	2
AT5G05500	5	1629666	1630396	730	+	0
AT5G05510	5	1630558	1632598	2040	-	55
AT5G05520	5	1632844	1635342	2498	+	433
AT5G05530	5	1635477	1636191	714	+	0
AT5G05540	5	1636297	1638939	2642	+	349
AT5G05550	5	1639031	1640606	1575	-	310
AT5G05560	5	1641451	1654756	13305	+	207
AT5G05570	5	1656565	1663929	7364	+	557
AT5G05580	5	1664084	1666531	2447	+	2605
AT5G05590	5	1666470	1668352	1882	-	43
AT5G05598	5	1671811	1672062	251	+	0
AT5G05600	5	1672119	1674739	2620	+	23
AT5G05610	5	1676931	1679104	2173	-	891
AT5G05620	5	1679243	1681719	2476	+	265
AT5G05630	5	1682320	1684191	1871	+	80
AT5G05640	5	1684565	1685812	1247	+	14
AT5G05650	5	1686531	1686909	378	-	0
AT5G05657	5	1688989	1689571	582	+	0
AT5G05660	5	1690850	1695467	4617	-	735
AT5G05670	5	1695729	1698153	2424	-	371
AT5G05680	5	1698269	1702645	4376	+	217
AT5G05690	5	1702687	1706787	4100	-	3786
AT5G05700	5	1712669	1715731	3062	-	558
AT5G05710	5	1715874	1716499	625	+	112
AT5G05720	5	1716870	1719541	2671	+	0
AT5G05730	5	1719556	1722910	3354	-	639
AT5G05740	5	1723835	1727030	3195	-	2847
AT5G05750	5	1727428	1728933	1505	+	371
AT5G05760	5	1728892	1731021	2129	-	163
AT5G05770	5	1734486	1734855	369	+	0
AT5G05780	5	1735724	1738700	2976	+	1435
AT5G05790	5	1740571	1742028	1457	-	176
AT5G05795	5	1742691	1742764	73	+	0
AT5G05800	5	1743085	1745245	2160	-	547
AT5G05810	5	1746829	1748255	1426	+	34
AT5G05820	5	1751687	1754178	2491	-	361
AT5G05830	5	1755765	1757085	1320	+	297
AT5G05840	5	1757097	1760666	3569	-	178
AT5G05850	5	1762404	1764678	2274	-	141
AT5G05860	5	1765506	1767455	1949	+	367
AT5G05870	5	1767638	1769262	1624	+	310
AT5G05880	5	1769647	1771515	1868	+	2
AT5G05890	5	1772542	1774113	1571	+	187
AT5G05900	5	1774512	1776381	1869	+	0
AT5G05910	5	1776857	1777313	456	+	0
AT5G05920	5	1777546	1779826	2280	-	192
AT5G05930	5	1779973	1783412	3439	-	422
AT5G05940	5	1785926	1788436	2510	+	129
AT5G05945	5	1788650	1788722	72	+	0
AT5G05950	5	1788766	1789438	672	+	208
AT5G05960	5	1790230	1790833	603	+	263
AT5G05965	5	1790787	1792634	1847	-	0
AT5G05970	5	1795293	1799527	4234	+	340
AT5G05980	5	1799489	1804492	5003	-	858
AT5G05985	5	1804615	1804689	74	+	0
AT5G05987	5	1804803	1806850	2047	+	137
AT5G05990	5	1806760	1807907	1147	-	166
AT5G06000	5	1808149	1809853	1704	+	48
AT5G06010	5	1809939	1810263	324	+	1
AT5G06020	5	1811937	1812393	456	+	0
AT5G06030	5	1813918	1814371	453	+	0
AT5G06040	5	1815127	1816037	910	+	0
AT5G06043	5	1817136	1817505	369	-	0
AT5G06050	5	1820131	1823771	3640	+	449
AT5G06060	5	1823841	1825894	2053	-	1814
AT5G06070	5	1828149	1829186	1037	-	2
AT5G06080	5	1830795	1831467	672	-	0
AT5G06090	5	1835105	1836722	1617	+	0
AT5G06100	5	1837906	1840727	2821	+	352
AT5G06110	5	1840828	1843872	3044	-	964
AT5G06120	5	1844066	1852981	8915	+	1029
AT5G06125	5	1853301	1853381	80	-	0
AT5G06130	5	1853431	1855888	2457	-	1766
AT5G06140	5	1856007	1858785	2778	-	962
AT5G06150	5	1859278	1861649	2371	-	295
AT5G06160	5	1862368	1866433	4065	-	563
AT5G06165	5	1867196	1868244	1048	-	6
AT5G06170	5	1869790	1871719	1929	+	1
AT5G06180	5	1873161	1876059	2898	+	174
AT5G06190	5	1875788	1876782	994	-	33
AT5G06200	5	1877332	1878116	784	+	4
AT5G06210	5	1878470	1879740	1270	+	269
AT5G06220	5	1879936	1885643	5707	+	3292
AT5G06230	5	1884927	1887121	2194	-	9
AT5G06240	5	1888310	1889698	1388	+	161
AT5G06250	5	1892713	1894124	1411	-	29
AT5G06260	5	1902598	1905101	2503	-	539
AT5G06265	5	1905286	1908167	2881	+	308
AT5G06270	5	1912549	1913674	1125	+	268
AT5G06278	5	1917210	1918112	902	+	3
AT5G06280	5	1917640	1918896	1256	-	281
AT5G06290	5	1919212	1921425	2213	+	8695
AT5G06300	5	1921743	1925370	3627	-	36
AT5G06310	5	1928390	1930951	2561	+	40
AT5G06320	5	1930792	1931768	976	-	561
AT5G06330	5	1934738	1935644	906	-	13
AT5G06340	5	1936365	1938114	1749	+	1507
AT5G06350	5	1938780	1944357	5577	+	491
AT5G06360	5	1944767	1946743	1976	+	951
AT5G06370	5	1947138	1948612	1474	-	561
AT5G06380	5	1949314	1950282	968	+	10
AT5G06390	5	1952850	1955788	2938	+	1108
AT5G06400	5	1955958	1959051	3093	+	9
AT5G06410	5	1959535	1961158	1623	-	106
AT5G06420	5	1960680	1963040	2360	+	31
AT5G06430	5	1963071	1964314	1243	-	129
AT5G06440	5	1964467	1967335	2868	-	968
AT5G06450	5	1967722	1969223	1501	-	163
AT5G06460	5	1970028	1974527	4499	+	755
AT5G06470	5	1974658	1975378	720	-	18
AT5G06480	5	1976085	1977290	1205	-	49
AT5G06490	5	1977995	1978589	594	-	0
AT5G06500	5	1982443	1983172	729	+	0
AT5G06510	5	1984990	1987044	2054	+	108
AT5G06520	5	1987249	1989372	2123	-	1
AT5G06530	5	1989746	1994912	5166	-	3295
AT5G06540	5	1999180	2001049	1869	-	20
AT5G06550	5	2001133	2003075	1942	-	94
AT5G06560	5	2003303	2006188	2885	-	424
AT5G06570	5	2007599	2011041	3442	-	2
AT5G06580	5	2011287	2016539	5252	-	748
AT5G06590	5	2016644	2018835	2191	+	77
AT5G06600	5	2019106	2027945	8839	-	3124
AT5G06610	5	2029896	2033723	3827	+	68
AT5G06620	5	2033759	2036143	2384	+	34
AT5G06630	5	2036360	2037843	1483	-	0
AT5G06634	5	2038816	2039221	405	+	0
AT5G06640	5	2039858	2041928	2070	-	0
AT5G06650	5	2043485	2044061	576	+	5
AT5G06660	5	2046809	2047794	985	+	448
AT5G06670	5	2048242	2055019	6777	-	398
AT5G06680	5	2056586	2059787	3201	+	241
AT5G06685	5	2060152	2060234	82	-	0
AT5G06690	5	2060500	2061956	1456	-	257
AT5G06700	5	2063486	2066039	2553	+	1547
AT5G06710	5	2068064	2070361	2297	-	168
AT5G06720	5	2077419	2079005	1586	-	25
AT5G06730	5	2079954	2081684	1730	-	1
AT5G06740	5	2084093	2086052	1959	+	1
AT5G06750	5	2086265	2088997	2732	-	171
AT5G06755	5	2088846	2089287	441	-	0
AT5G06760	5	2089491	2090430	939	-	17
AT5G06770	5	2090702	2092950	2248	-	281
AT5G06780	5	2093882	2097129	3247	-	378
AT5G06790	5	2097668	2098740	1072	-	170
AT5G06800	5	2103159	2105898	2739	+	88
AT5G06805	5	2106096	2108020	1924	-	0
AT5G06810	5	2108492	2112256	3764	+	155
AT5G06820	5	2112868	2116754	3886	+	13
AT5G06830	5	2116782	2119629	2847	-	538
AT5G06839	5	2120526	2126456	5930	+	0
AT5G06850	5	2126974	2130443	3469	-	305
AT5G06860	5	2132349	2133587	1238	+	1
AT5G06865	5	2132196	2133746	1550	-	3
AT5G06870	5	2133917	2135166	1249	+	300
AT5G06890	5	2135742	2135943	201	+	0
AT5G06900	5	2136159	2137925	1766	-	0
AT5G06905	5	2138437	2140078	1641	-	0
AT5G06910	5	2140452	2142679	2227	+	281
AT5G06920	5	2142857	2143919	1062	+	0
AT5G06930	5	2144998	2148039	3041	+	90
AT5G06940	5	2148077	2150771	2694	-	72
AT5G06950	5	2151024	2154553	3529	+	302
AT5G06960	5	2154779	2157646	2867	+	258
AT5G06970	5	2158227	2166398	8171	-	1726
AT5G06980	5	2167467	2169391	1924	+	1778
AT5G06990	5	2169601	2170606	1005	+	6
AT5G07000	5	2171402	2172939	1537	-	142
AT5G07010	5	2174677	2176106	1429	-	11
AT5G07020	5	2180501	2182418	1917	-	7573
AT5G07030	5	2183359	2185972	2613	-	1713
AT5G07040	5	2190343	2190823	480	+	10
AT5G07050	5	2191384	2193416	2032	-	0
AT5G07060	5	2193965	2195963	1998	-	15
AT5G07070	5	2196433	2198114	1681	-	95
AT5G07080	5	2200331	2202110	1779	+	157
AT5G07090	5	2202379	2204078	1699	+	5567
AT5G07100	5	2204247	2205811	1564	+	14
AT5G07110	5	2205999	2206928	929	+	101
AT5G07120	5	2206893	2209516	2623	-	479
AT5G07130	5	2210566	2212620	2054	+	76
AT5G07135	5	2212677	2212748	71	-	0
AT5G07140	5	2212825	2215530	2705	+	76
AT5G07150	5	2215819	2217983	2164	+	126
AT5G07152	5	2216872	2217812	940	-	18
AT5G07160	5	2219970	2220709	739	-	0
AT5G07170	5	2222766	2225098	2332	+	2
AT5G07180	5	2227570	2233417	5847	-	413
AT5G07190	5	2237506	2238671	1165	+	0
AT5G07200	5	2243552	2245339	1787	-	16
AT5G07210	5	2252236	2256018	3782	+	0
AT5G07215	5	2257474	2262962	5488	-	7
AT5G07220	5	2265255	2266967	1712	-	878
AT5G07225	5	2268641	2270227	1586	-	0
AT5G07230	5	2270964	2271610	646	+	0
AT5G07240	5	2271918	2274288	2370	+	1152
AT5G07250	5	2274259	2275990	1731	-	408
AT5G07260	5	2277812	2280281	2469	+	0
AT5G07270	5	2280666	2283593	2927	+	552
AT5G07280	5	2285039	2288686	3647	+	104
AT5G07290	5	2293352	2298976	5624	+	960
AT5G07300	5	2299886	2303268	3382	+	1126
AT5G07310	5	2305683	2306660	977	+	0
AT5G07315	5	2309511	2309548	37	-	0
AT5G07320	5	2309910	2312287	2377	+	322
AT5G07322	5	2313118	2313563	445	-	18
AT5G07330	5	2315979	2316874	895	+	0
AT5G07340	5	2317212	2319649	2437	+	875
AT5G07350	5	2320020	2325419	5399	-	2294
AT5G07360	5	2326703	2330142	3439	-	323
AT5G07370	5	2330384	2332281	1897	+	1075
AT5G07380	5	2332475	2336063	3588	+	47
AT5G07390	5	2335894	2339913	4019	-	3
AT5G07400	5	2340641	2345458	4817	+	92
AT5G07410	5	2345757	2347497	1740	+	0
AT5G07420	5	2349454	2351509	2055	+	0
AT5G07430	5	2352438	2354202	1764	+	0
AT5G07440	5	2355936	2358194	2258	+	700
AT5G07450	5	2358351	2359308	957	-	1
AT5G07460	5	2360633	2362013	1380	-	1107
AT5G07470	5	2362569	2364374	1805	-	1016
AT5G07475	5	2364744	2365605	861	-	5
AT5G07480	5	2367166	2369554	2388	+	0
AT5G07490	5	2370135	2371326	1191	+	0
AT5G07500	5	2372618	2373655	1037	+	0
AT5G07505	5	2374052	2377382	3330	+	0
AT5G07510	5	2377709	2378829	1120	-	2
AT5G07520	5	2379923	2381317	1394	-	9
AT5G07530	5	2382467	2384521	2054	-	0
AT5G07540	5	2386012	2387249	1237	-	0
AT5G07550	5	2388309	2389249	940	-	0
AT5G07560	5	2390206	2391075	869	-	7
AT5G07570	5	2391721	2396329	4608	+	8
AT5G07571	5	2396431	2397423	992	-	2
AT5G07572	5	2396707	2397548	841	+	0
AT5G07580	5	2399503	2400601	1098	+	789
AT5G07590	5	2401580	2403877	2297	-	185
AT5G07600	5	2404573	2405521	948	-	0
AT5G07610	5	2406067	2407330	1263	+	58
AT5G07620	5	2407400	2409066	1666	-	42
AT5G07625	5	2411147	2411231	84	+	0
AT5G07630	5	2410702	2414711	4009	+	468
AT5G07640	5	2414846	2416277	1431	+	33
AT5G07650	5	2416374	2421814	5440	-	4
AT5G07660	5	2422838	2429912	7074	+	94
AT5G07670	5	2430145	2432196	2051	+	417
AT5G07675	5	2432262	2432335	73	-	0
AT5G07680	5	2435874	2437499	1625	+	22
AT5G07685	5	2441438	2443509	2071	+	1
AT5G07690	5	2446763	2448543	1780	+	1463
AT5G07700	5	2450324	2451578	1254	+	69
AT5G07710	5	2453134	2455546	2412	+	251
AT5G07720	5	2455633	2457316	1683	+	65
AT5G07730	5	2457346	2458430	1084	-	39
AT5G07740	5	2458576	2466813	8237	-	1084
AT5G07760	5	2468238	2473657	5419	+	9
AT5G07770	5	2474641	2479402	4761	+	373
AT5G07780	5	2479513	2482850	3337	+	4
AT5G07790	5	2483310	2486361	3051	+	192
AT5G07800	5	2486575	2489296	2721	-	133
AT5G07810	5	2491282	2498484	7202	-	141
AT5G07820	5	2498748	2501209	2461	-	161
AT5G07830	5	2503322	2506688	3366	+	560
AT5G07840	5	2506655	2508373	1718	-	0
AT5G07842	5	2506633	2508435	1802	-	0
AT5G07850	5	2508916	2510503	1587	+	0
AT5G07860	5	2511441	2513095	1654	+	543
AT5G07870	5	2513793	2515418	1625	+	381
AT5G07880	5	2515586	2516694	1108	-	6
AT5G07890	5	2517380	2520038	2658	-	381
AT5G07900	5	2520168	2521546	1378	+	326
AT5G07910	5	2521533	2524201	2668	-	298
AT5G07920	5	2524777	2529330	4553	-	498
AT5G07930	5	2530833	2532742	1909	+	0
AT5G07940	5	2533723	2540421	6698	+	713
AT5G07950	5	2540283	2542136	1853	-	123
AT5G07960	5	2542245	2543459	1214	+	349
AT5G07970	5	2543867	2548723	4856	-	677
AT5G07980	5	2549165	2555519	6354	-	591
AT5G07990	5	2560393	2563109	2716	+	221
AT5G08000	5	2563553	2565491	1938	+	243
AT5G08010	5	2569605	2571734	2129	+	414
AT5G08020	5	2572106	2574879	2773	+	222
AT5G08030	5	2575032	2576783	1751	-	80
AT5G08040	5	2577201	2578119	918	-	669
AT5G08050	5	2578344	2579163	819	+	5435
AT5G08055	5	2579400	2579802	402	+	0
AT5G08060	5	2580448	2582564	2116	+	1229
AT5G08070	5	2584884	2585613	729	+	53
AT5G08075	5	2587825	2587898	73	-	0
AT5G08080	5	2588341	2591316	2975	+	911
AT5G08090	5	2591710	2592899	1189	+	0
AT5G08100	5	2593049	2594651	1602	-	506
AT5G08110	5	2594721	2600114	5393	-	205
AT5G08120	5	2600473	2602927	2454	-	414
AT5G08130	5	2606199	2610250	4051	-	1334
AT5G08139	5	2616344	2617881	1537	+	185
AT5G08141	5	2619141	2619555	414	+	0
AT5G08150	5	2622029	2622720	691	-	8
AT5G08160	5	2625558	2628110	2552	-	783
AT5G08170	5	2628324	2631098	2774	-	920
AT5G08180	5	2631515	2633850	2335	-	780
AT5G08185	5	2634100	2635438	1338	-	191
AT5G08190	5	2635901	2637433	1532	+	271
AT5G08200	5	2638035	2640824	2789	+	362
AT5G08210	5	2641425	2641674	249	-	5
AT5G08220	5	2642279	2642991	712	-	0
AT5G08230	5	2641393	2649788	8395	-	558
AT5G08240	5	2650836	2652398	1562	-	3
AT5G08250	5	2653578	2655732	2154	-	2
AT5G08260	5	2657150	2661416	4266	+	745
AT5G08270	5	2661657	2663627	1970	+	165
AT5G08280	5	2663498	2665792	2294	-	6955
AT5G08290	5	2665975	2667155	1180	+	2020
AT5G08300	5	2667411	2669923	2512	+	1333
AT5G08305	5	2670133	2671765	1632	-	9
AT5G08310	5	2672755	2675254	2499	-	50
AT5G08315	5	2676176	2676580	404	-	0
AT5G08320	5	2677051	2678678	1627	+	195
AT5G08330	5	2680743	2681813	1070	+	1215
AT5G08335	5	2682228	2683712	1484	+	92
AT5G08340	5	2683831	2685997	2166	+	152
AT5G08350	5	2686244	2687251	1007	-	34
AT5G08360	5	2689712	2690974	1262	+	6
AT5G08370	5	2690878	2693550	2672	-	671
AT5G08380	5	2694676	2697724	3048	-	309
AT5G08390	5	2701012	2707273	6261	+	613
AT5G08391	5	2699300	2699784	484	+	14
AT5G08400	5	2706457	2708946	2489	-	177
AT5G08410	5	2709847	2710583	736	-	2492
AT5G08415	5	2710816	2713132	2316	-	648
AT5G08420	5	2713412	2716179	2767	+	1382
AT5G08430	5	2716699	2720212	3513	+	777
AT5G08440	5	2720668	2727167	6499	+	547
AT5G08450	5	2727820	2732893	5073	-	1481
AT5G08460	5	2733219	2735455	2236	+	2
AT5G08470	5	2735924	2743056	7132	+	698
AT5G08480	5	2743619	2745111	1492	+	30
AT5G08490	5	2745207	2747757	2550	-	8
AT5G08500	5	2748192	2751771	3579	+	528
AT5G08505	5	2752024	2752356	332	-	0
AT5G08510	5	2753098	2755116	2018	+	81
AT5G08520	5	2755174	2758362	3188	-	479
AT5G08530	5	2759316	2761875	2559	-	4302
AT5G08535	5	2762028	2763436	1408	+	154
AT5G08540	5	2763822	2765734	1912	+	1510
AT5G08550	5	2765641	2770282	4641	-	462
AT5G08560	5	2770873	2774672	3799	-	995
AT5G08565	5	2775896	2777446	1550	+	92
AT5G08570	5	2777999	2780441	2442	+	2354
AT5G08580	5	2780511	2783066	2555	-	458
AT5G08590	5	2783330	2786094	2764	+	1967
AT5G08600	5	2786186	2790241	4055	+	100
AT5G08610	5	2790294	2794215	3921	+	925
AT5G08620	5	2794456	2797660	3204	+	312
AT5G08630	5	2798280	2803171	4891	-	397
AT5G08640	5	2803956	2805606	1650	+	787
AT5G08650	5	2806322	2813264	6942	-	7818
AT5G08660	5	2814086	2818019	3933	+	404
AT5G08670	5	2818116	2821176	3060	-	4597
AT5G08680	5	2821927	2824966	3039	+	3067
AT5G08690	5	2825712	2828662	2950	+	4796
AT5G08695	5	2829192	2834695	5503	+	1
AT5G08710	5	2834742	2838090	3348	-	432
AT5G08712	5	2838649	2838757	108	+	0
AT5G08717	5	2840627	2840728	101	+	0
AT5G08720	5	2841417	2845381	3964	-	2235
AT5G08730	5	2845823	2847415	1592	-	1
AT5G08740	5	2848505	2851428	2923	-	1516
AT5G08750	5	2851978	2854513	2535	+	346
AT5G08760	5	2854939	2855617	678	+	307
AT5G08770	5	2855637	2856540	903	-	64
AT5G08780	5	2856739	2859006	2267	+	128
AT5G08790	5	2858848	2860262	1414	-	234
AT5G09210	5	2862609	2865359	2750	-	0
AT5G09220	5	2866251	2869054	2803	+	3334
AT5G09225	5	2869361	2871190	1829	-	268
AT5G09230	5	2871376	2873789	2413	+	556
AT5G09240	5	2873659	2874849	1190	-	134
AT5G09250	5	2875231	2876575	1344	-	215
AT5G09260	5	2876752	2878700	1948	+	160
AT5G09270	5	2878883	2880816	1933	+	34
AT5G09280	5	2880422	2881597	1175	-	0
AT5G09290	5	2882426	2884229	1803	+	10
AT5G09300	5	2884178	2886863	2685	-	164
AT5G09310	5	2887191	2888538	1347	-	196
AT5G09320	5	2888654	2892016	3362	-	127
AT5G09330	5	2892364	2895422	3058	-	769
AT5G09340	5	2896674	2896914	240	-	0
AT5G09345	5	2898866	2898950	84	-	0
AT5G09350	5	2899122	2906146	7024	-	300
AT5G09360	5	2906425	2908658	2233	-	1
AT5G09370	5	2909362	2910545	1183	-	0
AT5G09380	5	2911312	2913136	1824	-	122
AT5G09390	5	2913533	2915923	2390	+	399
AT5G09400	5	2916215	2920759	4544	+	546
AT5G09410	5	2920826	2927420	6594	+	1768
AT5G09420	5	2928315	2931949	3634	+	84
AT5G09430	5	2932161	2933362	1201	+	3
AT5G09440	5	2938346	2939461	1115	+	109
AT5G09443	5	2940524	2941094	570	-	4
AT5G09445	5	2940675	2941251	576	+	5
AT5G09450	5	2941797	2943668	1871	+	322
AT5G09460	5	2943737	2946839	3102	-	0
AT5G09461	5	2943737	2946839	3102	-	0
AT5G09462	5	2943737	2946839	3102	-	0
AT5G09463	5	2943737	2946839	3102	-	0
AT5G09470	5	2949240	2950513	1273	-	17
AT5G09480	5	2950913	2951693	780	-	6
AT5G09490	5	2952215	2953245	1030	-	0
AT5G09500	5	2953912	2954918	1006	-	3
AT5G09510	5	2955112	2956673	1561	-	1780
AT5G09513	5	2957216	2958032	816	-	0
AT5G09520	5	2958291	2958856	565	-	4
AT5G09530	5	2959733	2961271	1538	-	55
AT5G09540	5	2962215	2963264	1049	-	29
AT5G09550	5	2963776	2966727	2951	+	0
AT5G09560	5	2967169	2969655	2486	+	0
AT5G09570	5	2970668	2972181	1513	+	10
AT5G09580	5	2972638	2974776	2138	+	41
AT5G09585	5	2974554	2975306	752	+	4
AT5G09590	5	2975547	2978750	3203	+	1080
AT5G09600	5	2978941	2980844	1903	+	35
AT5G09610	5	2981155	2982709	1554	+	1
AT5G09620	5	2983448	2985435	1987	-	1260
AT5G09630	5	2985855	2987652	1797	-	56
AT5G09640	5	2988313	2991156	2843	+	0
AT5G09650	5	2991148	2993213	2065	-	7400
AT5G09655	5	2993326	2993400	74	+	0
AT5G09660	5	2993443	2995675	2232	-	42868
AT5G09670	5	2995911	2998932	3021	-	37
AT5G09672	5	2995909	2998932	3023	-	0
AT5G09680	5	2999201	3000601	1400	-	412
AT5G09690	5	3000808	3003500	2692	-	86
AT5G09700	5	3003719	3005587	1868	-	2
AT5G09710	5	3007908	3010988	3080	-	18
AT5G09711	5	3011009	3011147	138	-	0
AT5G09720	5	3011734	3014399	2665	-	0
AT5G09730	5	3015246	3018262	3016	-	69
AT5G09740	5	3021951	3024756	2805	-	310
AT5G09750	5	3026400	3027075	675	-	1
AT5G09755	5	3030816	3030889	73	-	0
AT5G09760	5	3032374	3034543	2169	+	654
AT5G09770	5	3035039	3036561	1522	-	368
AT5G09780	5	3036955	3038484	1529	-	0
AT5G09790	5	3038977	3041044	2067	-	112
AT5G09795	5	3042139	3042683	544	+	0
AT5G09800	5	3043011	3044413	1402	-	14
AT5G09805	5	3047217	3047517	300	+	13
AT5G09810	5	3052096	3054614	2518	+	9703
AT5G09820	5	3055778	3057447	1669	-	452
AT5G09830	5	3057645	3058821	1176	-	337
AT5G09840	5	3058996	3061970	2974	+	58
AT5G09850	5	3063250	3065889	2639	-	1089
AT5G09860	5	3066561	3070933	4372	+	746
AT5G09870	5	3073355	3078262	4907	+	4900
AT5G09876	5	3079986	3080435	449	+	5
AT5G09880	5	3081441	3085264	3823	-	1264
AT5G09890	5	3085544	3089010	3466	-	682
AT5G09900	5	3089277	3092595	3318	-	2038
AT5G09910	5	3093271	3095156	1885	+	4
AT5G09920	5	3096182	3097575	1393	+	680
AT5G09930	5	3097642	3100241	2599	-	58
AT5G09940	5	3101191	3101833	642	+	0
AT5G09950	5	3102876	3105864	2988	-	23
AT5G09960	5	3106319	3107829	1510	+	402
AT5G09970	5	3111944	3114239	2295	+	10
AT5G09975	5	3118376	3118457	81	+	0
AT5G09976	5	3119103	3119573	470	+	6
AT5G09978	5	3120712	3121864	1152	+	1
AT5G09980	5	3122730	3123964	1234	+	7
AT5G09990	5	3124567	3125076	509	+	122
AT5G09995	5	3125037	3126378	1341	-	472
AT5G10000	5	3126708	3127155	447	+	0
AT5G10010	5	3127905	3131727	3822	+	847
AT5G10020	5	3133260	3137242	3982	+	615
AT5G10030	5	3137309	3144269	6960	-	444
AT5G10040	5	3143722	3144157	435	+	0
AT5G10050	5	3144199	3145730	1531	+	368
AT5G10060	5	3145748	3148379	2631	-	640
AT5G10070	5	3148521	3150434	1913	-	338
AT5G10080	5	3150842	3153380	2538	+	120
AT5G10090	5	3153721	3155745	2024	-	0
AT5G10100	5	3157979	3161708	3729	+	25
AT5G10110	5	3166438	3168297	1859	-	137
AT5G10120	5	3169731	3171147	1416	+	0
AT5G10130	5	3171298	3172528	1230	-	1
AT5G10140	5	3173496	3179448	5952	-	114
AT5G10150	5	3181982	3183865	1883	-	702
AT5G10160	5	3185745	3187312	1567	+	649
AT5G10170	5	3187276	3190251	2975	-	1091
AT5G10180	5	3193143	3197120	3977	+	4655
AT5G10190	5	3199132	3201363	2231	+	233
AT5G10200	5	3201517	3204709	3192	+	308
AT5G10210	5	3206139	3207136	997	+	3
AT5G10220	5	3206867	3208825	1958	-	0
AT5G10230	5	3209539	3211423	1884	-	0
AT5G10235	5	3212350	3212423	73	-	0
AT5G10240	5	3212687	3216466	3779	-	623
AT5G10250	5	3217027	3219368	2341	-	216
AT5G10260	5	3219990	3221515	1525	+	47
AT5G10270	5	3221606	3224765	3159	-	308
AT5G10278	5	3228240	3232723	4483	+	3
AT5G10280	5	3232568	3234210	1642	+	1
AT5G10290	5	3235294	3238719	3425	-	488
AT5G10300	5	3239616	3240870	1254	+	44
AT5G10310	5	3241517	3242266	749	-	65
AT5G10320	5	3243955	3246721	2766	-	183
AT5G10330	5	3247846	3250138	2292	-	120
AT5G10336	5	3251942	3252065	123	-	4
AT5G10340	5	3253121	3255045	1924	+	40
AT5G10350	5	3255304	3257807	2503	-	718
AT5G10360	5	3258473	3260234	1761	-	4630
AT5G10370	5	3261244	3267344	6100	+	209
AT5G10380	5	3267634	3268813	1179	+	426
AT5G10390	5	3268846	3269550	704	-	512
AT5G10400	5	3270288	3270952	664	-	998
AT5G10410	5	3271914	3273395	1481	+	95
AT5G10420	5	3273552	3276490	2938	-	0
AT5G10430	5	3277531	3278313	782	-	164
AT5G10440	5	3280515	3282411	1896	-	46
AT5G10450	5	3283852	3286347	2495	-	7256
AT5G10455	5	3287552	3287634	82	-	0
AT5G10460	5	3287780	3289948	2168	+	648
AT5G10470	5	3289924	3297390	7466	-	3880
AT5G10480	5	3297803	3300151	2348	-	1367
AT5G10490	5	3300224	3304761	4537	-	1249
AT5G10500	5	3305330	3308109	2779	+	0
AT5G10504	5	3311394	3311496	102	-	0
AT5G10510	5	3315528	3320202	4674	+	93
AT5G10520	5	3320369	3322910	2541	-	45
AT5G10525	5	3324701	3324774	73	+	0
AT5G10530	5	3324977	3326933	1956	-	71
AT5G10540	5	3328064	3334971	6907	+	1773
AT5G10550	5	3332854	3335232	2378	-	947
AT5G10560	5	3336254	3339366	3112	-	1014
AT5G10570	5	3341356	3342992	1636	+	59
AT5G10572	5	3343592	3343725	133	+	3
AT5G10580	5	3347420	3350071	2651	+	6
AT5G10590	5	3349133	3349468	335	-	0
AT5G10600	5	3351036	3352879	1843	+	153
AT5G10605	5	3352897	3353392	495	-	11
AT5G10610	5	3353506	3355124	1618	+	253
AT5G10620	5	3355319	3356615	1296	-	165
AT5G10625	5	3358786	3359781	995	+	1
AT5G10630	5	3360116	3364619	4503	+	507
AT5G10650	5	3364971	3368127	3156	-	274
AT5G10660	5	3370517	3372348	1831	+	10
AT5G10670	5	3372086	3372838	752	-	2
AT5G10680	5	3373583	3374309	726	+	27
AT5G10690	5	3374392	3377451	3059	-	1506
AT5G10695	5	3377662	3378221	559	+	43
AT5G10700	5	3378052	3378867	815	-	131
AT5G10710	5	3379006	3382958	3952	+	232
AT5G10720	5	3385900	3390686	4786	+	0
AT5G10730	5	3390613	3393178	2565	-	530
AT5G10740	5	3393568	3396200	2632	-	110
AT5G10745	5	3396474	3398063	1589	+	286
AT5G10750	5	3398950	3400156	1206	+	204
AT5G10760	5	3400341	3402207	1866	-	424
AT5G10770	5	3403109	3405448	2339	-	639
AT5G10780	5	3408278	3410070	1792	+	801
AT5G10790	5	3410538	3412633	2095	+	178
AT5G10800	5	3412653	3418382	5729	-	210
AT5G10810	5	3418665	3420635	1970	-	408
AT5G10820	5	3420826	3423221	2395	-	75
AT5G10830	5	3423685	3424720	1035	+	72
AT5G10840	5	3424687	3427878	3191	-	1630
AT5G10850	5	3428158	3428824	666	+	19
AT5G10860	5	3428890	3430470	1580	-	1548
AT5G10870	5	3430545	3432462	1917	-	165
AT5G10880	5	3432692	3433867	1175	+	8
AT5G10890	5	3434029	3435067	1038	-	18
AT5G10900	5	3435948	3439297	3349	-	130
AT5G10910	5	3439552	3441582	2030	+	622
AT5G10920	5	3441751	3444142	2391	+	1046
AT5G10930	5	3445365	3447114	1749	-	1142
AT5G10940	5	3448635	3454252	5617	-	920
AT5G10945	5	3456646	3456732	86	-	2
AT5G10946	5	3455606	3457306	1700	-	122
AT5G10950	5	3459272	3461734	2462	-	403
AT5G10960	5	3464217	3465687	1470	+	2256
AT5G10970	5	3469267	3470086	819	+	64
AT5G10980	5	3472404	3473466	1062	-	2612
AT5G10990	5	3476838	3477704	866	+	14
AT5G11000	5	3479028	3480425	1397	-	376
AT5G11010	5	3483703	3486267	2564	+	239
AT5G11020	5	3486241	3489234	2993	-	174
AT5G11027	5	3490425	3490542	117	-	0
AT5G11030	5	3490831	3495132	4301	-	355
AT5G11040	5	3495286	3500922	5636	+	821
AT5G11050	5	3502091	3503834	1743	+	0
AT5G11060	5	3510117	3513305	3188	+	1833
AT5G11070	5	3516216	3516995	779	-	398
AT5G11080	5	3517222	3520003	2781	-	1
AT5G11090	5	3524679	3525846	1167	+	427
AT5G11100	5	3532401	3535221	2820	+	46
AT5G11110	5	3536225	3541133	4908	+	158
AT5G11130	5	3542319	3544724	2405	+	0
AT5G11140	5	3545342	3546068	726	+	1
AT5G11150	5	3546285	3548111	1826	-	125
AT5G11160	5	3550519	3552207	1688	+	204
AT5G11170	5	3553116	3556977	3861	+	2139
AT5G11180	5	3557260	3561575	4315	-	0
AT5G11190	5	3564975	3566051	1076	+	14
AT5G11200	5	3567173	3571015	3842	+	1438
AT5G11210	5	3571213	3574537	3324	-	0
AT5G11220	5	3577056	3577978	922	+	0
AT5G11225	5	3578294	3578366	72	-	0
AT5G11230	5	3580561	3581617	1056	+	140
AT5G11240	5	3582539	3586986	4447	+	294
AT5G11242	5	3587251	3587928	677	-	29
AT5G11250	5	3587977	3591960	3983	-	398
AT5G11260	5	3593379	3594992	1613	-	163
AT5G11270	5	3595284	3597098	1814	-	823
AT5G11280	5	3597246	3598521	1275	+	433
AT5G11290	5	3599000	3600472	1472	+	1
AT5G11300	5	3601516	3605265	3749	-	47
AT5G11310	5	3606401	3608617	2216	+	39
AT5G11320	5	3611246	3613361	2115	-	23
AT5G11325	5	3617057	3617129	72	+	0
AT5G11330	5	3617214	3618897	1683	-	1563
AT5G11340	5	3619154	3621301	2147	+	298
AT5G11350	5	3621560	3625645	4085	+	406
AT5G11360	5	3625569	3626700	1131	-	2
AT5G11370	5	3627848	3629717	1869	+	0
AT5G11380	5	3629997	3633441	3444	+	695
AT5G11390	5	3633666	3636570	2904	+	317
AT5G11400	5	3636613	3638059	1446	-	0
AT5G11410	5	3638430	3639883	1453	-	31
AT5G11412	5	3640025	3640876	851	-	1
AT5G11416	5	3642779	3643010	231	-	0
AT5G11420	5	3644546	3647295	2749	+	4067
AT5G11425	5	3647958	3648168	210	-	3
AT5G11430	5	3648053	3652404	4351	+	424
AT5G11440	5	3652713	3654202	1489	-	1
AT5G11450	5	3654426	3656555	2129	+	2971
AT5G11460	5	3656810	3658931	2121	-	213
AT5G11470	5	3662716	3667923	5207	-	128
AT5G11475	5	3668999	3669072	73	-	0
AT5G11480	5	3669192	3671574	2382	-	2104
AT5G11490	5	3671787	3676452	4665	+	1180
AT5G11500	5	3676547	3679352	2805	+	2696
AT5G11510	5	3679807	3684877	5070	+	242
AT5G11520	5	3685088	3687764	2676	-	1473
AT5G11530	5	3695861	3701548	5687	+	512
AT5G11540	5	3703001	3704981	1980	-	24
AT5G11550	5	3708008	3709246	1238	-	753
AT5G11560	5	3709480	3714059	4579	-	2642
AT5G11570	5	3715942	3718276	2334	-	0
AT5G11580	5	3718809	3721334	2525	+	1315
AT5G11590	5	3727533	3728726	1193	-	179
AT5G11600	5	3733653	3735099	1446	-	227
AT5G11610	5	3735349	3738217	2868	-	337
AT5G11620	5	3739012	3740146	1134	-	23
AT5G11630	5	3740459	3742139	1680	+	107
AT5G11640	5	3741995	3743979	1984	+	262
AT5G11650	5	3744979	3747125	2146	+	665
AT5G11660	5	3748879	3750317	1438	+	0
AT5G11670	5	3754248	3758242	3994	+	3545
AT5G11680	5	3758857	3760851	1994	+	507
AT5G11690	5	3761243	3762346	1103	+	357
AT5G11700	5	3762461	3771416	8955	-	2843
AT5G11710	5	3772817	3776662	3845	+	2005
AT5G11720	5	3776813	3780146	3333	+	1135
AT5G11730	5	3780310	3782713	2403	+	304
AT5G11740	5	3784250	3784792	542	+	4384
AT5G11750	5	3787229	3789212	1983	+	223
AT5G11760	5	3789258	3790452	1194	+	301
AT5G11770	5	3790805	3793000	2195	-	2581
AT5G11780	5	3793857	3796142	2285	+	58
AT5G11790	5	3799549	3802792	3243	+	1821
AT5G11800	5	3803335	3808207	4872	-	324
AT5G11810	5	3808719	3810748	2029	+	432
AT5G11820	5	3810648	3811176	528	-	0
AT5G11830	5	3812519	3813044	525	-	0
AT5G11840	5	3813448	3814805	1357	-	1162
AT5G11850	5	3816345	3821072	4727	-	607
AT5G11860	5	3821802	3824275	2473	-	396
AT5G11870	5	3825419	3827491	2072	+	10
AT5G11880	5	3827525	3829986	2461	-	1736
AT5G11890	5	3831663	3832944	1281	+	303
AT5G11900	5	3833984	3836278	2294	+	611
AT5G11910	5	3836330	3838213	1883	-	454
AT5G11920	5	3839390	3842371	2981	+	30
AT5G11930	5	3844939	3845645	706	-	95
AT5G11940	5	3849282	3852417	3135	+	0
AT5G11950	5	3854915	3856983	2068	+	854
AT5G11960	5	3858578	3861515	2937	-	486
AT5G11970	5	3863070	3863755	685	-	268
AT5G11977	5	3867212	3867308	96	+	0
AT5G11980	5	3868651	3872269	3618	-	498
AT5G11990	5	3872650	3873196	546	-	30
AT5G12000	5	3873905	3876914	3009	-	0
AT5G12010	5	3877811	3879539	1728	-	379
AT5G12020	5	3882236	3882938	702	-	11
AT5G12030	5	3884106	3884737	631	-	7
AT5G12040	5	3885067	3888077	3010	+	1509
AT5G12043	5	3888759	3888894	135	-	0
AT5G12050	5	3890103	3891513	1410	+	442
AT5G12060	5	3894918	3895371	453	-	0
AT5G12070	5	3896949	3897408	459	-	0
AT5G12080	5	3898046	3901724	3678	-	469
AT5G12085	5	3904991	3909497	4506	-	0
AT5G12090	5	3909702	3910877	1175	+	0
AT5G12100	5	3911362	3914080	2718	+	197
AT5G12110	5	3914467	3915968	1501	+	801
AT5G12120	5	3916047	3918659	2612	-	1040
AT5G12130	5	3919593	3922485	2892	+	1494
AT5G12140	5	3922908	3924023	1115	-	3867
AT5G12150	5	3924125	3930305	6180	-	5403
AT5G12170	5	3931561	3935129	3568	+	369
AT5G12180	5	3937023	3939596	2573	+	6
AT5G12190	5	3940531	3941205	674	-	233
AT5G12200	5	3941527	3944811	3284	-	714
AT5G12210	5	3947102	3949866	2764	+	648
AT5G12220	5	3950137	3953144	3007	+	167
AT5G12230	5	3953147	3956185	3038	-	395
AT5G12235	5	3957739	3958051	312	+	2
AT5G12236	5	3958147	3958282	135	+	0
AT5G12240	5	3958900	3960845	1945	-	308
AT5G12250	5	3961105	3963522	2417	-	3905
AT5G12260	5	3966364	3968878	2514	+	237
AT5G12270	5	3970130	3971301	1171	-	1
AT5G12280	5	3971799	3973644	1845	-	6
AT5G12290	5	3974170	3978160	3990	-	438
AT5G12300	5	3978312	3979795	1483	-	72
AT5G12310	5	3980225	3982442	2217	-	784
AT5G12320	5	3982683	3984078	1395	+	310
AT5G12323	5	3985091	3985202	111	-	0
AT5G12330	5	3987374	3989833	2459	-	17
AT5G12340	5	3992947	3993610	663	-	0
AT5G12350	5	3995341	4000801	5460	+	671
AT5G12360	5	4000698	4002634	1936	-	44
AT5G12370	5	4002774	4008804	6030	-	1761
AT5G12380	5	4009222	4010687	1465	+	33
AT5G12390	5	4010442	4012039	1597	-	233
AT5G12400	5	4013812	4021543	7731	+	716
AT5G12410	5	4021814	4023988	2174	-	437
AT5G12420	5	4024313	4026741	2428	-	59
AT5G12430	5	4027978	4034086	6108	-	918
AT5G12440	5	4035293	4041334	6041	-	567
AT5G12450	5	4040936	4041128	192	+	2
AT5G12460	5	4043056	4044583	1527	+	0
AT5G12470	5	4044621	4047436	2815	-	5887
AT5G12480	5	4047514	4050533	3019	-	680
AT5G12840	5	4050690	4053606	2916	-	766
AT5G12850	5	4056186	4059580	3394	+	1177
AT5G12860	5	4059685	4061950	2265	-	12199
AT5G12870	5	4062723	4064992	2269	-	20
AT5G12880	5	4068518	4068962	444	-	0
AT5G12890	5	4069576	4071227	1651	-	321
AT5G12900	5	4071918	4074619	2701	-	420
AT5G12910	5	4077161	4077557	396	+	0
AT5G12920	5	4077772	4082634	4862	-	61
AT5G12930	5	4082889	4085297	2408	-	69
AT5G12940	5	4087711	4089004	1293	+	376
AT5G12950	5	4092952	4096975	4023	+	873
AT5G12960	5	4097700	4101668	3968	+	2
AT5G12970	5	4102134	4105327	3193	+	57
AT5G12980	5	4105382	4108184	2802	-	274
AT5G12990	5	4109233	4109768	535	-	0
AT5G13000	5	4110294	4121427	11133	-	3723
AT5G13010	5	4122409	4128861	6452	+	1371
AT5G13020	5	4129358	4132864	3506	-	1285
AT5G13030	5	4133203	4136688	3485	+	2657
AT5G13050	5	4136555	4138792	2237	-	416
AT5G13060	5	4142957	4147091	4134	+	202
AT5G13070	5	4147635	4149252	1617	+	415
AT5G13080	5	4149739	4151150	1411	-	0
AT5G13090	5	4153584	4154672	1088	-	535
AT5G13100	5	4156659	4158553	1894	+	889
AT5G13110	5	4158810	4161820	3010	+	554
AT5G13120	5	4162502	4164794	2292	-	4202
AT5G13130	5	4166608	4170643	4035	+	0
AT5G13140	5	4170559	4171794	1235	-	908
AT5G13150	5	4172828	4174930	2102	-	0
AT5G13160	5	4176578	4179885	3307	+	650
AT5G13170	5	4181041	4183306	2265	-	128
AT5G13180	5	4196571	4197848	1277	+	2036
AT5G13181	5	4198845	4198983	138	-	1
AT5G13190	5	4204816	4206405	1589	-	437
AT5G13200	5	4207003	4208289	1286	+	190
AT5G13205	5	4208520	4212591	4071	-	5
AT5G13210	5	4214503	4216686	2183	+	50
AT5G13220	5	4218887	4220883	1996	+	32
AT5G13225	5	4222002	4222085	83	-	1
AT5G13230	5	4222513	4224982	2469	+	12
AT5G13240	5	4225004	4227613	2609	-	579
AT5G13250	5	4234268	4241746	7478	+	22
AT5G13260	5	4243027	4246882	3855	+	777
AT5G13270	5	4246953	4249212	2259	-	114
AT5G13280	5	4249437	4252836	3399	+	1022
AT5G13290	5	4252841	4254894	2053	-	297
AT5G13300	5	4255600	4262314	6714	-	983
AT5G13310	5	4263492	4265337	1845	+	174
AT5G13320	5	4267509	4271051	3542	+	281
AT5G13330	5	4272059	4274660	2601	+	5
AT5G13340	5	4277938	4279446	1508	-	100
AT5G13350	5	4279883	4282287	2404	+	1
AT5G13360	5	4283355	4286295	2940	+	512
AT5G13370	5	4286818	4289554	2736	+	286
AT5G13380	5	4289838	4292441	2603	+	0
AT5G13390	5	4292746	4296725	3979	+	885
AT5G13400	5	4296687	4299223	2536	-	678
AT5G13410	5	4299704	4301780	2076	-	1235
AT5G13420	5	4301791	4304312	2521	-	1037
AT5G13430	5	4305124	4307513	2389	-	928
AT5G13440	5	4308128	4310181	2053	-	1526
AT5G13450	5	4310313	4312048	1735	-	4819
AT5G13460	5	4315758	4318360	2602	+	335
AT5G13470	5	4318523	4319924	1401	+	120
AT5G13475	5	4320276	4326003	5727	+	1
AT5G13480	5	4326472	4331971	5499	-	326
AT5G13485	5	4332946	4334683	1737	-	0
AT5G13490	5	4335466	4337680	2214	+	389
AT5G13500	5	4338154	4341003	2849	+	319
AT5G13510	5	4341261	4342095	834	+	6659
AT5G13520	5	4341947	4344671	2724	-	348
AT5G13530	5	4345525	4354551	9026	+	929
AT5G13548	5	4354885	4355128	243	-	0
AT5G13550	5	4355275	4359552	4277	-	489
AT5G13560	5	4360630	4366448	5818	-	1305
AT5G13570	5	4367298	4370265	2967	+	399
AT5G13580	5	4370691	4373201	2510	+	7
AT5G13590	5	4373238	4379356	6118	-	1087
AT5G13600	5	4380431	4382497	2066	+	0
AT5G13610	5	4383012	4385029	2017	+	272
AT5G13620	5	4385384	4386373	989	-	0
AT5G13630	5	4387333	4392227	4894	-	120848
AT5G13640	5	4393061	4397541	4480	+	1870
AT5G13650	5	4397745	4402692	4947	+	15803
AT5G13655	5	4403089	4404277	1188	+	1
AT5G13660	5	4404603	4407175	2572	+	196
AT5G13670	5	4407076	4409011	1935	-	0
AT5G13680	5	4410360	4415471	5111	-	509
AT5G13690	5	4415753	4420371	4618	+	731
AT5G13700	5	4420068	4423033	2965	-	17
AT5G13710	5	4423694	4427058	3364	-	1579
AT5G13720	5	4427782	4429133	1351	+	750
AT5G13730	5	4429109	4430837	1728	-	1018
AT5G13740	5	4432305	4436668	4363	+	1298
AT5G13750	5	4438199	4441579	3380	+	346
AT5G13760	5	4442013	4444935	2922	+	298
AT5G13770	5	4445422	4447476	2054	+	4033
AT5G13780	5	4447258	4448646	1388	-	792
AT5G13790	5	4449013	4450843	1830	-	20
AT5G13800	5	4451836	4454623	2787	-	1422
AT5G13810	5	4455332	4457019	1687	+	919
AT5G13820	5	4460893	4464666	3773	+	62
AT5G13825	5	4464966	4466052	1086	-	0
AT5G13830	5	4467362	4468487	1125	+	12
AT5G13840	5	4468507	4471466	2959	-	366
AT5G13845	5	4471047	4471119	72	+	0
AT5G13850	5	4471276	4472855	1579	+	1220
AT5G13860	5	4473088	4474402	1314	-	85
AT5G13870	5	4474975	4477045	2070	-	140
AT5G13880	5	4477353	4478109	756	-	38
AT5G13887	5	4479396	4479591	195	-	1
AT5G13890	5	4478842	4480928	2086	-	204
AT5G13900	5	4481231	4481889	658	-	1
AT5G13910	5	4482449	4483085	636	-	5
AT5G13917	5	4485167	4485311	144	-	0
AT5G13920	5	4485930	4487433	1503	-	56
AT5G13930	5	4488687	4490264	1577	+	5082
AT5G13940	5	4490262	4495585	5323	-	3
AT5G13950	5	4495970	4500725	4755	-	1631
AT5G13960	5	4501446	4506188	4742	+	257
AT5G13970	5	4506231	4507842	1611	-	274
AT5G13980	5	4508495	4514666	6171	+	2637
AT5G13990	5	4514567	4516892	2325	-	4
AT5G14000	5	4518007	4519300	1293	+	14
AT5G14010	5	4522148	4522935	787	+	0
AT5G14011	5	4523015	4523114	99	-	0
AT5G14020	5	4523519	4525863	2344	-	0
AT5G14030	5	4526783	4529614	2831	+	1563
AT5G14035	5	4530473	4530546	73	+	0
AT5G14040	5	4530642	4533070	2428	-	4814
AT5G14050	5	4533260	4535301	2041	+	498
AT5G14060	5	4535400	4539193	3793	+	6937
AT5G14070	5	4541835	4542514	679	+	13
AT5G14080	5	4543100	4545256	2156	-	200
AT5G14090	5	4547201	4549417	2216	+	103
AT5G14100	5	4549437	4551843	2406	-	306
AT5G14105	5	4551973	4553051	1078	-	141
AT5G14110	5	4553805	4554382	577	-	2
AT5G14120	5	4555948	4558710	2762	+	1686
AT5G14130	5	4558703	4560067	1364	-	5
AT5G14140	5	4561463	4563671	2208	+	106
AT5G14150	5	4565171	4566988	1817	-	1
AT5G14160	5	4567332	4568467	1135	+	2
AT5G14170	5	4568508	4570947	2439	-	803
AT5G14180	5	4571336	4574462	3126	-	3
AT5G14200	5	4576201	4578402	2201	+	5418
AT5G14210	5	4578377	4581374	2997	-	1379
AT5G14220	5	4583251	4587448	4197	-	831
AT5G14230	5	4591740	4595964	4224	+	171
AT5G14240	5	4595927	4597660	1733	-	559
AT5G14250	5	4597877	4600761	2884	+	581
AT5G14260	5	4600990	4604482	3492	+	5195
AT5G14270	5	4604612	4608905	4293	+	658
AT5G14280	5	4609122	4611444	2322	+	161
AT5G14290	5	4612096	4614401	2305	-	1
AT5G14300	5	4613101	4614023	922	+	0
AT5G14310	5	4615317	4617615	2298	+	330
AT5G14320	5	4617649	4618912	1263	-	9291
AT5G14330	5	4619796	4620551	755	-	10
AT5G14340	5	4623366	4624847	1481	+	0
AT5G14345	5	4626174	4626722	548	-	0
AT5G14350	5	4627139	4628703	1564	-	80
AT5G14360	5	4630996	4631742	746	+	10
AT5G14370	5	4631890	4633713	1823	-	639
AT5G14380	5	4635796	4636676	880	-	9
AT5G14390	5	4637311	4639756	2445	-	379
AT5G14400	5	4643520	4646382	2862	+	2
AT5G14410	5	4646780	4647444	664	-	201
AT5G14420	5	4648110	4651309	3199	-	543
AT5G14430	5	4652979	4655973	2994	+	1655
AT5G14440	5	4655902	4657907	2005	-	430
AT5G14450	5	4658440	4660175	1735	+	367
AT5G14460	5	4660058	4662668	2610	-	1241
AT5G14470	5	4662802	4664657	1855	-	11
AT5G14480	5	4667773	4670106	2333	+	160
AT5G14490	5	4670778	4672072	1294	-	1
AT5G14495	5	4673899	4673971	72	+	0
AT5G14500	5	4674232	4676765	2533	-	493
AT5G14510	5	4677972	4679194	1222	-	58
AT5G14520	5	4680695	4684404	3709	-	727
AT5G14530	5	4684619	4686909	2290	-	107
AT5G14540	5	4687146	4689674	2528	-	828
AT5G14545	5	4691021	4691137	116	+	0
AT5G14550	5	4691005	4694055	3050	-	472
AT5G14560	5	4693963	4694086	123	+	0
AT5G14565	5	4694625	4697013	2388	+	17
AT5G14570	5	4695083	4697078	1995	-	27
AT5G14580	5	4697239	4703084	5845	-	89
AT5G14590	5	4703297	4706738	3441	-	1231
AT5G14600	5	4706944	4709143	2199	+	149
AT5G14602	5	4709435	4709871	436	+	1
AT5G14610	5	4710562	4715069	4507	+	561
AT5G14620	5	4715252	4718704	3452	-	295
AT5G14640	5	4719076	4722279	3203	-	1014
AT5G14650	5	4724449	4726513	2064	+	47
AT5G14660	5	4726640	4728746	2106	-	1645
AT5G14670	5	4729318	4730495	1177	+	0
AT5G14680	5	4730906	4733081	2175	-	423
AT5G14690	5	4733761	4734547	786	-	43
AT5G14700	5	4740251	4743446	3195	-	205
AT5G14710	5	4746331	4747934	1603	+	195
AT5G14720	5	4747859	4753592	5733	-	2002
AT5G14730	5	4756217	4757657	1440	+	18
AT5G14740	5	4757971	4762615	4644	+	44449
AT5G14750	5	4763451	4764738	1287	-	16
AT5G14760	5	4768467	4772153	3686	+	483
AT5G14770	5	4772880	4775697	2817	-	101
AT5G14780	5	4776942	4779494	2552	+	1298
AT5G14790	5	4782945	4785805	2860	+	504
AT5G14800	5	4785959	4787839	1880	-	1172
AT5G14810	5	4789000	4791151	2151	+	0
AT5G14820	5	4792071	4793868	1797	-	0
AT5G14830	5	4794768	4798102	3334	+	41
AT5G14840	5	4798328	4800738	2410	-	120
AT5G14850	5	4801896	4804990	3094	-	274
AT5G14860	5	4805886	4807759	1873	+	3
AT5G14870	5	4808090	4810897	2807	-	18
AT5G14880	5	4814243	4817667	3424	+	1504
AT5G14890	5	4817948	4821808	3860	+	47
AT5G14900	5	4822675	4823581	906	-	0
AT5G14910	5	4823713	4825373	1660	+	4989
AT5G14920	5	4826478	4827980	1502	+	237
AT5G14930	5	4828639	4830955	2316	+	168
AT5G14940	5	4831747	4834395	2648	-	220
AT5G14950	5	4837151	4841942	4791	-	776
AT5G14960	5	4843947	4846394	2447	+	40
AT5G14970	5	4847277	4848867	1590	+	5106
AT5G14980	5	4849599	4850583	984	+	0
AT5G14990	5	4850667	4853087	2420	+	0
AT5G14995	5	4853412	4853718	306	+	0
AT5G15000	5	4854874	4855171	297	+	0
AT5G15008	5	4856974	4857139	165	-	0
AT5G15010	5	4857170	4858959	1789	+	91
AT5G15020	5	4859126	4866031	6905	-	1734
AT5G15022	5	4866236	4866939	703	+	0
AT5G15030	5	4866691	4869133	2442	-	68
AT5G15040	5	4869907	4870253	346	-	0
AT5G15050	5	4871638	4873598	1960	-	531
AT5G15060	5	4874331	4875949	1618	-	1
AT5G15070	5	4876514	4885821	9307	+	188
AT5G15080	5	4886113	4888788	2675	+	454
AT5G15090	5	4888963	4891603	2640	-	4090
AT5G15100	5	4892158	4893937	1779	-	3
AT5G15110	5	4895749	4897682	1933	+	0
AT5G15120	5	4898736	4900581	1845	+	37
AT5G15130	5	4904346	4907094	2748	+	0
AT5G15140	5	4908685	4910799	2114	+	2
AT5G15150	5	4913698	4915892	2194	-	17
AT5G15160	5	4921265	4922648	1383	-	144
AT5G15170	5	4926093	4929502	3409	-	363
AT5G15175	5	4929559	4929633	74	+	0
AT5G15180	5	4930518	4932363	1845	+	32
AT5G15190	5	4932819	4933577	758	-	41
AT5G15200	5	4934882	4936408	1526	-	6675
AT5G15210	5	4937578	4939007	1429	-	530
AT5G15220	5	4941243	4942483	1240	-	226
AT5G15230	5	4944899	4946216	1317	+	1419
AT5G15240	5	4947666	4950340	2674	+	57
AT5G15250	5	4950358	4952803	2445	-	2
AT5G15254	5	4953094	4953274	180	-	2
AT5G15260	5	4953439	4954932	1493	-	156
AT5G15265	5	4956500	4957533	1033	+	0
AT5G15270	5	4958336	4962013	3677	+	772
AT5G15280	5	4962292	4966141	3849	+	297
AT5G15290	5	4967010	4968035	1025	+	0
AT5G15300	5	4968162	4970034	1872	-	13
AT5G15310	5	4974670	4976227	1557	+	626
AT5G15320	5	4977534	4978894	1360	+	904
AT5G15330	5	4980487	4982231	1744	+	190
AT5G15340	5	4982272	4984144	1872	-	10
AT5G15350	5	4984958	4986239	1281	-	1269
AT5G15360	5	4987436	4989182	1746	-	1
AT5G15380	5	4991346	4994826	3480	+	0
AT5G15390	5	4995144	4997403	2259	+	651
AT5G15400	5	4997610	5003140	5530	-	1401
AT5G15410	5	5003306	5006882	3576	-	1887
AT5G15420	5	5007825	5008964	1139	-	0
AT5G15430	5	5009875	5011737	1862	+	6
AT5G15440	5	5012060	5014281	2221	+	554
AT5G15450	5	5014211	5018347	4136	-	5891
AT5G15460	5	5018710	5020703	1993	-	245
AT5G15470	5	5021009	5024742	3733	-	554
AT5G15480	5	5025951	5027160	1209	-	2
AT5G15490	5	5027638	5030194	2556	-	1114
AT5G15500	5	5031675	5033500	1825	-	290
AT5G15510	5	5034004	5036795	2791	+	115
AT5G15520	5	5037020	5038172	1152	-	215
AT5G15530	5	5038750	5040840	2090	+	396
AT5G15540	5	5047886	5057411	9525	-	905
AT5G15546	5	5058240	5058568	328	+	0
AT5G15550	5	5058748	5062087	3339	-	369
AT5G15560	5	5064050	5064889	839	+	0
AT5G15570	5	5066374	5068199	1825	+	226
AT5G15580	5	5068300	5072492	4192	-	521
AT5G15581	5	5071620	5072492	872	+	1
AT5G15600	5	5078199	5079091	892	+	182
AT5G15610	5	5079512	5082205	2693	+	1014
AT5G15620	5	5082464	5083991	1527	+	0
AT5G15630	5	5084703	5086792	2089	+	73
AT5G15640	5	5087370	5090040	2670	+	176
AT5G15650	5	5092156	5094494	2338	+	2068
AT5G15660	5	5095651	5097041	1390	+	0
AT5G15670	5	5099594	5100407	813	+	0
AT5G15680	5	5100983	5111029	10046	-	1218
AT5G15690	5	5113822	5114477	655	-	0
AT5G15700	5	5115299	5121840	6541	-	183
AT5G15710	5	5122491	5124375	1884	+	196
AT5G15720	5	5124524	5126181	1657	-	2
AT5G15725	5	5127403	5128338	935	+	0
AT5G15730	5	5130502	5133187	2685	+	259
AT5G15740	5	5134526	5137626	3100	-	917
AT5G15750	5	5141102	5142866	1764	+	257
AT5G15760	5	5143052	5144053	1001	+	165
AT5G15770	5	5144092	5144542	450	-	82
AT5G15780	5	5144726	5146403	1677	-	1475
AT5G15790	5	5148743	5151433	2690	+	194
AT5G15800	5	5151333	5154154	2821	-	31
AT5G15802	5	5156348	5157545	1197	-	215
AT5G15805	5	5157638	5157712	74	+	0
AT5G15810	5	5157797	5161358	3561	+	434
AT5G15815	5	5161511	5161583	72	+	0
AT5G15820	5	5161723	5163030	1307	+	70
AT5G15830	5	5168542	5169361	819	+	106
AT5G15833	5	5169989	5170131	142	+	0
AT5G15840	5	5171181	5172758	1577	-	15
AT5G15845	5	5173184	5177889	4705	+	12
AT5G15850	5	5176090	5177897	1807	-	68
AT5G15853	5	5178106	5178307	201	+	6
AT5G15860	5	5178504	5181383	2879	-	411
AT5G15870	5	5182640	5184878	2238	-	246
AT5G15880	5	5185777	5187706	1929	+	378
AT5G15890	5	5187586	5189348	1762	-	4
AT5G15900	5	5189490	5192070	2580	-	27
AT5G15910	5	5193110	5195396	2286	+	803
AT5G15920	5	5195682	5199559	3877	+	331
AT5G15930	5	5199710	5202452	2742	+	429
AT5G15940	5	5202800	5204875	2075	+	4
AT5G15948	5	5205870	5208036	2166	+	0
AT5G15950	5	5205868	5208036	2168	+	3
AT5G15960	5	5209897	5210727	830	+	24
AT5G15970	5	5211910	5212665	755	+	888
AT5G15980	5	5213080	5215620	2540	+	395
AT5G15990	5	5217774	5218267	493	+	0
AT5G15995	5	5218643	5220913	2270	-	0
AT5G16000	5	5224142	5227288	3146	+	934
AT5G16010	5	5227923	5229116	1193	+	2226
AT5G16020	5	5229691	5232241	2550	+	1
AT5G16023	5	5232730	5232886	156	-	7
AT5G16030	5	5238177	5240748	2571	+	6698
AT5G16040	5	5240674	5243329	2655	-	225
AT5G16050	5	5243744	5245820	2076	-	2464
AT5G16060	5	5246119	5247431	1312	+	216
AT5G16070	5	5247353	5251179	3826	-	915
AT5G16080	5	5252314	5253618	1304	-	24
AT5G16090	5	5255796	5257230	1434	-	0
AT5G16100	5	5258550	5259719	1169	-	0
AT5G16110	5	5260603	5262840	2237	-	1098
AT5G16120	5	5265632	5267979	2347	+	607
AT5G16130	5	5268420	5270156	1736	+	3496
AT5G16140	5	5270169	5271921	1752	-	462
AT5G16150	5	5272556	5275815	3259	+	4568
AT5G16160	5	5275694	5276606	912	-	28
AT5G16170	5	5277866	5279818	1952	+	28
AT5G16180	5	5279883	5282898	3015	+	762
AT5G16190	5	5283549	5286293	2744	-	117
AT5G16200	5	5289564	5290202	638	-	79
AT5G16210	5	5290866	5297974	7108	-	1080
AT5G16220	5	5298302	5300610	2308	-	441
AT5G16230	5	5303347	5306068	2721	+	15
AT5G16235	5	5304493	5305828	1335	-	0
AT5G16240	5	5306806	5309932	3126	+	244
AT5G16250	5	5310094	5310951	857	-	623
AT5G16260	5	5311206	5315767	4561	+	566
AT5G16270	5	5316298	5322696	6398	+	1754
AT5G16280	5	5323133	5331685	8552	-	1270
AT5G16285	5	5332829	5333102	273	-	0
AT5G16286	5	5333180	5333321	141	-	0
AT5G16290	5	5333763	5337745	3982	+	1037
AT5G16300	5	5337973	5342432	4459	+	938
AT5G16310	5	5342390	5344285	1895	-	274
AT5G16320	5	5344501	5346019	1518	+	98
AT5G16330	5	5346162	5346977	815	-	0
AT5G16336	5	5348416	5348774	358	-	0
AT5G16340	5	5349093	5350907	1814	-	36
AT5G16350	5	5352625	5355070	2445	+	74
AT5G16360	5	5355081	5356300	1219	-	33
AT5G16370	5	5356604	5358511	1907	-	202
AT5G16375	5	5358915	5358997	82	+	0
AT5G16380	5	5359362	5360710	1348	-	59
AT5G16390	5	5360800	5363126	2326	-	1969
AT5G16400	5	5363660	5365334	1674	-	3481
AT5G16410	5	5365668	5367385	1717	-	53
AT5G16420	5	5368033	5369641	1608	+	39
AT5G16430	5	5370349	5370607	258	+	0
AT5G16440	5	5371626	5373735	2109	+	702
AT5G16450	5	5373882	5375459	1577	+	289
AT5G16453	5	5375454	5375999	545	-	2
AT5G16460	5	5376960	5378533	1573	-	0
AT5G16470	5	5379415	5380040	625	+	1653
AT5G16480	5	5381112	5382897	1785	-	146
AT5G16486	5	5383596	5384226	630	-	3
AT5G16490	5	5384304	5385213	909	-	38
AT5G16500	5	5386674	5389165	2491	-	0
AT5G16505	5	5390005	5392383	2378	+	516
AT5G16510	5	5392604	5394568	1964	+	539
AT5G16520	5	5394607	5397455	2848	-	333
AT5G16530	5	5400734	5402626	1892	+	117
AT5G16540	5	5403187	5405154	1967	+	1343
AT5G16550	5	5405349	5406887	1538	+	435
AT5G16560	5	5406862	5411424	4562	-	254
AT5G16567	5	5418890	5419085	195	+	0
AT5G16570	5	5421742	5424566	2824	-	195
AT5G16580	5	5425888	5427472	1584	-	2
AT5G16590	5	5431680	5434134	2454	+	806
AT5G16600	5	5438290	5440245	1955	+	62
AT5G16610	5	5444921	5448313	3392	-	340
AT5G16620	5	5450695	5454535	3840	+	2051
AT5G16630	5	5454800	5459617	4817	+	498
AT5G16640	5	5460975	5463017	2042	+	25
AT5G16650	5	5463176	5465331	2155	-	865
AT5G16660	5	5465483	5467063	1580	-	1365
AT5G16680	5	5467372	5473506	6134	-	928
AT5G16690	5	5474385	5479951	5566	+	151
AT5G16700	5	5480762	5483045	2283	+	0
AT5G16710	5	5483287	5485081	1794	+	5600
AT5G16715	5	5485352	5493520	8168	+	2543
AT5G16720	5	5494227	5496810	2583	+	209
AT5G16730	5	5497642	5500845	3203	+	1385
AT5G16740	5	5501043	5502856	1813	-	0
AT5G16750	5	5504345	5509343	4998	-	308
AT5G16760	5	5509673	5511232	1559	+	916
AT5G16770	5	5514883	5516936	2053	+	16
AT5G16780	5	5517489	5522258	4769	-	1014
AT5G16790	5	5522494	5523963	1469	-	71
AT5G16800	5	5524281	5526589	2308	-	379
AT5G16810	5	5526741	5529930	3189	-	945
AT5G16820	5	5530272	5532889	2617	+	217
AT5G16830	5	5532845	5535252	2407	-	522
AT5G16840	5	5535868	5538250	2382	+	1096
AT5G16850	5	5538179	5543543	5364	-	19
AT5G16860	5	5543833	5546386	2553	+	22
AT5G16870	5	5546810	5548736	1926	-	194
AT5G16880	5	5548913	5551463	2550	+	1418
AT5G16890	5	5551628	5554917	3289	+	236
AT5G16900	5	5555253	5559715	4462	+	2
AT5G16910	5	5561678	5565580	3902	+	375
AT5G16920	5	5567010	5568128	1118	+	0
AT5G16930	5	5568392	5571859	3467	+	114
AT5G16940	5	5571549	5572405	856	-	83
AT5G16950	5	5572575	5573070	495	+	80
AT5G16960	5	5574280	5575910	1630	-	0
AT5G16970	5	5576167	5578075	1908	-	948
AT5G16980	5	5579053	5580929	1876	-	93
AT5G16990	5	5581657	5584029	2372	-	770
AT5G17000	5	5584800	5587063	2263	-	372
AT5G17010	5	5587350	5592469	5119	-	542
AT5G17020	5	5594723	5602955	8232	+	2143
AT5G17030	5	5603132	5604738	1606	-	0
AT5G17040	5	5605283	5606970	1687	-	14
AT5G17050	5	5607787	5609492	1705	-	1038
AT5G17060	5	5610805	5613065	2260	+	236
AT5G17070	5	5613367	5616138	2771	-	340
AT5G17073	5	5617431	5617572	141	+	0
AT5G17080	5	5619593	5620949	1356	+	0
AT5G17090	5	5621248	5622476	1228	-	0
AT5G17100	5	5623020	5624800	1780	-	0
AT5G17110	5	5626562	5627474	912	-	0
AT5G17120	5	5628528	5629324	796	-	0
AT5G17125	5	5630537	5634764	4227	+	0
AT5G17130	5	5636971	5637534	563	+	0
AT5G17140	5	5637829	5638273	444	+	0
AT5G17150	5	5638474	5639592	1118	-	4
AT5G17160	5	5639645	5642513	2868	-	305
AT5G17165	5	5643117	5647783	4666	-	26
AT5G17170	5	5649192	5651158	1966	+	7404
AT5G17180	5	5651435	5651807	372	+	0
AT5G17190	5	5652217	5652983	766	+	569
AT5G17200	5	5653523	5655336	1813	-	1
AT5G17210	5	5656382	5658147	1765	+	70
AT5G17220	5	5658459	5659386	927	+	520
AT5G17230	5	5659573	5662865	3292	-	11004
AT5G17233	5	5664159	5664273	114	+	0
AT5G17240	5	5666851	5668907	2056	+	96
AT5G17250	5	5668899	5673516	4617	-	233
AT5G17260	5	5675322	5677912	2590	-	19
AT5G17262	5	5678376	5678508	132	+	0
AT5G17270	5	5679990	5685597	5607	+	197
AT5G17280	5	5686298	5686895	597	+	274
AT5G17290	5	5686944	5689900	2956	-	306
AT5G17300	5	5690226	5692902	2676	-	536
AT5G17310	5	5696644	5700922	4278	-	2338
AT5G17320	5	5703379	5707637	4258	-	0
AT5G17330	5	5711011	5715075	4064	+	85
AT5G17340	5	5715623	5716268	645	-	0
AT5G17350	5	5718771	5719608	837	+	27
AT5G17360	5	5720375	5721659	1284	+	53
AT5G17370	5	5721635	5724719	3084	-	105
AT5G17380	5	5724758	5726746	1988	-	906
AT5G17390	5	5727639	5728688	1049	+	1
AT5G17400	5	5728788	5730376	1588	-	381
AT5G17410	5	5730609	5736695	6086	+	400
AT5G17420	5	5736629	5741465	4836	-	215
AT5G17430	5	5742541	5745568	3027	-	0
AT5G17440	5	5749761	5753643	3882	+	445
AT5G17450	5	5755321	5756888	1567	+	173
AT5G17460	5	5757097	5759795	2698	-	44
AT5G17470	5	5760965	5761406	441	-	0
AT5G17480	5	5762688	5762940	252	+	0
AT5G17490	5	5764062	5766077	2015	-	25
AT5G17500	5	5767378	5769719	2341	+	2
AT5G17510	5	5769972	5772395	2423	-	505
AT5G17520	5	5772582	5775345	2763	-	579
AT5G17523	5	5775585	5777327	1742	-	0
AT5G17530	5	5777594	5782150	4556	+	1255
AT5G17540	5	5781986	5783706	1720	-	17
AT5G17550	5	5786509	5788239	1730	-	514
AT5G17560	5	5788453	5789923	1470	+	1706
AT5G17570	5	5792925	5794792	1867	+	149
AT5G17580	5	5795301	5797178	1877	+	200
AT5G17590	5	5797370	5797949	579	-	2
AT5G17600	5	5799904	5801244	1340	-	343
AT5G17610	5	5803935	5805295	1360	+	227
AT5G17620	5	5805754	5808561	2807	-	233
AT5G17630	5	5809333	5810962	1629	+	1103
AT5G17640	5	5810934	5813284	2350	-	307
AT5G17650	5	5816697	5818347	1650	-	375
AT5G17660	5	5818547	5820864	2317	-	415
AT5G17670	5	5821059	5822736	1677	+	1625
AT5G17680	5	5822998	5827153	4155	+	22
AT5G17690	5	5827170	5829682	2512	-	287
AT5G17700	5	5830580	5833901	3321	-	315
AT5G17710	5	5839342	5841728	2386	-	2737
AT5G17720	5	5845933	5847653	1720	+	0
AT5G17725	5	5848295	5850501	2206	-	0
AT5G17730	5	5852497	5853999	1502	-	0
AT5G17740	5	5856234	5857934	1700	-	0
AT5G17750	5	5858694	5860041	1347	-	0
AT5G17760	5	5860420	5862422	2002	-	160
AT5G17770	5	5864250	5866709	2459	-	1999
AT5G17780	5	5867282	5869050	1768	-	56
AT5G17790	5	5869709	5872718	3009	-	655
AT5G17795	5	5875003	5875219	216	-	0
AT5G17800	5	5877188	5879331	2143	+	13
AT5G17810	5	5880442	5884770	4328	-	0
AT5G17820	5	5887905	5890193	2288	-	1
AT5G17830	5	5893381	5895572	2191	+	17
AT5G17840	5	5895673	5897150	1477	-	438
AT5G17847	5	5898658	5898787	129	+	0
AT5G17850	5	5899252	5900932	1680	+	41
AT5G17860	5	5902393	5904380	1987	-	31
AT5G17870	5	5907774	5908335	561	+	4956
AT5G17880	5	5908873	5913099	4226	-	483
AT5G17890	5	5916969	5923355	6386	+	839
AT5G17900	5	5924706	5926901	2195	+	349
AT5G17910	5	5927361	5932775	5414	+	817
AT5G17920	5	5935037	5939487	4450	+	39206
AT5G17930	5	5939997	5944430	4433	-	482
AT5G17950	5	5944552	5944959	407	-	0
AT5G17960	5	5945664	5947464	1800	-	0
AT5G17970	5	5948998	5951619	2621	-	2
AT5G17980	5	5953595	5956745	3150	+	119
AT5G17990	5	5957212	5959905	2693	+	1823
AT5G18000	5	5959899	5961642	1743	-	5
AT5G18005	5	5962697	5962769	72	-	0
AT5G18010	5	5962896	5963405	509	-	36
AT5G18015	5	5965970	5966042	72	-	0
AT5G18020	5	5966182	5966677	495	-	251
AT5G18030	5	5968434	5968938	504	+	250
AT5G18037	5	5971100	5971566	466	-	0
AT5G18040	5	5972418	5974156	1738	+	241
AT5G18050	5	5974566	5975054	488	-	50
AT5G18060	5	5975953	5976496	543	+	92
AT5G18065	5	5978677	5980376	1699	+	77
AT5G18070	5	5981006	5982934	1928	+	202
AT5G18080	5	5983839	5984112	273	+	108
AT5G18085	5	5984376	5984448	72	+	0
AT5G18090	5	5985364	5987165	1801	+	4
AT5G18100	5	5987186	5988885	1699	+	790
AT5G18110	5	5988743	5990681	1938	-	597
AT5G18120	5	5990955	5993936	2981	+	325
AT5G18130	5	5995478	5997498	2020	+	410
AT5G18140	5	5998174	5999888	1714	+	701
AT5G18150	5	6000013	6000331	318	-	92
AT5G18160	5	6002769	6003909	1140	+	0
AT5G18170	5	6006038	6008472	2434	+	1272
AT5G18180	5	6008560	6009605	1045	-	11
AT5G18190	5	6009966	6014689	4723	-	1619
AT5G18200	5	6015224	6016782	1558	+	262
AT5G18202	5	6017005	6017378	373	+	1
AT5G18210	5	6017864	6019993	2129	+	86
AT5G18220	5	6018913	6020453	1540	-	5
AT5G18230	5	6021443	6027249	5806	-	3261
AT5G18240	5	6028284	6030802	2518	-	103
AT5G18245	5	6028284	6033231	4947	+	102
AT5G18250	5	6033701	6035380	1679	+	124
AT5G18255	5	6035610	6037633	2023	+	78
AT5G18260	5	6036201	6038106	1905	-	17
AT5G18270	5	6040918	6042938	2020	-	18
AT5G18280	5	6050513	6054875	4362	-	693
AT5G18290	5	6055027	6058368	3341	-	50
AT5G18300	5	6057772	6058216	444	+	24
AT5G18310	5	6061698	6063148	1450	+	245
AT5G18320	5	6064430	6066186	1756	-	4
AT5G18330	5	6068473	6070042	1569	-	0
AT5G18340	5	6070639	6072310	1671	-	27
AT5G18350	5	6074068	6078569	4501	-	0
AT5G18360	5	6080048	6083027	2979	-	121
AT5G18362	5	6083087	6084362	1275	-	42
AT5G18370	5	6085035	6088926	3891	-	176
AT5G18380	5	6090048	6090761	713	-	4180
AT5G18390	5	6090953	6092545	1592	+	187
AT5G18400	5	6092681	6095053	2372	-	423
AT5G18403	5	6095342	6095715	373	+	0
AT5G18404	5	6096148	6096406	258	+	39
AT5G18407	5	6096746	6097158	412	+	11
AT5G18410	5	6097270	6105031	7761	-	1383
AT5G18420	5	6105479	6109385	3906	-	537
AT5G18430	5	6110254	6112029	1775	-	186
AT5G18440	5	6112849	6115932	3083	+	271
AT5G18450	5	6116096	6117020	924	-	0
AT5G18460	5	6122866	6126721	3855	+	589
AT5G18470	5	6127796	6129285	1489	+	47
AT5G18475	5	6129236	6131015	1779	-	104
AT5G18480	5	6131202	6133906	2704	-	503
AT5G18490	5	6134151	6136765	2614	-	149
AT5G18500	5	6138382	6141630	3248	+	1596
AT5G18510	5	6141777	6143886	2109	-	3
AT5G18520	5	6144962	6146570	1608	+	1395
AT5G18525	5	6146742	6153742	7000	-	427
AT5G18540	5	6153868	6156166	2298	+	27
AT5G18550	5	6160177	6163130	2953	+	420
AT5G18560	5	6164586	6165991	1405	-	0
AT5G18570	5	6171660	6174833	3173	-	1659
AT5G18580	5	6174995	6178401	3406	+	1174
AT5G18590	5	6178353	6182761	4408	-	847
AT5G18600	5	6183257	6183954	697	-	1035
AT5G18610	5	6192442	6195753	3311	+	343
AT5G18620	5	6195916	6202166	6250	-	1021
AT5G18630	5	6202608	6205737	3129	+	1185
AT5G18633	5	6205812	6210644	4832	+	4
AT5G18636	5	6211267	6212371	1104	+	1
AT5G18640	5	6212801	6215782	2981	+	492
AT5G18650	5	6217911	6220702	2791	+	1022
AT5G18660	5	6220780	6222228	1448	-	3865
AT5G18661	5	6222519	6222678	159	-	1
AT5G18670	5	6225955	6228132	2177	+	851
AT5G18680	5	6228164	6230537	2373	-	533
AT5G18690	5	6233518	6234206	688	-	128
AT5G18700	5	6235095	6240733	5638	-	636
AT5G18710	5	6241133	6243479	2346	+	15
AT5G18720	5	6244004	6246241	2237	+	1
AT5G18730	5	6246762	6249405	2643	+	20
AT5G18740	5	6249726	6252042	2316	+	18
AT5G18748	5	6254559	6254769	210	-	0
AT5G18750	5	6254619	6257932	3313	+	132
AT5G18755	5	6258144	6258216	72	+	0
AT5G18760	5	6258294	6260929	2635	-	785
AT5G18770	5	6261351	6263436	2085	+	172
AT5G18780	5	6264269	6266174	1905	+	141
AT5G18790	5	6266091	6266907	816	-	130
AT5G18800	5	6267052	6268638	1586	+	846
AT5G18810	5	6268717	6271325	2608	-	18
AT5G18820	5	6271488	6274327	2839	+	185
AT5G18830	5	6275989	6280681	4692	+	624
AT5G18840	5	6282880	6286707	3827	+	16
AT5G18850	5	6286846	6287590	744	+	221
AT5G18860	5	6290675	6295811	5136	+	482
AT5G18870	5	6298385	6300289	1904	+	0
AT5G18880	5	6300534	6301422	888	-	0
AT5G18890	5	6301651	6304088	2437	+	0
AT5G18900	5	6304214	6306290	2076	-	409
AT5G18910	5	6306827	6309419	2592	-	0
AT5G18920	5	6310063	6310846	783	+	38
AT5G18930	5	6311724	6313323	1599	-	107
AT5G18940	5	6325785	6328354	2569	+	689
AT5G18950	5	6328378	6329970	1592	-	129
AT5G18960	5	6330378	6333071	2693	+	621
AT5G18970	5	6333210	6334642	1432	-	245
AT5G18980	5	6334831	6338100	3269	-	340
AT5G18990	5	6340075	6341614	1539	+	0
AT5G19000	5	6342219	6344794	2575	+	629
AT5G19010	5	6344788	6348212	3424	-	1324
AT5G19015	5	6349761	6350949	1188	-	0
AT5G19020	5	6352770	6354828	2058	-	38
AT5G19025	5	6355219	6357083	1864	-	81
AT5G19030	5	6357382	6359124	1742	-	166
AT5G19040	5	6361836	6363413	1577	-	20
AT5G19050	5	6369266	6371904	2638	+	330
AT5G19060	5	6372798	6374903	2105	+	34
AT5G19070	5	6375244	6377660	2416	+	249
AT5G19080	5	6378338	6380605	2267	+	87
AT5G19090	5	6387488	6390024	2536	+	1343
AT5G19095	5	6401238	6401309	71	+	0
AT5G19097	5	6403276	6407608	4332	-	14
AT5G19100	5	6408241	6409417	1176	-	3
AT5G19110	5	6411560	6413170	1610	-	3
AT5G19120	5	6414487	6415907	1420	+	299
AT5G19130	5	6415919	6419035	3116	-	492
AT5G19140	5	6423152	6426166	3014	+	13593
AT5G19150	5	6423304	6428467	5163	-	406
AT5G19151	5	6428529	6429672	1143	+	48
AT5G19160	5	6430485	6432728	2243	+	16
AT5G19165	5	6433769	6438242	4473	-	0
AT5G19170	5	6445244	6447419	2175	+	59
AT5G19172	5	6448114	6448732	618	-	0
AT5G19175	5	6449802	6450245	443	-	0
AT5G19180	5	6453275	6456014	2739	+	804
AT5G19190	5	6457259	6458031	772	+	1376
AT5G19200	5	6458952	6460856	1904	+	125
AT5G19210	5	6461390	6463866	2476	+	336
AT5G19220	5	6463823	6466831	3008	-	6731
AT5G19221	5	6464233	6466349	2116	+	13
AT5G19230	5	6467526	6468484	958	+	24
AT5G19240	5	6470128	6471062	934	+	1105
AT5G19250	5	6471905	6472945	1040	+	1843
AT5G19257	5	6477553	6477652	99	+	0
AT5G19260	5	6479399	6480446	1047	-	216
AT5G19270	5	6485616	6487009	1393	-	0
AT5G19280	5	6488318	6493439	5121	+	492
AT5G19290	5	6494054	6495284	1230	+	1504
AT5G19300	5	6495575	6498214	2639	+	104
AT5G19310	5	6498778	6503432	4654	+	348
AT5G19315	5	6504537	6504900	363	+	0
AT5G19320	5	6505109	6507435	2326	-	323
AT5G19330	5	6507793	6512759	4966	-	1321
AT5G19340	5	6515091	6516205	1114	-	60
AT5G19350	5	6518837	6521474	2637	+	785
AT5G19360	5	6521715	6523780	2065	-	0
AT5G19370	5	6524119	6526706	2587	-	2121
AT5G19380	5	6526806	6530592	3786	-	181
AT5G19390	5	6531537	6538483	6946	+	2153
AT5G19400	5	6540002	6545015	5013	+	1820
AT5G19410	5	6545236	6547111	1875	-	2
AT5G19420	5	6547637	6553242	5605	-	302
AT5G19430	5	6553702	6555848	2146	+	453
AT5G19440	5	6556419	6558342	1923	+	744
AT5G19450	5	6558425	6562000	3575	-	945
AT5G19460	5	6562970	6565632	2662	+	632
AT5G19470	5	6566302	6568806	2504	+	92
AT5G19473	5	6569193	6570873	1680	+	0
AT5G19480	5	6571500	6573525	2025	+	278
AT5G19485	5	6573591	6576490	2899	-	391
AT5G19490	5	6576768	6578273	1505	-	15
AT5G19500	5	6578951	6581945	2994	+	736
AT5G19510	5	6581657	6583248	1591	-	3693
AT5G19520	5	6585420	6588936	3516	+	4
AT5G19530	5	6588957	6591363	2406	-	824
AT5G19540	5	6595701	6597889	2188	+	3146
AT5G19550	5	6598016	6601819	3803	+	1345
AT5G19560	5	6603290	6606448	3158	+	1
AT5G19570	5	6606699	6607203	504	+	129
AT5G19580	5	6607370	6609626	2256	-	70
AT5G19590	5	6610729	6612103	1374	-	1898
AT5G19600	5	6612814	6616997	4183	-	145
AT5G19610	5	6617745	6622045	4300	-	2
AT5G19620	5	6623203	6627846	4643	+	1142
AT5G19630	5	6627974	6630024	2050	-	234
AT5G19640	5	6636459	6638590	2131	+	0
AT5G19650	5	6639631	6640297	666	-	16
AT5G19660	5	6642003	6646530	4527	-	499
AT5G19670	5	6646718	6649498	2780	+	231
AT5G19680	5	6649604	6651935	2331	+	404
AT5G19690	5	6652515	6658411	5896	+	1903
AT5G19700	5	6660820	6662347	1527	-	2
AT5G19710	5	6664744	6666107	1363	-	0
AT5G19720	5	6667663	6668587	924	+	0
AT5G19729	5	6670308	6670422	114	-	0
AT5G19730	5	6670457	6673282	2825	+	655
AT5G19740	5	6673932	6676859	2927	+	239
AT5G19750	5	6677068	6679384	2316	+	648
AT5G19760	5	6679305	6682001	2696	-	8150
AT5G19770	5	6682492	6684579	2087	-	2229
AT5G19780	5	6687073	6689171	2098	+	1594
AT5G19790	5	6689107	6690040	933	-	0
AT5G19800	5	6690647	6690938	291	+	0
AT5G19810	5	6693051	6693801	750	+	2
AT5G19820	5	6695223	6701311	6088	-	2568
AT5G19830	5	6703149	6705249	2100	+	82
AT5G19840	5	6705324	6709792	4468	+	195
AT5G19850	5	6709733	6711673	1940	-	1248
AT5G19855	5	6711971	6713636	1665	-	2474
AT5G19860	5	6714263	6715875	1612	-	1072
AT5G19870	5	6716072	6717110	1038	-	24
AT5G19875	5	6718340	6718995	655	+	124
AT5G19880	5	6720383	6722475	2092	-	2
AT5G19890	5	6724114	6725923	1809	-	0
AT5G19900	5	6728159	6730045	1886	-	640
AT5G19910	5	6731184	6732990	1806	-	159
AT5G19920	5	6733215	6737373	4158	-	144
AT5G19930	5	6737522	6739390	1868	-	207
AT5G19940	5	6739623	6740957	1334	+	16130
AT5G19950	5	6740776	6743773	2997	-	133
AT5G19960	5	6743925	6746339	2414	+	191
AT5G19970	5	6747549	6748641	1092	+	42
AT5G19980	5	6749704	6751070	1366	-	367
AT5G19990	5	6752005	6755080	3075	+	1158
AT5G20000	5	6756632	6759750	3118	+	588
AT5G20010	5	6760283	6762094	1811	+	5119
AT5G20020	5	6762723	6764671	1948	+	2263
AT5G20030	5	6764726	6766669	1943	-	41
AT5G20040	5	6767796	6771190	3394	-	606
AT5G20045	5	6771557	6772188	631	-	1
AT5G20050	5	6774301	6775845	1544	+	255
AT5G20060	5	6776166	6779614	3448	+	1009
AT5G20070	5	6779853	6782482	2629	+	1640
AT5G20080	5	6782565	6786664	4099	+	1368
AT5G20090	5	6787001	6788654	1653	-	1284
AT5G20100	5	6790055	6790725	670	+	0
AT5G20110	5	6791486	6793346	1860	-	140
AT5G20120	5	6795365	6797172	1807	+	244
AT5G20130	5	6797439	6798899	1460	+	662
AT5G20140	5	6798831	6800977	2146	-	2107
AT5G20150	5	6802371	6803625	1254	+	454
AT5G20160	5	6803781	6805201	1420	-	716
AT5G20165	5	6805593	6807327	1734	-	430
AT5G20170	5	6807480	6810798	3318	-	395
AT5G20180	5	6810919	6812146	1227	+	335
AT5G20181	5	6812337	6812559	222	+	0
AT5G20190	5	6814092	6815379	1287	+	2553
AT5G20200	5	6816706	6821810	5104	+	664
AT5G20220	5	6821989	6825981	3992	+	529
AT5G20225	5	6825260	6825940	680	-	1
AT5G20230	5	6826505	6827629	1124	+	52
AT5G20240	5	6829041	6831515	2474	+	3
AT5G20250	5	6833658	6836782	3124	+	317
AT5G20260	5	6836805	6839532	2727	-	3
AT5G20270	5	6840832	6842858	2026	-	965
AT5G20280	5	6844713	6850154	5441	-	3939
AT5G20290	5	6851451	6853066	1615	-	9585
AT5G20300	5	6853415	6856977	3562	-	710
AT5G20310	5	6857552	6859145	1593	+	0
AT5G20320	5	6859217	6869307	10090	-	592
AT5G20330	5	6871560	6873112	1552	+	0
AT5G20340	5	6874786	6875851	1065	+	0
AT5G20350	5	6876588	6881270	4682	+	1273
AT5G20360	5	6881618	6884630	3012	-	492
AT5G20370	5	6886930	6887458	528	-	0
AT5G20380	5	6887724	6892432	4708	-	1807
AT5G20390	5	6892830	6894195	1365	-	0
AT5G20400	5	6894843	6896349	1506	+	39
AT5G20410	5	6896575	6898783	2208	+	238
AT5G20420	5	6899014	6904167	5153	-	37
AT5G20430	5	6904704	6905391	687	+	0
AT5G20440	5	6908645	6909996	1351	+	0
AT5G20447	5	6910416	6910515	99	+	0
AT5G20450	5	6910548	6913317	2769	-	195
AT5G20460	5	6914302	6914855	553	+	0
AT5G20470	5	6916323	6920120	3797	-	0
AT5G20480	5	6922479	6925887	3408	+	100
AT5G20490	5	6926622	6937506	10884	-	2565
AT5G20500	5	6938597	6939848	1251	+	941
AT5G20510	5	6939812	6942908	3096	-	171
AT5G20520	5	6943153	6946454	3301	-	601
AT5G20540	5	6947842	6952038	4196	+	208
AT5G20550	5	6952416	6953896	1480	-	2
AT5G20560	5	6955367	6956381	1014	+	0
AT5G20570	5	6956659	6958311	1652	-	704
AT5G20580	5	6958596	6962804	4208	-	430
AT5G20590	5	6963437	6966226	2789	+	563
AT5G20600	5	6966177	6968033	1856	-	328
AT5G20610	5	6968689	6972995	4306	+	642
AT5G20620	5	6973070	6974946	1876	-	1323
AT5G20630	5	6975103	6975993	890	-	3344
AT5G20635	5	6979212	6981935	2723	-	84
AT5G20640	5	6984239	6985365	1126	+	4
AT5G20650	5	6985297	6986037	740	-	916
AT5G20660	5	6986234	6991043	4809	+	1046
AT5G20670	5	6993113	6993873	760	-	54
AT5G20680	5	6998102	7001910	3808	+	356
AT5G20690	5	7002452	7004551	2099	+	0
AT5G20700	5	7005843	7007117	1274	-	11589
AT5G20710	5	7010521	7014249	3728	+	21
AT5G20720	5	7014668	7016698	2030	+	12669
AT5G20730	5	7016444	7022113	5669	-	965
AT5G20736	5	7024328	7024472	144	-	0
AT5G20740	5	7025685	7026532	847	-	273
AT5G20750	5	7027772	7031290	3518	+	0
AT5G20760	5	7032526	7033189	663	+	0
AT5G20770	5	7034187	7034883	696	-	0
AT5G20780	5	7035604	7038469	2865	-	0
AT5G20790	5	7039910	7040654	744	-	50
AT5G20800	5	7041113	7042676	1563	+	0
AT5G20810	5	7043897	7045712	1815	+	6
AT5G20820	5	7046750	7047396	646	-	30
AT5G20830	5	7050225	7055195	4970	-	1412
AT5G20840	5	7061102	7069219	8117	-	1436
AT5G20850	5	7070585	7072951	2366	-	60
AT5G20852	5	7073529	7073601	72	-	0
AT5G20854	5	7073942	7074014	72	-	0
AT5G20856	5	7074355	7074427	72	-	0
AT5G20858	5	7074771	7074843	72	-	0
AT5G20860	5	7076889	7079077	2188	-	7
AT5G20870	5	7079974	7081769	1795	-	39
AT5G20880	5	7082103	7083226	1123	-	54
AT5G20885	5	7083964	7084734	770	-	258
AT5G20890	5	7086652	7090081	3429	-	2170
AT5G20900	5	7090703	7092539	1836	+	945
AT5G20910	5	7092511	7094446	1935	-	220
AT5G20920	5	7094717	7097116	2399	-	1429
AT5G20930	5	7097907	7103198	5291	+	398
AT5G20935	5	7103469	7104023	554	+	430
AT5G20940	5	7103926	7106701	2775	-	17
AT5G20950	5	7107375	7111349	3974	-	1500
AT5G20960	5	7116737	7122774	6037	+	150
AT5G20970	5	7122799	7124001	1202	+	172
AT5G20980	5	7122799	7128359	5560	-	333
AT5G20990	5	7128474	7133476	5002	-	1004
AT5G21005	5	7135433	7135676	243	-	0
AT5G21010	5	7136008	7138681	2673	+	344
AT5G21020	5	7138761	7139661	900	+	3590
AT5G21030	5	7139891	7144272	4381	-	11
AT5G21040	5	7144876	7147277	2401	-	607
AT5G21050	5	7147889	7148957	1068	+	8
AT5G21060	5	7148977	7152876	3899	-	881
AT5G21070	5	7156172	7157775	1603	+	364
AT5G21080	5	7158034	7163188	5154	-	2
AT5G21090	5	7164602	7167255	2653	+	3522
AT5G21100	5	7168183	7170928	2745	+	2309
AT5G21105	5	7172686	7177841	5155	+	688
AT5G21110	5	7178614	7179086	472	+	0
AT5G21120	5	7182620	7184342	1722	+	0
AT5G21125	5	7185047	7185428	381	-	0
AT5G21130	5	7185914	7186919	1005	+	0
AT5G21140	5	7187095	7189619	2524	-	67
AT5G21150	5	7192238	7198324	6086	+	9
AT5G21160	5	7198740	7204097	5357	-	1107
AT5G21170	5	7205561	7208496	2935	+	466
AT5G21222	5	7208642	7213894	5252	+	1747
AT5G21274	5	7214499	7216019	1520	-	1030
AT5G21280	5	7263993	7265678	1685	-	57
AT5G21326	5	7217339	7222007	4668	+	1561
AT5G21378	5	7222056	7222128	72	-	0
AT5G21430	5	7222225	7223621	1396	+	3744
AT5G21482	5	7226726	7230210	3484	+	642
AT5G21535	5	7236282	7236651	369	-	0
AT5G21900	5	7238196	7240482	2286	+	103
AT5G21910	5	7240658	7241746	1088	+	28
AT5G21920	5	7241200	7242857	1657	-	1658
AT5G21930	5	7243001	7249170	6169	+	2977
AT5G21940	5	7249267	7250539	1272	-	357
AT5G21950	5	7253920	7255944	2024	-	63
AT5G21960	5	7258362	7259308	946	-	0
AT5G21970	5	7261599	7263513	1914	+	85
AT5G21990	5	7273168	7276563	3395	+	917
AT5G22000	5	7277182	7280255	3073	+	1263
AT5G22010	5	7280388	7287364	6976	-	563
AT5G22020	5	7287735	7289482	1747	-	459
AT5G22030	5	7289702	7296344	6642	-	673
AT5G22040	5	7296998	7299120	2122	-	264
AT5G22044	5	7299988	7300324	336	+	0
AT5G22050	5	7301230	7303418	2188	+	711
AT5G22060	5	7303621	7305797	2176	-	1168
AT5G22070	5	7307893	7310367	2474	+	643
AT5G22080	5	7310170	7313670	3500	-	704
AT5G22090	5	7314582	7321683	7101	-	3487
AT5G22100	5	7328960	7330930	1970	+	152
AT5G22110	5	7330824	7334205	3381	-	113
AT5G22120	5	7334377	7336814	2437	-	432
AT5G22130	5	7337157	7340052	2895	-	130
AT5G22140	5	7340121	7341906	1785	-	108
AT5G22150	5	7342566	7345956	3390	+	0
AT5G22160	5	7346943	7349255	2312	+	0
AT5G22170	5	7350574	7351190	616	+	0
AT5G22180	5	7353069	7353706	637	-	0
AT5G22190	5	7354163	7354688	525	+	0
AT5G22200	5	7355687	7356871	1184	+	1
AT5G22210	5	7358819	7359988	1169	+	373
AT5G22220	5	7360534	7364454	3920	+	112
AT5G22240	5	7364688	7365279	591	+	9
AT5G22250	5	7365531	7366778	1247	-	27
AT5G22260	5	7367634	7370295	2661	-	0
AT5G22270	5	7372232	7373102	870	-	48
AT5G22280	5	7373994	7375719	1725	-	379
AT5G22290	5	7375922	7377644	1722	-	237
AT5G22300	5	7379198	7381935	2737	+	893
AT5G22310	5	7383628	7385734	2106	-	44
AT5G22315	5	7387887	7387959	72	+	0
AT5G22320	5	7387984	7390520	2536	-	360
AT5G22330	5	7390795	7394194	3399	-	438
AT5G22340	5	7394443	7396875	2432	+	1765
AT5G22350	5	7397385	7400937	3552	-	418
AT5G22355	5	7401706	7403825	2119	+	0
AT5G22360	5	7404003	7405765	1762	-	509
AT5G22370	5	7406096	7408702	2606	+	258
AT5G22380	5	7408776	7410102	1326	-	5
AT5G22390	5	7418115	7419249	1134	-	745
AT5G22400	5	7422715	7425467	2752	-	274
AT5G22410	5	7426313	7427964	1651	+	0
AT5G22420	5	7429902	7432586	2684	+	0
AT5G22430	5	7433789	7434935	1146	+	1
AT5G22440	5	7435075	7436686	1611	-	1524
AT5G22450	5	7437144	7443347	6203	-	965
AT5G22460	5	7443507	7445546	2039	-	66
AT5G22470	5	7446973	7451049	4076	+	0
AT5G22480	5	7451504	7456685	5181	-	254
AT5G22490	5	7458942	7461049	2107	-	4
AT5G22500	5	7470442	7474120	3678	+	327
AT5G22510	5	7474809	7477941	3132	-	3744
AT5G22520	5	7478929	7479527	598	+	10
AT5G22530	5	7480526	7481194	668	+	2
AT5G22540	5	7481477	7482953	1476	-	1
AT5G22545	5	7483252	7483811	559	+	0
AT5G22550	5	7483869	7485482	1613	-	2
AT5G22555	5	7489421	7490503	1082	+	0
AT5G22560	5	7491355	7493176	1821	-	0
AT5G22570	5	7495538	7496784	1246	-	0
AT5G22580	5	7502673	7503449	776	+	1066
AT5G22590	5	7504535	7505838	1303	+	0
AT5G22600	5	7510022	7511788	1766	+	1
AT5G22608	5	7513172	7514453	1281	+	5
AT5G22610	5	7515216	7516916	1700	+	0
AT5G22620	5	7517466	7520281	2815	-	2260
AT5G22630	5	7524341	7526160	1819	+	316
AT5G22640	5	7529367	7533784	4417	+	4032
AT5G22650	5	7534016	7536273	2257	+	2405
AT5G22660	5	7536289	7537990	1701	-	6
AT5G22670	5	7538191	7539685	1494	-	0
AT5G22680	5	7540040	7540748	708	-	0
AT5G22690	5	7541270	7545182	3912	+	171
AT5G22700	5	7545515	7547595	2080	-	434
AT5G22720	5	7547796	7551174	3378	-	240
AT5G22730	5	7551428	7553452	2024	-	225
AT5G22740	5	7554927	7560073	5146	-	916
AT5G22750	5	7565036	7571083	6047	-	182
AT5G22760	5	7571634	7577866	6232	+	1010
AT5G22770	5	7579262	7588249	8987	-	744
AT5G22780	5	7589853	7598049	8196	-	754
AT5G22788	5	7602912	7603499	587	-	12
AT5G22790	5	7599145	7601690	2545	-	175
AT5G22791	5	7603499	7604822	1323	-	0
AT5G22792	5	7606734	7607667	933	-	0
AT5G22794	5	7608241	7611591	3350	+	51
AT5G22800	5	7616072	7619981	3909	-	4980
AT5G22810	5	7621567	7623367	1800	+	6
AT5G22820	5	7623439	7626975	3536	-	203
AT5G22830	5	7627596	7630993	3397	+	1404
AT5G22840	5	7630716	7633223	2507	-	130
AT5G22850	5	7633436	7636567	3131	-	511
AT5G22860	5	7639317	7642984	3667	-	439
AT5G22870	5	7647055	7647679	624	-	22
AT5G22875	5	7650581	7651776	1195	+	290
AT5G22880	5	7651956	7652622	666	-	2326
AT5G22890	5	7653256	7654724	1468	-	0
AT5G22900	5	7657223	7659868	2645	+	0
AT5G22910	5	7660926	7663829	2903	-	0
AT5G22920	5	7664990	7667265	2275	+	447
AT5G22930	5	7668228	7669315	1087	-	47
AT5G22940	5	7676937	7679179	2242	+	216
AT5G22950	5	7681304	7682903	1599	+	509
AT5G22960	5	7684013	7685052	1039	-	0
AT5G22970	5	7686252	7686837	585	-	0
AT5G22980	5	7688083	7690648	2565	+	0
AT5G22990	5	7691493	7692468	975	-	0
AT5G23000	5	7696134	7697927	1793	+	6
AT5G23010	5	7703091	7706896	3805	+	6849
AT5G23020	5	7718120	7721839	3719	+	776
AT5G23027	5	7725572	7725728	156	-	0
AT5G23030	5	7726787	7727809	1022	+	0
AT5G23035	5	7728019	7728455	436	-	0
AT5G23040	5	7729316	7731036	1720	-	2846
AT5G23050	5	7731268	7735439	4171	-	325
AT5G23060	5	7736589	7738535	1946	-	21639
AT5G23065	5	7740609	7740697	88	-	0
AT5G23070	5	7741897	7742978	1081	+	352
AT5G23080	5	7742939	7748933	5994	-	541
AT5G23090	5	7749069	7750544	1475	+	192
AT5G23100	5	7753433	7754759	1326	+	201
AT5G23110	5	7758306	7775671	17365	+	1464
AT5G23120	5	7778120	7780628	2508	+	11101
AT5G23130	5	7781195	7783601	2406	+	120
AT5G23140	5	7783737	7785497	1760	+	696
AT5G23150	5	7785834	7792489	6655	+	867
AT5G23155	5	7794141	7795010	869	+	17
AT5G23160	5	7795255	7796346	1091	-	2
AT5G23170	5	7798196	7799448	1252	-	62
AT5G23180	5	7801473	7801890	417	+	0
AT5G23190	5	7803140	7805815	2675	-	8
AT5G23200	5	7807182	7809164	1982	+	290
AT5G23210	5	7810682	7815039	4357	+	522
AT5G23212	5	7815404	7815882	478	-	0
AT5G23220	5	7819815	7820676	861	-	0
AT5G23230	5	7825881	7826611	730	-	2
AT5G23235	5	7826027	7828724	2697	+	2
AT5G23240	5	7826731	7828724	1993	-	0
AT5G23250	5	7830359	7832843	2484	+	514
AT5G23260	5	7836095	7838505	2410	+	0
AT5G23270	5	7838905	7841026	2121	+	19
AT5G23280	5	7842970	7844275	1305	+	1021
AT5G23290	5	7846080	7847643	1563	+	270
AT5G23300	5	7847586	7850404	2818	-	232
AT5G23310	5	7850522	7852532	2010	+	875
AT5G23320	5	7853367	7853961	594	+	41
AT5G23330	5	7854128	7855813	1685	+	332
AT5G23340	5	7856188	7858319	2131	+	329
AT5G23350	5	7858252	7859387	1135	-	21
AT5G23360	5	7861739	7862697	958	+	25
AT5G23370	5	7863330	7864271	941	-	17
AT5G23380	5	7866741	7870302	3561	+	95
AT5G23390	5	7870512	7874505	3993	-	493
AT5G23395	5	7874671	7876427	1756	-	178
AT5G23400	5	7880334	7882634	2300	+	185
AT5G23405	5	7882847	7884360	1513	-	123
AT5G23410	5	7885590	7886785	1195	-	71
AT5G23411	5	7886643	7886790	147	+	0
AT5G23413	5	7886970	7887685	715	-	0
AT5G23420	5	7888512	7890180	1668	-	574
AT5G23430	5	7893670	7900387	6717	-	304
AT5G23440	5	7903044	7903845	801	-	763
AT5G23450	5	7904707	7909585	4878	-	1685
AT5G23460	5	7912768	7913505	737	+	69
AT5G23470	5	7913860	7914769	909	+	0
AT5G23480	5	7916313	7919278	2965	+	77
AT5G23490	5	7919437	7926628	7191	+	352
AT5G23510	5	7926944	7929338	2394	+	151
AT5G23520	5	7929350	7931793	2443	-	352
AT5G23530	5	7932965	7934436	1471	-	160
AT5G23535	5	7935400	7937372	1972	+	311
AT5G23540	5	7937668	7939575	1907	+	1353
AT5G23550	5	7939610	7941628	2018	-	273
AT5G23570	5	7943123	7946050	2927	+	485
AT5G23575	5	7946309	7950253	3944	+	434
AT5G23580	5	7950201	7952532	2331	-	397
AT5G23590	5	7953528	7955640	2112	-	344
AT5G23600	5	7955993	7956632	639	+	12
AT5G23610	5	7957339	7960272	2933	-	658
AT5G23630	5	7960477	7967946	7469	-	1409
AT5G23640	5	7968258	7968502	244	-	0
AT5G23650	5	7969811	7971019	1208	+	0
AT5G23660	5	7971650	7973925	2275	-	492
AT5G23665	5	7981397	7981469	72	+	0
AT5G23670	5	7981640	7985398	3758	+	885
AT5G23680	5	7985353	7986851	1498	-	182
AT5G23690	5	7987539	7990547	3008	+	156
AT5G23700	5	7992787	7996420	3633	+	0
AT5G23710	5	7996455	7997479	1024	-	146
AT5G23720	5	7998229	8002840	4611	+	342
AT5G23730	5	8005233	8006630	1397	+	318
AT5G23740	5	8008009	8009436	1427	-	2540
AT5G23750	5	8009805	8011619	1814	-	728
AT5G23760	5	8013084	8014228	1144	-	343
AT5G23770	5	8014380	8016913	2533	-	70
AT5G23780	5	8017191	8019026	1835	-	24
AT5G23790	5	8020103	8021597	1494	-	3
AT5G23800	5	8022215	8024689	2474	-	121
AT5G23810	5	8028377	8030816	2439	+	72
AT5G23820	5	8031267	8033020	1753	+	763
AT5G23830	5	8033737	8034930	1193	+	0
AT5G23840	5	8035766	8036982	1216	+	0
AT5G23850	5	8038051	8040938	2887	+	169
AT5G23860	5	8042875	8044819	1944	+	1186
AT5G23870	5	8045843	8050175	4332	-	108
AT5G23880	5	8052503	8058354	5851	+	325
AT5G23890	5	8058688	8063201	4513	+	2634
AT5G23900	5	8063984	8065523	1539	-	1882
AT5G23903	5	8066418	8067096	678	+	0
AT5G23908	5	8068070	8068280	210	-	1
AT5G23910	5	8068451	8072991	4540	+	304
AT5G23920	5	8073223	8074170	947	-	1256
AT5G23930	5	8074624	8075998	1374	-	24
AT5G23940	5	8076328	8079793	3465	-	1556
AT5G23950	5	8082743	8083604	861	+	4
AT5G23955	5	8085081	8090422	5341	+	159
AT5G23960	5	8092968	8095285	2317	+	0
AT5G23970	5	8096289	8097660	1371	+	1
AT5G23980	5	8098051	8101323	3272	-	37
AT5G23989	5	8105232	8105325	93	+	0
AT5G23990	5	8105564	8108590	3026	-	0
AT5G24000	5	8110312	8112710	2398	-	306
AT5G24010	5	8113794	8116615	2821	+	209
AT5G24020	5	8116679	8118030	1351	+	651
AT5G24030	5	8118316	8122784	4468	-	240
AT5G24040	5	8126011	8127336	1325	-	0
AT5G24050	5	8128352	8129402	1050	-	0
AT5G24060	5	8129978	8133301	3323	-	495
AT5G24065	5	8133459	8134077	618	+	3
AT5G24070	5	8134300	8135991	1691	-	0
AT5G24080	5	8139252	8141122	1870	-	5
AT5G24090	5	8143698	8145252	1554	-	2
AT5G24100	5	8148615	8151308	2693	+	1
AT5G24105	5	8151923	8152867	944	+	243
AT5G24110	5	8153114	8154709	1595	-	8
AT5G24120	5	8157550	8160229	2679	-	2776
AT5G24130	5	8162212	8164066	1854	+	0
AT5G24140	5	8164346	8167673	3327	-	1
AT5G24150	5	8172315	8175431	3116	-	4181
AT5G24155	5	8180117	8181027	910	-	305
AT5G24160	5	8183074	8186640	3566	-	244
AT5G24165	5	8188559	8189276	717	+	2263
AT5G24170	5	8189482	8191392	1910	-	141
AT5G24180	5	8195599	8197119	1520	+	0
AT5G24190	5	8199756	8201051	1295	+	1
AT5G24200	5	8203002	8205793	2791	+	49
AT5G24205	5	8210821	8213086	2265	-	30
AT5G24206	5	8213625	8214689	1064	-	13
AT5G24210	5	8217334	8219619	2285	+	891
AT5G24220	5	8225860	8227551	1691	+	0
AT5G24230	5	8228891	8230964	2073	+	7
AT5G24240	5	8230941	8234150	3209	-	10
AT5G24250	5	8233695	8234652	957	-	0
AT5G24260	5	8234722	8238244	3522	-	614
AT5G24270	5	8238533	8243357	4824	-	16
AT5G24280	5	8251377	8262154	10777	-	133
AT5G24290	5	8263131	8265741	2610	-	15
AT5G24300	5	8266789	8271205	4416	+	5447
AT5G24310	5	8273545	8276526	2981	+	153
AT5G24313	5	8276784	8277402	618	-	0
AT5G24314	5	8277699	8279240	1541	+	2466
AT5G24316	5	8279178	8279964	786	-	0
AT5G24318	5	8281975	8284001	2026	-	88
AT5G24320	5	8284435	8288039	3604	-	628
AT5G24330	5	8295146	8297068	1922	-	45
AT5G24340	5	8297304	8300374	3070	+	253
AT5G24350	5	8301104	8310895	9791	+	1191
AT5G24352	5	8310939	8311985	1046	+	44
AT5G24355	5	8314904	8315246	342	-	0
AT5G24360	5	8316439	8319981	3542	+	517
AT5G24370	5	8320968	8321544	576	+	0
AT5G24380	5	8323894	8326705	2811	+	629
AT5G24390	5	8326606	8329490	2884	-	20
AT5G24400	5	8330314	8331837	1523	-	633
AT5G24410	5	8332472	8334066	1594	-	0
AT5G24420	5	8336613	8338008	1395	-	408
AT5G24430	5	8339143	8343102	3959	-	291
AT5G24440	5	8345401	8347776	2375	-	0
AT5G24450	5	8348241	8353303	5062	+	842
AT5G24460	5	8354698	8355874	1176	+	445
AT5G24470	5	8355950	8358873	2923	-	5
AT5G24480	5	8363830	8365036	1206	-	0
AT5G24490	5	8365600	8367460	1860	+	4915
AT5G24500	5	8367301	8368736	1435	-	311
AT5G24510	5	8369170	8369866	696	-	5
AT5G24520	5	8370586	8372847	2261	-	855
AT5G24530	5	8378832	8383401	4569	+	389
AT5G24540	5	8384875	8388027	3152	-	0
AT5G24550	5	8392058	8395302	3244	-	0
AT5G24557	5	8401542	8401897	355	+	0
AT5G24560	5	8402204	8403266	1062	+	0
AT5G24570	5	8405680	8406132	452	-	85
AT5G24580	5	8410257	8412265	2008	-	246
AT5G24590	5	8416661	8418933	2272	-	427
AT5G24593	5	8419766	8420018	252	+	0
AT5G24600	5	8421623	8423499	1876	-	2
AT5G24610	5	8428077	8429253	1176	+	718
AT5G24620	5	8430003	8432414	2411	+	1301
AT5G24630	5	8432383	8436170	3787	-	120
AT5G24640	5	8436375	8436862	487	+	2
AT5G24650	5	8437084	8439104	2020	+	1144
AT5G24655	5	8440693	8441218	525	-	24
AT5G24660	5	8443278	8443834	556	-	266
AT5G24670	5	8447953	8451218	3265	+	1406
AT5G24680	5	8453601	8455518	1917	+	115
AT5G24690	5	8455456	8458751	3295	-	4043
AT5G24710	5	8458846	8468173	9327	-	1713
AT5G24735	5	8468330	8469262	932	-	556
AT5G24740	5	8469950	8489703	19753	-	943
AT5G24750	5	8490571	8494587	4016	-	194
AT5G24760	5	8494790	8497419	2629	-	329
AT5G24770	5	8500475	8502224	1749	-	46
AT5G24775	5	8503316	8506432	3116	+	0
AT5G24780	5	8507589	8508957	1368	-	5
AT5G24790	5	8512041	8513164	1123	+	0
AT5G24800	5	8515199	8516669	1470	+	533
AT5G24810	5	8516634	8522767	6133	-	1992
AT5G24820	5	8523405	8525297	1892	+	0
AT5G24825	5	8527468	8527649	181	+	0
AT5G24830	5	8530977	8533867	2890	+	232
AT5G24840	5	8533786	8535043	1257	-	193
AT5G24850	5	8535281	8538107	2826	-	505
AT5G24860	5	8541777	8542449	672	+	1
AT5G24870	5	8544784	8547789	3005	-	337
AT5G24879	5	8552490	8552604	114	-	0
AT5G24880	5	8552742	8554074	1332	+	19
AT5G24890	5	8558190	8559406	1216	-	722
AT5G24900	5	8563808	8566812	3004	-	0
AT5G24910	5	8567580	8570358	2778	-	2
AT5G24915	5	8571955	8577856	5901	+	0
AT5G24920	5	8584664	8585275	611	+	22
AT5G24930	5	8589233	8591236	2003	+	8855
AT5G24940	5	8591406	8593601	2195	-	0
AT5G24950	5	8595208	8597761	2553	-	0
AT5G24960	5	8599987	8603194	3207	-	0
AT5G24970	5	8604323	8608842	4519	-	190
AT5G24980	5	8609080	8609528	448	+	183
AT5G24990	5	8610536	8611694	1158	+	153
AT5G25000	5	8613965	8614331	366	-	0
AT5G25010	5	8616008	8616869	861	+	39
AT5G25020	5	8618566	8619465	899	+	0
AT5G25030	5	8620082	8620991	909	-	0
AT5G25040	5	8621953	8624337	2384	+	732
AT5G25045	5	8624713	8629137	4424	-	3
AT5G25050	5	8631679	8634027	2348	+	146
AT5G25060	5	8634073	8640217	6144	-	1175
AT5G25070	5	8640997	8643491	2494	-	368
AT5G25080	5	8643671	8647058	3387	+	401
AT5G25090	5	8647017	8647817	800	-	196
AT5G25100	5	8648005	8651176	3171	-	2820
AT5G25102	5	8652878	8653046	168	+	0
AT5G25110	5	8657625	8659322	1697	-	16
AT5G25120	5	8662098	8664533	2435	+	489
AT5G25130	5	8668298	8670194	1896	+	317
AT5G25140	5	8672423	8674629	2206	+	465
AT5G25150	5	8677090	8682205	5115	+	607
AT5G25160	5	8687456	8688415	959	+	16
AT5G25170	5	8693136	8695095	1959	+	198
AT5G25180	5	8694629	8697108	2479	-	0
AT5G25190	5	8706789	8707748	959	-	81
AT5G25200	5	8716765	8717869	1104	-	0
AT5G25205	5	8718570	8723552	4982	-	0
AT5G25210	5	8723957	8725771	1814	+	34
AT5G25220	5	8736073	8738584	2511	+	2339
AT5G25230	5	8739708	8743594	3886	+	13
AT5G25240	5	8746604	8747197	593	-	39
AT5G25250	5	8749726	8751636	1910	+	83
AT5G25260	5	8752683	8754485	1802	+	41
AT5G25265	5	8754552	8756948	2396	-	928
AT5G25270	5	8757546	8762757	5211	-	1235
AT5G25280	5	8773788	8776000	2212	+	1905
AT5G25290	5	8778591	8779785	1194	+	0
AT5G25300	5	8780257	8783093	2836	+	0
AT5G25305	5	8783286	8783837	551	-	0
AT5G25310	5	8784819	8787366	2547	+	5
AT5G25320	5	8787402	8789530	2128	-	1
AT5G25330	5	8791512	8792813	1301	+	0
AT5G25340	5	8793017	8794784	1767	+	0
AT5G25350	5	8794251	8797020	2769	-	412
AT5G25360	5	8799709	8802753	3044	-	758
AT5G25370	5	8804239	8807547	3308	-	62
AT5G25380	5	8815229	8817566	2337	+	21
AT5G25390	5	8820475	8821992	1517	+	20
AT5G25400	5	8823282	8824332	1050	+	0
AT5G25410	5	8831669	8833509	1840	+	0
AT5G25415	5	8834205	8837248	3043	+	0
AT5G25420	5	8838416	8841775	3359	-	1
AT5G25422	5	8845102	8845204	102	-	0
AT5G25425	5	8848548	8848986	438	+	0
AT5G25430	5	8851250	8854259	3009	+	0
AT5G25440	5	8854774	8856758	1984	-	106
AT5G25450	5	8856996	8858476	1480	+	6
AT5G25451	5	8858200	8858951	751	-	0
AT5G25460	5	8863362	8865677	2315	+	4174
AT5G25470	5	8865650	8867685	2035	-	14
AT5G25475	5	8867796	8869821	2025	-	125
AT5G25480	5	8869872	8872262	2390	-	123
AT5G25490	5	8876485	8877815	1330	+	110
AT5G25500	5	8880862	8882542	1680	+	27
AT5G25510	5	8882467	8884834	2367	-	786
AT5G25520	5	8885087	8889620	4533	+	1213
AT5G25530	5	8889664	8890954	1290	-	0
AT5G25540	5	8891524	8892990	1466	-	708
AT5G25550	5	8894178	8895480	1302	+	1
AT5G25560	5	8897870	8901709	3839	+	3016
AT5G25570	5	8901740	8903219	1479	+	71
AT5G25580	5	8903504	8906311	2807	+	92
AT5G25585	5	8906415	8906499	84	+	0
AT5G25590	5	8906597	8909920	3323	-	525
AT5G25600	5	8912958	8914055	1097	-	1
AT5G25610	5	8914232	8916800	2568	-	15148
AT5G25615	5	8929176	8933835	4659	+	0
AT5G25620	5	8935039	8938758	3719	-	104
AT5G25625	5	8946823	8946896	73	-	0
AT5G25630	5	8947222	8949599	2377	+	3518
AT5G25640	5	8949848	8950331	483	-	5
AT5G25750	5	8950883	8951143	260	+	3
AT5G25752	5	8951263	8953396	2133	-	719
AT5G25754	5	8953450	8955790	2340	+	193
AT5G25757	5	8965244	8967504	2260	-	160
AT5G25760	5	8967654	8969369	1715	+	427
AT5G25770	5	8969214	8972125	2911	-	155
AT5G25780	5	8973266	8976869	3603	-	576
AT5G25790	5	8977099	8979259	2160	-	38
AT5G25800	5	8979621	8982873	3252	-	123
AT5G25810	5	8986770	8987787	1017	-	44
AT5G25820	5	8997182	9000329	3147	-	15
AT5G25830	5	9004312	9005502	1190	-	48
AT5G25840	5	9010723	9011498	775	-	352
AT5G25850	5	9014081	9015917	1836	+	0
AT5G25860	5	9016907	9018424	1517	-	0
AT5G25870	5	9019590	9020321	731	-	0
AT5G25880	5	9024548	9028377	3829	+	59
AT5G25890	5	9033414	9034834	1420	+	168
AT5G25900	5	9036017	9038406	2389	+	921
AT5G25910	5	9038859	9041377	2518	+	4
AT5G25920	5	9044205	9046528	2323	-	5
AT5G25930	5	9050793	9054143	3350	+	71
AT5G25940	5	9054121	9055251	1130	-	351
AT5G25950	5	9057792	9059963	2171	-	0
AT5G25955	5	9061650	9062419	769	+	0
AT5G25960	5	9062916	9065011	2095	-	1
AT5G25970	5	9066376	9067974	1598	+	34
AT5G25980	5	9072726	9075690	2964	+	12159
AT5G25990	5	9076106	9077379	1273	-	18
AT5G26000	5	9079504	9082384	2880	-	55272
AT5G26010	5	9085392	9087372	1980	-	47
AT5G26015	5	9088339	9088809	470	+	0
AT5G26020	5	9093594	9094877	1283	-	0
AT5G26030	5	9096459	9099185	2726	+	879
AT5G26038	5	9098790	9098916	126	+	0
AT5G26040	5	9099156	9101636	2480	-	127
AT5G26050	5	9103178	9104100	922	-	0
AT5G26060	5	9104846	9105524	678	-	0
AT5G26070	5	9106340	9106649	309	+	0
AT5G26080	5	9107996	9108422	426	+	0
AT5G26090	5	9109025	9113235	4210	-	1
AT5G26100	5	9117289	9117817	528	-	0
AT5G26110	5	9117906	9119826	1920	-	181
AT5G26114	5	9120687	9120960	273	-	0
AT5G26120	5	9121726	9125967	4241	-	0
AT5G26130	5	9128109	9128610	501	-	0
AT5G26140	5	9130795	9131636	841	+	0
AT5G26146	5	9135912	9138264	2352	+	0
AT5G26147	5	9136125	9136215	90	+	0
AT5G26150	5	9137460	9140099	2639	-	0
AT5G26160	5	9142864	9146525	3661	+	235
AT5G26170	5	9147175	9148128	953	-	47
AT5G26180	5	9149226	9153502	4276	+	289
AT5G26190	5	9153627	9155298	1671	-	12
AT5G26200	5	9157141	9158404	1263	+	121
AT5G26210	5	9158317	9160383	2066	-	998
AT5G26220	5	9162968	9164685	1717	-	13
AT5G26230	5	9173516	9174542	1026	-	113
AT5G26233	5	9179751	9180539	788	-	0
AT5G26236	5	9183054	9187480	4426	+	0
AT5G26240	5	9189523	9194731	5208	+	931
AT5G26250	5	9196757	9198801	2044	+	0
AT5G26260	5	9200462	9202400	1938	+	1
AT5G26262	5	9203284	9203392	108	-	0
AT5G26270	5	9206374	9208136	1762	+	7
AT5G26280	5	9208710	9210572	1862	+	39
AT5G26283	5	9214235	9217143	2908	-	0
AT5G26286	5	9220056	9221658	1602	+	0
AT5G26290	5	9226078	9227873	1795	+	0
AT5G26300	5	9229325	9231033	1708	+	0
AT5G26310	5	9234684	9236385	1701	+	1
AT5G26320	5	9238309	9241236	2927	+	0
AT5G26330	5	9241545	9242713	1168	-	129
AT5G26340	5	9243510	9247066	3556	-	127
AT5G26345	5	9249456	9252813	3357	+	0
AT5G26350	5	9253107	9253637	530	-	0
AT5G26360	5	9255052	9258991	3939	-	2606
AT5G26570	5	9261579	9267729	6150	+	1250
AT5G26580	5	9393064	9394102	1038	-	0
AT5G26582	5	9388755	9392082	3327	-	16
AT5G26590	5	9381991	9382331	340	-	0
AT5G26594	5	9269281	9270254	973	+	0
AT5G26600	5	9377401	9379797	2396	+	704
AT5G26610	5	9375182	9377125	1943	+	620
AT5G26617	5	9360461	9360988	527	+	2
AT5G26618	5	9272490	9274179	1689	-	0
AT5G26620	5	9366696	9366963	267	-	5
AT5G26622	5	9355979	9357436	1457	-	370
AT5G26630	5	9350814	9351471	657	+	1
AT5G26640	5	9347840	9348174	334	-	0
AT5G26642	5	9274543	9275779	1236	+	0
AT5G26650	5	9343784	9345011	1227	+	0
AT5G26660	5	9331572	9333174	1602	-	13
AT5G26667	5	9275946	9278596	2650	+	1224
AT5G26670	5	9318279	9320991	2712	+	377
AT5G26673	5	9279308	9279611	303	+	1
AT5G26680	5	9311874	9315475	3601	-	212
AT5G26690	5	9310796	9311572	776	+	16
AT5G26692	5	9282478	9283007	529	+	0
AT5G26700	5	9308289	9309625	1336	-	11
AT5G26710	5	9305512	9308440	2928	+	1239
AT5G26717	5	9284557	9284997	440	+	0
AT5G26720	5	9304024	9304743	719	+	68
AT5G26730	5	9300415	9301990	1575	+	3
AT5G26731	5	9295573	9296380	807	+	15
AT5G26740	5	9291927	9294687	2760	+	367
AT5G26742	5	9284978	9289003	4025	-	10708
AT5G26749	5	9398014	9399267	1253	-	50
AT5G26751	5	9399376	9402476	3100	-	1328
AT5G26760	5	9403597	9407301	3704	-	711
AT5G26770	5	9407719	9410117	2398	-	165
AT5G26775	5	9411665	9416927	5262	+	1
AT5G26780	5	9418194	9422156	3962	+	1223
AT5G26790	5	9423091	9423611	520	+	40
AT5G26800	5	9425150	9426711	1561	+	260
AT5G26805	5	9427542	9428067	525	+	0
AT5G26810	5	9430951	9432969	2018	+	0
AT5G26820	5	9433618	9437105	3487	+	2505
AT5G26830	5	9437296	9441779	4483	+	1637
AT5G26840	5	9442287	9442605	318	-	0
AT5G26848	5	9445118	9445367	249	-	0
AT5G26850	5	9445311	9450865	5554	+	1066
AT5G26860	5	9451047	9457000	5953	+	386
AT5G26880	5	9457036	9459230	2194	-	527
AT5G26890	5	9460464	9460716	252	+	0
AT5G26900	5	9463751	9465086	1335	+	0
AT5G26910	5	9465928	9470403	4475	-	701
AT5G26912	5	9471973	9472111	138	+	0
AT5G26920	5	9475681	9478751	3070	+	134
AT5G26930	5	9479465	9480200	735	+	3
AT5G26940	5	9480572	9482790	2218	+	379
AT5G26950	5	9483250	9484120	870	-	0
AT5G26960	5	9484733	9486149	1416	-	254
AT5G26970	5	9487059	9487386	327	-	3
AT5G26980	5	9488147	9490816	2669	-	300
AT5G26990	5	9491071	9493920	2849	+	314
AT5G27000	5	9498051	9503134	5083	+	22
AT5G27010	5	9503314	9507569	4255	-	0
AT5G27020	5	9508097	9508878	781	+	1
AT5G27030	5	9508717	9515407	6690	-	771
AT5G27035	5	9516469	9516708	239	-	0
AT5G27037	5	9517435	9518141	706	+	0
AT5G27043	5	9519655	9520055	400	-	0
AT5G27050	5	9520275	9520638	363	+	0
AT5G27060	5	9522533	9525407	2874	-	11
AT5G27070	5	9527740	9528604	864	+	0
AT5G27080	5	9529602	9531081	1479	-	0
AT5G27090	5	9531844	9532408	564	+	0
AT5G27095	5	9532981	9533649	668	+	0
AT5G27100	5	9535058	9538333	3275	-	109
AT5G27110	5	9538571	9540647	2076	-	21
AT5G27120	5	9540924	9543871	2947	+	702
AT5G27130	5	9546546	9547553	1007	+	0
AT5G27140	5	9548541	9550597	2056	+	0
AT5G27150	5	9553437	9557513	4076	+	2013
AT5G27160	5	9562595	9565841	3246	+	0
AT5G27170	5	9566006	9566412	406	+	0
AT5G27180	5	9566762	9567176	414	-	0
AT5G27190	5	9567919	9571164	3245	-	0
AT5G27200	5	9571184	9571989	805	+	1
AT5G27210	5	9572099	9574135	2036	-	87
AT5G27220	5	9578756	9582752	3996	+	11
AT5G27230	5	9584091	9588049	3958	+	29
AT5G27238	5	9593903	9594434	531	-	0
AT5G27240	5	9597551	9600866	3315	+	282
AT5G27247	5	9601442	9601589	147	-	2
AT5G27250	5	9601672	9603014	1342	+	32
AT5G27260	5	9603942	9604930	988	+	0
AT5G27270	5	9605649	9609787	4138	+	741
AT5G27280	5	9617485	9618481	996	+	624
AT5G27290	5	9618391	9620533	2142	-	1512
AT5G27300	5	9620809	9624990	4181	+	276
AT5G27310	5	9625448	9626561	1113	+	0
AT5G27320	5	9629086	9631210	2124	+	259
AT5G27330	5	9632702	9634980	2278	-	251
AT5G27340	5	9635884	9636884	1000	+	0
AT5G27345	5	9641504	9643917	2413	-	1
AT5G27350	5	9648666	9654426	5760	+	1191
AT5G27360	5	9657025	9662559	5534	+	459
AT5G27370	5	9667310	9667886	576	+	0
AT5G27380	5	9667970	9670962	2992	-	1386
AT5G27390	5	9674390	9676189	1799	-	1149
AT5G27395	5	9671495	9674256	2761	-	224
AT5G27400	5	9676333	9678503	2170	+	40
AT5G27410	5	9676333	9682940	6607	+	382
AT5G27420	5	9684071	9685561	1490	+	40
AT5G27430	5	9687377	9689420	2043	+	360
AT5G27440	5	9689497	9690318	821	-	43
AT5G27450	5	9690606	9693289	2683	+	410
AT5G27460	5	9693261	9694840	1579	-	148
AT5G27470	5	9695007	9697389	2382	+	1897
AT5G27480	5	9699528	9701664	2136	+	0
AT5G27490	5	9702834	9704719	1885	-	164
AT5G27495	5	9706373	9706720	347	+	0
AT5G27500	5	9708135	9709444	1309	+	0
AT5G27505	5	9710871	9712425	1554	-	0
AT5G27510	5	9713172	9714078	906	+	0
AT5G27520	5	9714381	9716354	1973	-	133
AT5G27530	5	9717502	9721097	3595	+	0
AT5G27540	5	9722424	9727454	5030	+	1000
AT5G27550	5	9727453	9731341	3888	-	228
AT5G27560	5	9731601	9733918	2317	+	2324
AT5G27570	5	9734895	9736131	1236	-	0
AT5G27580	5	9736650	9737322	672	+	1
AT5G27590	5	9738491	9740473	1982	-	0
AT5G27600	5	9742575	9747005	4430	+	360
AT5G27603	5	9750867	9751143	276	+	0
AT5G27606	5	9752001	9753404	1403	+	0
AT5G27610	5	9764134	9769903	5769	+	77
AT5G27620	5	9771323	9774875	3552	+	214
AT5G27630	5	9776022	9781002	4980	+	74
AT5G27640	5	9781009	9785288	4279	-	2037
AT5G27650	5	9785406	9789232	3826	+	592
AT5G27660	5	9789467	9792299	2832	-	496
AT5G27670	5	9792560	9793456	896	-	1018
AT5G27680	5	9793789	9798961	5172	-	110
AT5G27690	5	9803763	9805160	1397	+	233
AT5G27700	5	9807301	9808506	1205	-	2177
AT5G27705	5	9811768	9812302	534	+	0
AT5G27710	5	9812987	9815420	2433	+	325
AT5G27715	5	9815401	9815473	72	-	0
AT5G27720	5	9815555	9817599	2044	+	783
AT5G27730	5	9820248	9823086	2838	+	685
AT5G27740	5	9823678	9827064	3386	+	541
AT5G27750	5	9828236	9830161	1925	+	87
AT5G27760	5	9830342	9831790	1448	+	449
AT5G27770	5	9835884	9837341	1457	+	1735
AT5G27771	5	9837594	9837944	350	-	0
AT5G27780	5	9838884	9839313	429	-	0
AT5G27790	5	9840924	9842003	1079	-	0
AT5G27800	5	9842411	9843804	1393	+	0
AT5G27807	5	9852663	9852783	120	+	0
AT5G27810	5	9855826	9856186	360	+	0
AT5G27820	5	9859853	9861129	1276	+	215
AT5G27830	5	9861175	9862897	1722	+	236
AT5G27840	5	9862922	9865038	2116	-	726
AT5G27845	5	9868347	9871836	3489	+	1
AT5G27850	5	9873151	9874598	1447	+	4836
AT5G27860	5	9874823	9876464	1641	-	596
AT5G27870	5	9878990	9881806	2816	-	0
AT5G27880	5	9885907	9886744	837	+	0
AT5G27882	5	9888331	9889951	1620	-	0
AT5G27885	5	9892137	9896776	4639	-	0
AT5G27889	5	9903436	9903598	162	+	19
AT5G27890	5	9903639	9905914	2275	+	199
AT5G27895	5	9906057	9909700	3643	-	56
AT5G27900	5	9913202	9918023	4821	+	0
AT5G27902	5	9921055	9923736	2681	-	0
AT5G27905	5	9925218	9930411	5193	+	0
AT5G27910	5	9940735	9941299	564	-	2
AT5G27920	5	9941904	9944778	2874	-	142
AT5G27925	5	9949685	9954107	4422	+	1
AT5G27927	5	9956858	9957640	782	-	0
AT5G27930	5	9958089	9961264	3175	-	335
AT5G27940	5	9974410	9975071	661	+	0
AT5G27944	5	9975917	9976592	675	-	0
AT5G27945	5	9976006	9977601	1595	+	0
AT5G27947	5	9979366	9982856	3490	-	0
AT5G27950	5	9984050	9987990	3940	+	1726
AT5G27960	5	9991684	9992770	1086	-	0
AT5G27965	5	9995664	9999232	3568	-	0
AT5G27967	5	10001589	10001736	147	+	0
AT5G27970	5	10004719	10015668	10949	+	1349
AT5G27980	5	10015773	10016726	953	-	0
AT5G27990	5	10017035	10018441	1406	+	284
AT5G28000	5	10020678	10021251	573	+	0
AT5G28010	5	10024812	10025382	570	+	8
AT5G28020	5	10026182	10028580	2398	-	1843
AT5G28030	5	10030405	10032451	2046	-	639
AT5G28040	5	10037268	10039001	1733	-	457
AT5G28050	5	10043913	10045975	2062	-	1749
AT5G28052	5	10050221	10050317	96	-	0
AT5G28053	5	10050550	10056352	5802	+	0
AT5G28056	5	10059199	10064669	5470	-	0
AT5G28060	5	10069545	10070899	1354	-	3756
AT5G28065	5	10078023	10081241	3218	+	0
AT5G28067	5	10081910	10083044	1134	-	0
AT5G28070	5	10083169	10083519	350	+	0
AT5G28073	5	10085102	10085726	624	-	0
AT5G28076	5	10086842	10089344	2502	+	0
AT5G28080	5	10090069	10092402	2333	-	0
AT5G28085	5	10094410	10098508	4098	-	1
AT5G28090	5	10101041	10102274	1233	+	1
AT5G28100	5	10103086	10106860	3774	-	1
AT5G28110	5	10108330	10111154	2824	+	0
AT5G28120	5	10111392	10114354	2962	+	0
AT5G28130	5	10114432	10114780	348	-	0
AT5G28140	5	10115248	10116612	1364	-	1
AT5G28141	5	10117449	10118928	1479	-	0
AT5G28143	5	10123675	10124569	894	-	0
AT5G28145	5	10129021	10133676	4655	+	13
AT5G28150	5	10135433	10136977	1544	+	266
AT5G28160	5	10137925	10139013	1088	+	0
AT5G28165	5	10140417	10147542	7125	+	0
AT5G28170	5	10152146	10154734	2588	+	0
AT5G28173	5	10156025	10159001	2976	-	0
AT5G28176	5	10160232	10160736	504	-	0
AT5G28180	5	10162782	10163943	1161	+	0
AT5G28190	5	10167849	10170696	2847	-	0
AT5G28200	5	10180091	10182915	2824	-	0
AT5G28210	5	10188585	10190463	1878	+	0
AT5G28220	5	10190356	10193119	2763	-	205
AT5G28225	5	10193378	10194578	1200	-	0
AT5G28230	5	10195173	10196616	1443	-	0
AT5G28232	5	10198746	10201299	2553	+	0
AT5G28235	5	10201270	10203335	2065	-	0
AT5G28237	5	10207352	10213598	6246	-	3
AT5G28240	5	10216252	10216783	531	+	0
AT5G28250	5	10219022	10224680	5658	+	0
AT5G28253	5	10227599	10230967	3368	-	0
AT5G28260	5	10235175	10236006	831	-	0
AT5G28262	5	10238549	10239773	1224	+	37
AT5G28263	5	10241336	10256531	15195	+	11
AT5G28266	5	10256935	10257890	955	+	0
AT5G28270	5	10258089	10260471	2382	-	0
AT5G28280	5	10261016	10263283	2267	+	4
AT5G28285	5	10264890	10268620	3730	-	0
AT5G28287	5	10275171	10275542	371	-	0
AT5G28288	5	10276242	10276626	384	-	0
AT5G28290	5	10278690	10282614	3924	-	370
AT5G28295	5	10283281	10283777	496	-	0
AT5G28300	5	10292650	10295283	2633	-	842
AT5G28310	5	10300116	10301844	1728	-	11
AT5G28320	5	10301935	10306142	4207	+	49
AT5G28330	5	10307168	10308142	974	+	47
AT5G28335	5	10308600	10313586	4986	-	6
AT5G28340	5	10314117	10317160	3043	+	58
AT5G28350	5	10320138	10326946	6808	+	463
AT5G28360	5	10328402	10329702	1300	-	2
AT5G28370	5	10332374	10334571	2197	-	0
AT5G28380	5	10338722	10341007	2285	-	8
AT5G28390	5	10342023	10342997	974	-	67
AT5G28400	5	10344023	10348234	4211	-	90
AT5G28405	5	10350540	10354653	4113	-	0
AT5G28410	5	10358372	10359438	1066	+	0
AT5G28415	5	10359591	10364018	4427	-	27
AT5G28420	5	10364833	10365289	456	+	2
AT5G28430	5	10365741	10367421	1680	-	15
AT5G28440	5	10367670	10368317	647	-	3
AT5G28442	5	10368384	10369186	802	-	18
AT5G28450	5	10372937	10374190	1253	-	16
AT5G28460	5	10374898	10377304	2406	+	4
AT5G28463	5	10379445	10380973	1528	+	0
AT5G28464	5	10398190	10400049	1859	+	0
AT5G28465	5	10397381	10397486	105	-	0
AT5G28466	5	10401019	10401740	721	-	0
AT5G28468	5	10406987	10409696	2709	+	0
AT5G28469	5	10415550	10416093	543	-	0
AT5G28470	5	10429800	10432357	2557	+	0
AT5G28480	5	10433336	10438292	4956	+	0
AT5G28482	5	10439270	10439966	696	+	0
AT5G28484	5	10440638	10441293	655	+	0
AT5G28487	5	10441690	10445995	4305	-	1
AT5G28490	5	10454392	10455196	804	-	156
AT5G28491	5	10455681	10455807	126	-	2
AT5G28495	5	10463555	10467339	3784	+	0
AT5G28497	5	10470257	10471578	1321	-	0
AT5G28500	5	10477770	10479384	1614	+	5556
AT5G28510	5	10481040	10484022	2982	-	0
AT5G28515	5	10491993	10492514	521	+	0
AT5G28520	5	10493109	10494852	1743	+	2
AT5G28523	5	10497295	10502802	5507	+	0
AT5G28524	5	10508114	10508919	805	-	0
AT5G28525	5	10511289	10512803	1514	+	0
AT5G28526	5	10515531	10521998	6467	-	0
AT5G28527	5	10513365	10514577	1212	+	0
AT5G28530	5	10525077	10527300	2223	-	245
AT5G28535	5	10534817	10536025	1208	+	0
AT5G28540	5	10540459	10543375	2916	-	2663
AT5G28545	5	10547745	10553612	5867	-	0
AT5G28550	5	10557721	10559779	2058	-	0
AT5G28560	5	10566845	10567130	285	+	0
AT5G28570	5	10574620	10575159	539	+	0
AT5G28580	5	10575494	10578143	2649	-	0
AT5G28590	5	10579445	10581559	2114	-	0
AT5G28593	5	10583772	10587294	3522	+	0
AT5G28596	5	10589693	10592511	2818	+	0
AT5G28600	5	10597808	10603450	5642	+	0
AT5G28605	5	10604856	10607910	3054	-	0
AT5G28610	5	10610958	10611446	488	+	0
AT5G28615	5	10611970	10612501	531	+	0
AT5G28620	5	10612528	10613004	476	-	0
AT5G28622	5	10616593	10617598	1005	+	56
AT5G28623	5	10621960	10622671	711	-	0
AT5G28624	5	10623340	10629148	5808	-	0
AT5G28625	5	10630019	10630445	426	+	0
AT5G28626	5	10632240	10633944	1704	+	95
AT5G28627	5	10634055	10635268	1213	+	0
AT5G28630	5	10636630	10637249	619	+	11
AT5G28635	5	10637833	10643194	5361	+	0
AT5G28637	5	10645025	10646093	1068	-	0
AT5G28640	5	10647569	10649892	2323	-	283
AT5G28641	5	10662403	10666310	3907	-	0
AT5G28642	5	10654591	10654741	150	-	0
AT5G28643	5	10667518	10669676	2158	-	0
AT5G28644	5	10670837	10672133	1296	+	0
AT5G28646	5	10674813	10677234	2421	+	5
AT5G28650	5	10677715	10679204	1489	-	9
AT5G28655	5	10681549	10682057	508	-	1
AT5G28660	5	10683217	10683926	709	+	0
AT5G28662	5	10686172	10686823	651	+	0
AT5G28664	5	10687263	10688628	1365	-	0
AT5G28667	5	10690061	10691087	1026	+	0
AT5G28670	5	10691736	10695537	3801	-	0
AT5G28671	5	10698506	10699687	1181	-	0
AT5G28672	5	10700384	10701826	1442	+	0
AT5G28673	5	10706346	10708619	2273	-	0
AT5G28675	5	10708693	10712681	3988	+	0
AT5G28680	5	10719436	10722013	2577	-	0
AT5G28690	5	10722737	10724091	1354	+	0
AT5G28692	5	10728377	10733393	5016	-	0
AT5G28696	5	10738452	10744395	5943	-	0
AT5G28698	5	10750393	10752193	1800	+	0
AT5G28700	5	10755919	10757122	1203	-	6
AT5G28710	5	10757990	10758887	897	-	0
AT5G28712	5	10760796	10762070	1274	-	0
AT5G28715	5	10765647	10770477	4830	+	0
AT5G28720	5	10776130	10776952	822	+	0
AT5G28730	5	10779002	10780218	1216	+	0
AT5G28740	5	10780646	10783911	3265	+	848
AT5G28750	5	10783982	10785722	1740	-	3813
AT5G28760	5	10786307	10788949	2642	+	0
AT5G28765	5	10791039	10793514	2475	-	0
AT5G28770	5	10796458	10798222	1764	-	755
AT5G28773	5	10802035	10802887	852	-	1
AT5G28776	5	10808701	10812733	4032	+	0
AT5G28780	5	10812906	10814173	1267	-	0
AT5G28781	5	10814692	10814824	132	+	0
AT5G28785	5	10817193	10818477	1284	+	0
AT5G28790	5	10820172	10820525	353	+	0
AT5G28800	5	10822879	10823638	759	+	0
AT5G28810	5	10824432	10826575	2143	+	0
AT5G28820	5	10831798	10832532	734	+	0
AT5G28821	5	10832918	10833026	108	+	0
AT5G28823	5	10837848	10839826	1978	-	0
AT5G28824	5	10842659	10845756	3097	-	0
AT5G28826	5	10846898	10853413	6515	+	0
AT5G28830	5	10856790	10858668	1878	+	153
AT5G28840	5	10862172	10864903	2731	-	4812
AT5G28845	5	10869578	10872681	3103	+	0
AT5G28850	5	10876814	10881444	4630	-	328
AT5G28860	5	10883451	10884283	832	-	0
AT5G28865	5	10884482	10889210	4728	+	0
AT5G28870	5	10889277	10891421	2144	-	0
AT5G28880	5	10894097	10894704	607	-	0
AT5G28885	5	10896740	10898180	1440	+	0
AT5G28886	5	10900008	10900385	377	-	0
AT5G28888	5	10902104	10903015	911	-	0
AT5G28890	5	10904101	10904800	699	-	0
AT5G28892	5	10905937	10911761	5824	+	0
AT5G28894	5	10913550	10914393	843	-	0
AT5G28897	5	10923208	10923688	480	+	1
AT5G28900	5	10925634	10930338	4704	+	385
AT5G28910	5	10930568	10932999	2431	-	173
AT5G28913	5	10933822	10934730	908	-	108
AT5G28916	5	10935724	10936232	508	-	0
AT5G28917	5	10936831	10938217	1386	-	1
AT5G28919	5	10940032	10941771	1739	+	273
AT5G28920	5	10940034	10943378	3344	-	1
AT5G28923	5	10946561	10948829	2268	-	0
AT5G28926	5	10949703	10953591	3888	-	0
AT5G28927	5	10959090	10961379	2289	-	2
AT5G28928	5	10962067	10963114	1047	-	0
AT5G28929	5	10966525	10967632	1107	-	0
AT5G28930	5	10968246	10972487	4241	+	0
AT5G28931	5	10961625	10961781	156	-	0
AT5G28935	5	10974471	10979625	5154	-	0
AT5G28937	5	10981813	10984144	2331	-	0
AT5G28940	5	10985287	10987600	2313	-	0
AT5G28950	5	10992504	10993435	931	+	0
AT5G28960	5	10996590	10998783	2193	+	0
AT5G28970	5	11002029	11009297	7268	+	0
AT5G28980	5	11009928	11012192	2264	+	0
AT5G28990	5	11012866	11013508	642	+	0
AT5G28993	5	11014536	11017239	2703	-	0
AT5G28996	5	11020536	11020788	252	-	0
AT5G29000	5	11022082	11024960	2878	-	227
AT5G29015	5	11031698	11038817	7119	+	0
AT5G29020	5	11041950	11046502	4552	+	0
AT5G29022	5	11047198	11050909	3711	-	0
AT5G29024	5	11054696	11056812	2116	-	0
AT5G29026	5	11057785	11059041	1256	+	0
AT5G29028	5	11060646	11062141	1495	+	0
AT5G29029	5	11062523	11063981	1458	-	0
AT5G29030	5	11068257	11072505	4248	+	0
AT5G29031	5	11066525	11066990	465	-	0
AT5G29032	5	11080138	11083743	3605	+	0
AT5G29033	5	11073588	11074017	429	+	0
AT5G29034	5	11085570	11086257	687	+	0
AT5G29035	5	11076229	11078077	1848	-	0
AT5G29036	5	11078395	11079007	612	+	0
AT5G29037	5	11087123	11092700	5577	+	0
AT5G29040	5	11094904	11098337	3433	-	0
AT5G29041	5	11100204	11101377	1173	-	0
AT5G29043	5	11102694	11106649	3955	+	0
AT5G29044	5	11107380	11107512	132	+	0
AT5G29046	5	11107775	11109629	1854	+	0
AT5G29050	5	11111691	11112283	592	+	0
AT5G29053	5	11112539	11116875	4336	-	0
AT5G29054	5	11116912	11117014	102	-	0
AT5G29056	5	11117608	11121412	3804	+	0
AT5G29058	5	11122320	11122830	510	+	0
AT5G29060	5	11128469	11129537	1068	-	1
AT5G29070	5	11132174	11133516	1342	-	0
AT5G29075	5	11136148	11146651	10503	-	0
AT5G29090	5	11149621	11150540	919	+	0
AT5G29100	5	11150676	11152845	2169	-	0
AT5G29210	5	11153465	11153945	480	-	0
AT5G29231	5	11155093	11155210	117	-	0
AT5G29295	5	11158406	11159420	1014	-	0
AT5G29337	5	11161134	11163918	2784	+	0
AT5G29380	5	11166004	11170339	4335	-	0
AT5G29408	5	11171499	11174052	2553	-	0
AT5G29436	5	11175676	11176666	990	-	0
AT5G29465	5	11178376	11181391	3015	-	0
AT5G29550	5	11182705	11184514	1809	-	0
AT5G29560	5	11190542	11191963	1421	-	3
AT5G29562	5	11197049	11201681	4632	+	0
AT5G29565	5	11206791	11210598	3807	+	0
AT5G29568	5	11212605	11213608	1003	+	0
AT5G29571	5	11215093	11217830	2737	+	0
AT5G29574	5	11218047	11223147	5100	+	0
AT5G29577	5	11227043	11227495	452	-	0
AT5G29580	5	11268324	11271810	3486	-	0
AT5G29591	5	11272315	11273629	1314	+	0
AT5G29602	5	11273907	11274447	540	-	0
AT5G29613	5	11280576	11281110	534	+	0
AT5G29624	5	11285137	11286604	1467	+	0
AT5G29629	5	11287946	11288518	572	+	0
AT5G29635	5	11291091	11292716	1625	+	0
AT5G29646	5	11622148	11630296	8148	-	0
AT5G29708	5	11631510	11634456	2946	-	0
AT5G29720	5	11294564	11300009	5445	+	0
AT5G29762	5	11302069	11303892	1823	+	0
AT5G29805	5	11305983	11306557	574	+	0
AT5G29807	5	11306897	11307152	255	-	0
AT5G29890	5	11316708	11318967	2259	+	0
AT5G29975	5	11323980	11329884	5904	-	0
AT5G30060	5	11335385	11339141	3756	+	0
AT5G30102	5	11340042	11344833	4791	-	0
AT5G30123	5	11345398	11346278	880	+	0
AT5G30189	5	11347261	11352028	4767	-	0
AT5G30207	5	11592942	11595226	2284	-	0
AT5G30218	5	11352699	11354221	1522	+	0
AT5G30247	5	11356353	11357072	719	+	0
AT5G30269	5	11596126	11610717	14591	+	0
AT5G30276	5	11358800	11364836	6036	-	0
AT5G30341	5	11365986	11366641	655	+	0
AT5G30380	5	11443003	11444180	1177	+	0
AT5G30390	5	11462111	11463413	1302	+	0
AT5G30400	5	11499012	11500014	1002	-	0
AT5G30406	5	11368302	11372538	4236	-	0
AT5G30410	5	11504748	11506398	1650	+	0
AT5G30420	5	11533468	11537215	3747	-	0
AT5G30428	5	11374054	11374642	588	+	0
AT5G30440	5	11551761	11552832	1071	-	0
AT5G30450	5	11559202	11561951	2749	+	0
AT5G30460	5	11564676	11565897	1221	+	0
AT5G30470	5	11587318	11589681	2363	+	0
AT5G30480	5	11590736	11591989	1253	+	0
AT5G30490	5	11611982	11614530	2548	+	273
AT5G30495	5	11380000	11381562	1562	+	145
AT5G30500	5	11615344	11616926	1582	+	0
AT5G30510	5	11619025	11621298	2273	-	16875
AT5G30520	5	11636191	11636638	447	-	0
AT5G30532	5	11637178	11637949	771	-	0
AT5G30545	5	11641769	11643020	1251	-	0
AT5G30584	5	11388163	11395249	7086	+	1
AT5G30628	5	11396274	11396867	593	+	0
AT5G30648	5	11566336	11566789	453	-	0
AT5G30673	5	11398078	11400784	2706	+	0
AT5G30721	5	11563123	11564305	1182	+	0
AT5G30762	5	11402277	11403675	1398	+	0
AT5G30852	5	11405396	11406710	1314	+	0
AT5G30870	5	11567515	11568304	789	+	0
AT5G30942	5	11406967	11412536	5569	-	0
AT5G31032	5	11412726	11415675	2949	+	0
AT5G31087	5	11644437	11649471	5034	-	0
AT5G31092	5	11569501	11572297	2796	+	0
AT5G31122	5	11417341	11418304	963	+	0
AT5G31212	5	11418566	11421081	2515	+	0
AT5G31302	5	11421207	11423580	2373	+	1
AT5G31314	5	11573251	11573608	357	+	0
AT5G31355	5	11506491	11509806	3315	-	0
AT5G31412	5	11541462	11543768	2306	-	0
AT5G31496	5	11510032	11512009	1977	-	0
AT5G31511	5	11555407	11558380	2973	+	0
AT5G31536	5	11575367	11575838	471	+	0
AT5G31572	5	11424676	11426539	1863	+	0
AT5G31637	5	11515441	11516644	1203	-	0
AT5G31651	5	11651768	11653077	1309	-	0
AT5G31662	5	11428289	11433594	5305	+	0
AT5G31668	5	11653107	11654329	1222	+	0
AT5G31685	5	11657832	11659707	1875	+	0
AT5G31702	5	11664595	11667214	2619	-	0
AT5G31719	5	11689259	11692220	2961	-	0
AT5G31736	5	11692641	11695374	2733	-	0
AT5G31752	5	11434336	11436213	1877	-	0
AT5G31753	5	11696729	11697699	970	+	0
AT5G31758	5	11576744	11577128	384	+	0
AT5G31770	5	11701225	11701762	537	+	0
AT5G31778	5	11517597	11518965	1368	-	0
AT5G31787	5	11713112	11713641	529	+	0
AT5G31804	5	11715183	11721564	6381	-	0
AT5G31807	5	11548173	11549679	1506	-	0
AT5G31821	5	11739276	11741176	1900	+	0
AT5G31838	5	11742645	11742984	339	-	0
AT5G31842	5	11437643	11438267	624	+	0
AT5G31845	5	11464464	11468772	4308	-	0
AT5G31855	5	11744500	11746159	1659	-	0
AT5G31873	5	11746239	11747771	1532	+	0
AT5G31884	5	11468968	11469478	510	+	0
AT5G31891	5	11749393	11752198	2805	-	0
AT5G31905	5	11502428	11503175	747	-	0
AT5G31909	5	11765719	11765950	231	+	0
AT5G31919	5	11519919	11521244	1325	-	0
AT5G31923	5	11469616	11470030	414	+	0
AT5G31927	5	11767477	11772031	4554	-	0
AT5G31932	5	11439254	11439476	222	+	0
AT5G31945	5	11773772	11776512	2740	+	0
AT5G31962	5	11472356	11473802	1446	-	0
AT5G31963	5	11777653	11779488	1835	+	0
AT5G31980	5	11578103	11580836	2733	+	0
AT5G31981	5	11780619	11781807	1188	+	0
AT5G31989	5	11521175	11522261	1086	+	0
AT5G31999	5	11782796	11784866	2070	-	1
AT5G32002	5	11474496	11478579	4083	-	0
AT5G32017	5	11785054	11785126	72	+	0
AT5G32022	5	11440712	11441132	420	+	0
AT5G32035	5	11797903	11798515	612	-	0
AT5G32037	5	11446318	11447530	1212	+	0
AT5G32042	5	11479952	11483063	3111	+	0
AT5G32053	5	11800199	11802224	2025	-	0
AT5G32060	5	11527890	11533149	5259	+	0
AT5G32070	5	11447666	11449552	1886	+	0
AT5G32071	5	11803544	11806277	2733	-	0
AT5G32072	5	11450043	11450532	489	-	0
AT5G32082	5	11484470	11485445	975	+	0
AT5G32089	5	11807470	11808190	720	-	0
AT5G32103	5	11453774	11457685	3911	+	0
AT5G32107	5	11813520	11816463	2943	-	0
AT5G32112	5	11441809	11442856	1047	+	0
AT5G32122	5	11487133	11488177	1044	+	0
AT5G32125	5	11816894	11819615	2721	-	0
AT5G32136	5	11457958	11459621	1663	+	0
AT5G32143	5	11820825	11821563	738	-	1
AT5G32161	5	11830874	11831456	582	+	0
AT5G32162	5	11497152	11498490	1338	-	0
AT5G32169	5	11460440	11461217	777	+	0
AT5G32179	5	11832739	11835472	2733	+	0
AT5G32197	5	11836786	11838733	1947	+	0
AT5G32215	5	11842364	11845100	2736	+	0
AT5G32228	5	11846409	11848350	1941	+	0
AT5G32241	5	11907124	11908798	1674	-	0
AT5G32254	5	11909709	11913389	3680	-	0
AT5G32267	5	11918628	11921430	2802	+	0
AT5G32280	5	11921537	11924125	2588	+	0
AT5G32293	5	11937172	11939908	2736	+	0
AT5G32306	5	11941157	11943053	1896	+	0
AT5G32312	5	11944830	11945358	528	-	0
AT5G32345	5	11977547	11987264	9717	+	1
AT5G32358	5	11994407	11998634	4227	+	0
AT5G32386	5	12000153	12004374	4221	+	0
AT5G32400	5	12007313	12008321	1008	+	0
AT5G32402	5	12009111	12011820	2709	+	0
AT5G32404	5	12013299	12015174	1875	+	0
AT5G32405	5	12016949	12017720	771	+	0
AT5G32406	5	12018665	12020290	1625	+	0
AT5G32408	5	12021490	12022876	1386	+	0
AT5G32410	5	12023370	12023773	403	+	0
AT5G32420	5	12030327	12030933	606	-	0
AT5G32423	5	12032692	12034552	1860	-	0
AT5G32426	5	12035632	12041415	5783	-	0
AT5G32430	5	12042599	12043202	603	-	0
AT5G32431	5	12049748	12050468	720	-	0
AT5G32433	5	12066201	12068976	2775	-	0
AT5G32434	5	12070641	12071381	740	-	0
AT5G32436	5	12072625	12073943	1318	-	0
AT5G32440	5	12076892	12078603	1711	+	802
AT5G32450	5	12079610	12081573	1963	+	1170
AT5G32460	5	12081802	12084148	2346	-	0
AT5G32470	5	12084898	12088603	3705	-	480
AT5G32471	5	12098264	12099650	1386	+	0
AT5G32473	5	12099856	12101337	1481	-	0
AT5G32475	5	12102511	12104578	2067	-	0
AT5G32481	5	12106065	12110796	4731	-	8
AT5G32482	5	12114981	12116007	1026	+	0
AT5G32483	5	12111918	12112694	776	-	0
AT5G32484	5	12116157	12119634	3477	+	0
AT5G32485	5	12112739	12113504	765	+	0
AT5G32486	5	12123525	12124662	1137	+	0
AT5G32487	5	12119769	12122316	2547	-	0
AT5G32488	5	12127959	12128881	922	-	0
AT5G32489	5	12125629	12126732	1103	-	0
AT5G32490	5	12129477	12130279	802	-	0
AT5G32495	5	12131936	12133832	1896	-	0
AT5G32505	5	12135291	12137910	2619	-	0
AT5G32510	5	12138751	12139374	623	-	0
AT5G32511	5	12142710	12144657	1947	-	0
AT5G32512	5	12146024	12148775	2751	-	0
AT5G32513	5	12153709	12156646	2937	+	0
AT5G32514	5	12160427	12164246	3819	+	0
AT5G32515	5	12140384	12140969	585	-	0
AT5G32516	5	12165299	12167168	1869	+	0
AT5G32517	5	12150098	12151013	915	-	0
AT5G32518	5	12177865	12180943	3078	+	0
AT5G32519	5	12151080	12151728	648	+	0
AT5G32520	5	12190078	12192625	2547	+	0
AT5G32521	5	12170270	12176294	6024	-	0
AT5G32522	5	12183152	12184489	1337	+	0
AT5G32525	5	12192827	12193774	947	-	0
AT5G32540	5	12195730	12199558	3828	+	2
AT5G32563	5	12200247	12204138	3891	+	0
AT5G32566	5	12204732	12206865	2133	+	0
AT5G32569	5	12207552	12209270	1718	+	0
AT5G32572	5	12210245	12210551	306	-	0
AT5G32576	5	12211626	12212207	581	-	0
AT5G32580	5	12213983	12220094	6111	+	0
AT5G32590	5	12221588	12224322	2734	-	0
AT5G32591	5	12225110	12226634	1524	-	0
AT5G32592	5	12228142	12231785	3643	-	0
AT5G32593	5	12232550	12235535	2985	+	0
AT5G32594	5	12238157	12240479	2322	+	0
AT5G32595	5	12236346	12238106	1760	-	0
AT5G32596	5	12242586	12244472	1886	-	0
AT5G32597	5	12235758	12235890	132	-	0
AT5G32598	5	12245005	12249415	4410	+	0
AT5G32600	5	12249698	12251643	1945	-	0
AT5G32605	5	12254966	12256655	1689	-	0
AT5G32610	5	12256676	12259096	2420	-	0
AT5G32613	5	12263254	12265041	1787	+	0
AT5G32616	5	12265316	12267974	2658	+	0
AT5G32619	5	12277541	12278091	550	-	0
AT5G32620	5	12269748	12270681	933	+	2
AT5G32621	5	12271359	12273728	2369	+	2
AT5G32622	5	12289343	12291161	1818	+	0
AT5G32623	5	12282238	12283972	1734	-	0
AT5G32624	5	12292462	12294049	1587	+	0
AT5G32625	5	12284778	12286164	1386	-	0
AT5G32626	5	12297343	12299080	1737	-	0
AT5G32627	5	12286880	12288728	1848	-	0
AT5G32628	5	12300331	12301534	1203	-	0
AT5G32630	5	12310536	12315067	4531	-	0
AT5G32654	5	12317803	12321334	3531	-	0
AT5G32678	5	12326880	12329676	2796	+	0
AT5G32690	5	12332282	12390801	58519	+	0
AT5G32702	5	12332884	12335557	2673	-	0
AT5G32726	5	12340215	12342177	1962	-	0
AT5G32750	5	12343224	12348933	5709	-	0
AT5G32775	5	12349745	12350642	897	-	0
AT5G32800	5	12352678	12353216	538	+	0
AT5G32825	5	12353840	12360571	6731	-	0
AT5G32850	5	12361414	12363883	2469	+	0
AT5G32875	5	12367878	12370254	2376	-	0
AT5G32900	5	12373305	12373893	588	-	0
AT5G32925	5	12381878	12385472	3594	+	0
AT5G32950	5	12386480	12388874	2394	+	0
AT5G32975	5	12391785	12393114	1329	+	0
AT5G33000	5	12396112	12396754	642	+	0
AT5G33025	5	12398110	12400792	2682	+	0
AT5G33050	5	12402097	12408478	6381	+	0
AT5G33070	5	12419574	12420057	483	-	0
AT5G33075	5	12423223	12425701	2478	-	0
AT5G33100	5	12427568	12428243	675	+	0
AT5G33125	5	12429427	12433051	3624	+	0
AT5G33150	5	12434285	12435257	972	+	0
AT5G33175	5	12446148	12448569	2421	+	0
AT5G33200	5	12451651	12454741	3090	-	0
AT5G33202	5	12455769	12457176	1407	-	0
AT5G33204	5	12457548	12461543	3995	-	0
AT5G33207	5	12462511	12464082	1571	-	0
AT5G33210	5	12464745	12465713	968	-	0
AT5G33220	5	12466109	12468921	2812	+	0
AT5G33223	5	12469885	12470725	840	-	0
AT5G33226	5	12472881	12475965	3084	-	0
AT5G33230	5	12476676	12477134	458	+	0
AT5G33232	5	12479273	12481736	2463	-	0
AT5G33234	5	12483582	12487437	3855	+	0
AT5G33237	5	12488414	12489239	825	-	0
AT5G33240	5	12490164	12490991	827	-	0
AT5G33250	5	12493614	12494901	1287	+	0
AT5G33251	5	12499071	12500433	1362	+	2
AT5G33252	5	12502072	12506833	4761	+	0
AT5G33253	5	12512723	12516182	3459	+	0
AT5G33254	5	12518369	12519302	933	-	0
AT5G33255	5	12520676	12522492	1816	-	0
AT5G33256	5	12523690	12529391	5701	-	0
AT5G33257	5	12530544	12531174	630	-	0
AT5G33258	5	12531699	12532410	711	-	0
AT5G33259	5	12532645	12533260	615	-	0
AT5G33260	5	12534631	12535846	1215	-	0
AT5G33270	5	12542038	12543313	1275	+	0
AT5G33280	5	12549279	12552507	3228	+	884
AT5G33285	5	12555189	12556428	1239	-	0
AT5G33290	5	12558255	12562020	3765	+	166
AT5G33300	5	12562429	12565757	3328	-	96
AT5G33303	5	12570175	12571226	1051	+	0
AT5G33306	5	12571677	12577071	5394	+	0
AT5G33310	5	12577320	12582199	4879	-	0
AT5G33315	5	12582856	12583555	699	+	0
AT5G33320	5	12588837	12591748	2911	+	2641
AT5G33330	5	12591682	12592896	1214	-	0
AT5G33340	5	12594466	12595952	1486	+	0
AT5G33350	5	12596784	12598098	1314	+	0
AT5G33355	5	12599252	12599671	419	+	0
AT5G33360	5	12601139	12601667	528	+	0
AT5G33365	5	12602146	12602476	330	-	0
AT5G33370	5	12602467	12604764	2297	-	342
AT5G33380	5	12607809	12608362	553	+	0
AT5G33381	5	12610178	12615470	5292	+	2
AT5G33382	5	12616562	12621331	4769	+	6
AT5G33383	5	12623152	12625333	2181	-	0
AT5G33384	5	12628890	12630594	1704	-	0
AT5G33385	5	12631764	12634496	2732	-	0
AT5G33386	5	12635784	12637371	1587	-	0
AT5G33387	5	12639703	12640306	603	+	0
AT5G33388	5	12641506	12644260	2754	+	0
AT5G33389	5	12645571	12647476	1905	+	2
AT5G33390	5	12661788	12662820	1032	+	0
AT5G33391	5	12649193	12649796	603	+	0
AT5G33392	5	12652366	12655045	2679	+	0
AT5G33393	5	12656429	12658588	2159	-	0
AT5G33395	5	12664505	12666192	1687	+	0
AT5G33398	5	12667638	12668028	390	+	0
AT5G33399	5	12680934	12682120	1186	-	1
AT5G33400	5	12682231	12682927	696	-	0
AT5G33402	5	12669980	12672312	2332	-	1
AT5G33404	5	12674827	12675080	253	+	0
AT5G33405	5	12683326	12684600	1274	+	0
AT5G33406	5	12676054	12678403	2349	-	0
AT5G33410	5	12687332	12688479	1147	-	0
AT5G33415	5	12690064	12694730	4666	-	0
AT5G33420	5	12699281	12701623	2342	-	0
AT5G33421	5	12704686	12704788	102	-	0
AT5G33422	5	12707517	12710289	2772	+	0
AT5G33424	5	12712013	12714275	2262	+	0
AT5G33427	5	12715033	12716881	1848	+	0
AT5G33428	5	12720970	12727586	6616	+	0
AT5G33431	5	12742863	12744019	1156	-	0
AT5G33432	5	12728898	12729634	736	-	0
AT5G33433	5	12739313	12739690	377	-	0
AT5G33434	5	12745750	12750205	4455	-	0
AT5G33436	5	12734108	12735277	1169	-	0
AT5G33438	5	12752519	12754535	2016	-	0
AT5G33439	5	12738897	12739212	315	-	0
AT5G33441	5	12737078	12738581	1503	-	0
AT5G33442	5	12755640	12758275	2635	+	0
AT5G33533	5	12758855	12766533	7678	-	0
AT5G33624	5	12770434	12776410	5976	-	0
AT5G33715	5	12782298	12782787	489	-	0
AT5G33806	5	12784838	12787298	2460	+	0
AT5G33898	5	12787598	12788778	1180	+	0
AT5G33990	5	12791431	12794551	3120	-	0
AT5G34082	5	12794968	12796844	1876	-	0
AT5G34174	5	12797196	12798429	1233	+	0
AT5G34266	5	12798681	12799635	954	-	0
AT5G34358	5	12802377	12802848	471	+	0
AT5G34376	5	12837837	12838797	960	-	0
AT5G34394	5	12839139	12840366	1227	+	0
AT5G34412	5	12840490	12841837	1347	-	0
AT5G34431	5	12888193	12890980	2787	+	0
AT5G34450	5	12893059	12894008	949	+	0
AT5G34460	5	12897306	12897719	413	+	0
AT5G34480	5	12898288	12900448	2160	-	0
AT5G34500	5	12902120	12903143	1023	+	0
AT5G34520	5	12904124	12905684	1560	+	0
AT5G34540	5	12909115	12910041	926	+	0
AT5G34560	5	12916587	12917571	984	-	0
AT5G34581	5	12920365	12921018	653	+	0
AT5G34602	5	12921296	12923057	1761	+	0
AT5G34623	5	12928507	12933349	4842	-	0
AT5G34644	5	12934140	12935436	1296	-	0
AT5G34665	5	12935516	12940229	4713	+	0
AT5G34686	5	12940775	12941933	1158	+	0
AT5G34696	5	12942902	12944561	1659	-	0
AT5G34707	5	12946016	12947465	1449	-	0
AT5G34728	5	12948174	12950352	2178	-	0
AT5G34749	5	12951061	12952393	1332	+	0
AT5G34770	5	12955719	12960171	4452	+	0
AT5G34780	5	12961681	12963892	2211	-	0
AT5G34790	5	12966079	12968155	2076	+	84
AT5G34795	5	12969405	12970836	1431	+	66
AT5G34800	5	12971143	12973180	2037	+	87
AT5G34810	5	12974775	12975438	663	+	11
AT5G34820	5	12976649	12977309	660	-	8
AT5G34825	5	12979611	12981477	1866	-	20
AT5G34828	5	13094068	13094344	276	-	0
AT5G34829	5	12982670	12982889	219	-	0
AT5G34830	5	12981644	12982497	853	+	13
AT5G34831	5	12983241	12984120	879	+	0
AT5G34832	5	12984739	12985360	621	+	0
AT5G34833	5	12985524	12991092	5568	-	0
AT5G34834	5	12993228	12995709	2481	+	0
AT5G34835	5	12996227	12997214	987	+	0
AT5G34836	5	12998468	13001189	2721	+	0
AT5G34837	5	13005693	13006653	960	+	0
AT5G34838	5	13008217	13009492	1275	+	1
AT5G34839	5	13018224	13018805	581	+	0
AT5G34840	5	13054468	13055728	1260	-	0
AT5G34841	5	13020821	13022144	1323	+	0
AT5G34842	5	13023683	13026784	3101	+	0
AT5G34843	5	13027319	13029224	1905	+	0
AT5G34844	5	13032718	13035262	2544	+	0
AT5G34845	5	13036201	13038013	1812	+	0
AT5G34846	5	13041709	13043929	2220	-	0
AT5G34847	5	13046902	13047433	531	+	0
AT5G34848	5	13055897	13056920	1023	+	0
AT5G34849	5	13070533	13074757	4224	+	0
AT5G34850	5	13108153	13111631	3478	-	3861
AT5G34851	5	13086816	13091997	5181	+	0
AT5G34852	5	13101333	13101579	246	-	0
AT5G34853	5	13103677	13107090	3413	+	449
AT5G34854	5	13115070	13117684	2614	+	0
AT5G34855	5	13120187	13121596	1409	-	0
AT5G34856	5	13121989	13128286	6297	-	0
AT5G34857	5	13128439	13129606	1167	+	0
AT5G34858	5	13134875	13136513	1638	-	0
AT5G34859	5	13137438	13137777	339	+	0
AT5G34860	5	13182691	13184771	2080	-	0
AT5G34861	5	13141756	13142246	490	+	0
AT5G34862	5	13143973	13147606	3633	-	0
AT5G34863	5	13148458	13152499	4041	+	0
AT5G34864	5	13158219	13161939	3720	+	0
AT5G34865	5	13163921	13165382	1461	+	0
AT5G34866	5	13167718	13169344	1626	+	0
AT5G34867	5	13171122	13176186	5064	+	0
AT5G34868	5	13177599	13180050	2451	-	0
AT5G34869	5	13061034	13062230	1196	+	0
AT5G34870	5	13185520	13187946	2426	+	0
AT5G34871	5	13085036	13086565	1529	+	35
AT5G34880	5	13193399	13195209	1810	+	0
AT5G34881	5	13197651	13197999	348	+	0
AT5G34882	5	13195704	13196052	348	+	0
AT5G34883	5	13199597	13199945	348	+	0
AT5G34885	5	13201474	13202185	711	+	0
AT5G34887	5	13203493	13203841	348	+	0
AT5G34890	5	13206339	13208918	2579	+	0
AT5G34895	5	13209813	13211899	2086	-	0
AT5G34900	5	13214695	13219362	4667	-	0
AT5G34903	5	13221189	13221537	348	+	0
AT5G34905	5	13223132	13223480	348	+	0
AT5G34908	5	13225066	13225315	249	+	0
AT5G34910	5	13226057	13226321	264	+	0
AT5G34920	5	13227194	13227825	631	+	0
AT5G34925	5	13228856	13229660	804	-	0
AT5G34930	5	13233373	13235567	2194	+	157
AT5G34940	5	13235828	13238839	3011	-	203
AT5G34945	5	13241998	13242745	747	-	0
AT5G34950	5	13244556	13245839	1283	-	0
AT5G34960	5	13246526	13251225	4699	-	0
AT5G34965	5	13253348	13258229	4881	-	0
AT5G34970	5	13259323	13261366	2043	+	2
AT5G34980	5	13262203	13262687	484	+	0
AT5G34985	5	13264940	13270577	5637	-	0
AT5G34990	5	13271932	13274842	2910	+	0
AT5G35000	5	13275207	13275881	674	+	0
AT5G35010	5	13276670	13277363	693	+	0
AT5G35020	5	13278166	13278445	279	+	0
AT5G35021	5	13278854	13279796	942	-	0
AT5G35023	5	13280386	13283296	2910	-	0
AT5G35025	5	13285644	13289722	4078	+	0
AT5G35030	5	13291121	13291848	727	-	0
AT5G35035	5	13293159	13293678	519	-	0
AT5G35040	5	13294025	13295042	1017	+	0
AT5G35045	5	13295471	13298304	2833	-	0
AT5G35046	5	13301419	13304806	3387	+	0
AT5G35048	5	13305468	13306464	996	+	0
AT5G35050	5	13311035	13311854	819	-	0
AT5G35052	5	13315154	13318790	3636	-	0
AT5G35057	5	13320516	13326651	6135	-	2
AT5G35061	5	13327813	13328383	570	-	0
AT5G35065	5	13328412	13330548	2136	-	0
AT5G35066	5	13332536	13332650	114	-	0
AT5G35069	5	13336474	13336657	183	+	0
AT5G35070	5	13336980	13338990	2010	-	0
AT5G35073	5	13340656	13341994	1338	-	0
AT5G35076	5	13348105	13353283	5178	+	0
AT5G35080	5	13354272	13356817	2545	-	354
AT5G35090	5	13358413	13359088	675	+	0
AT5G35100	5	13360282	13361390	1108	-	2011
AT5G35110	5	13363936	13364275	339	-	0
AT5G35111	5	13366071	13367241	1170	-	0
AT5G35113	5	13373578	13378239	4661	-	0
AT5G35116	5	13379835	13381935	2100	+	0
AT5G35118	5	13384736	13385442	706	-	0
AT5G35120	5	13386851	13387175	324	-	0
AT5G35130	5	13390728	13392273	1545	-	0
AT5G35140	5	13394307	13396013	1706	+	0
AT5G35142	5	13397088	13399881	2793	+	1
AT5G35145	5	13400551	13402834	2283	+	0
AT5G35146	5	13404007	13404991	984	+	0
AT5G35148	5	13405609	13407178	1569	+	0
AT5G35150	5	13410610	13412704	2094	+	0
AT5G35160	5	13414750	13417265	2515	+	1280
AT5G35170	5	13419165	13423746	4581	+	7648
AT5G35180	5	13424417	13433018	8601	+	2077
AT5G35190	5	13434180	13435167	987	+	0
AT5G35195	5	13449572	13449749	177	-	0
AT5G35200	5	13462161	13466051	3890	-	694
AT5G35205	5	13466903	13471592	4689	-	0
AT5G35207	5	13471729	13472482	753	-	0
AT5G35210	5	13474195	13482591	8396	-	2694
AT5G35220	5	13484430	13487584	3154	-	1825
AT5G35230	5	13489977	13491673	1696	-	0
AT5G35240	5	13495593	13497910	2317	+	0
AT5G35250	5	13501484	13503772	2288	+	0
AT5G35260	5	13504637	13505971	1334	+	0
AT5G35270	5	13507447	13508381	934	+	0
AT5G35280	5	13509621	13510530	909	+	0
AT5G35290	5	13517886	13518306	420	-	0
AT5G35300	5	13518316	13518949	633	+	0
AT5G35310	5	13520904	13521327	423	-	0
AT5G35320	5	13521778	13523425	1647	+	205
AT5G35330	5	13523402	13525791	2389	-	354
AT5G35331	5	13526417	13531682	5265	-	0
AT5G35332	5	13532431	13536037	3606	+	0
AT5G35334	5	13537916	13538984	1068	+	0
AT5G35336	5	13543156	13544446	1290	+	0
AT5G35337	5	13545608	13546581	973	-	12
AT5G35338	5	13549342	13550124	782	-	0
AT5G35339	5	13552637	13552951	314	+	0
AT5G35340	5	13562791	13565902	3111	+	0
AT5G35341	5	13554777	13557670	2893	+	0
AT5G35344	5	13568728	13569617	889	+	0
AT5G35348	5	13569957	13570614	657	+	0
AT5G35353	5	13571675	13573328	1653	-	0
AT5G35354	5	13573967	13576078	2111	-	1
AT5G35356	5	13578380	13579247	867	+	0
AT5G35360	5	13584105	13588496	4391	+	4271
AT5G35370	5	13588432	13591271	2839	-	154
AT5G35375	5	13592254	13593149	895	+	0
AT5G35380	5	13593428	13596293	2865	-	0
AT5G35390	5	13596872	13598976	2104	+	0
AT5G35400	5	13599219	13602269	3050	-	146
AT5G35405	5	13604161	13604726	565	-	0
AT5G35407	5	13611797	13611932	135	+	2
AT5G35410	5	13634453	13638297	3844	+	140
AT5G35413	5	13639181	13643273	4092	-	0
AT5G35416	5	13644788	13649513	4725	-	0
AT5G35420	5	13655194	13655937	743	-	9
AT5G35425	5	13659848	13660734	886	-	1
AT5G35430	5	13661922	13666015	4093	+	593
AT5G35450	5	13667685	13671184	3499	+	356
AT5G35460	5	13672538	13674739	2201	+	1209
AT5G35470	5	13682475	13682748	273	-	0
AT5G35475	5	13686251	13687326	1075	-	0
AT5G35480	5	13689203	13689558	355	-	276
AT5G35490	5	13689816	13690548	732	+	414
AT5G35495	5	13694864	13698386	3522	+	22
AT5G35510	5	13699829	13700036	207	+	4
AT5G35520	5	13701395	13703125	1730	+	184
AT5G35525	5	13707083	13707955	872	+	1
AT5G35526	5	13708800	13708911	111	-	0
AT5G35530	5	13710110	13712288	2178	-	2769
AT5G35535	5	13713459	13719312	5853	+	0
AT5G35540	5	13722136	13722993	857	+	0
AT5G35550	5	13726742	13727860	1118	+	2
AT5G35555	5	13736244	13740702	4458	-	0
AT5G35560	5	13742108	13748312	6204	-	1066
AT5G35570	5	13749710	13753458	3748	-	619
AT5G35575	5	13756127	13758995	2868	-	0
AT5G35580	5	13761964	13763944	1980	+	9
AT5G35590	5	13765137	13767823	2686	-	1709
AT5G35600	5	13770120	13771712	1592	-	3
AT5G35601	5	13776347	13777103	756	-	0
AT5G35602	5	13779114	13784340	5226	+	0
AT5G35603	5	13785167	13786329	1162	-	0
AT5G35604	5	13788204	13789345	1141	-	0
AT5G35605	5	13805981	13806054	73	-	0
AT5G35606	5	13791079	13794238	3159	+	0
AT5G35607	5	13795195	13796686	1491	-	0
AT5G35608	5	13798470	13800663	2193	+	1
AT5G35610	5	13819505	13820293	788	-	0
AT5G35615	5	13821823	13823683	1860	-	0
AT5G35620	5	13824704	13826391	1687	-	1055
AT5G35630	5	13830428	13833542	3114	+	60678
AT5G35631	5	13833707	13833929	222	-	0
AT5G35640	5	13834632	13835606	974	+	0
AT5G35643	5	13836114	13843155	7041	+	0
AT5G35646	5	13843960	13844653	693	+	0
AT5G35650	5	13845627	13846092	465	+	0
AT5G35655	5	13846650	13847587	937	-	0
AT5G35657	5	13848347	13851110	2763	-	0
AT5G35660	5	13852389	13853717	1328	-	0
AT5G35670	5	13856102	13858059	1957	+	118
AT5G35680	5	13857920	13859013	1093	-	1238
AT5G35688	5	13864214	13864367	153	-	0
AT5G35690	5	13864851	13868238	3387	-	911
AT5G35695	5	13869119	13869941	822	+	0
AT5G35698	5	13871714	13871948	234	+	0
AT5G35700	5	13872534	13876857	4323	-	521
AT5G35710	5	13877522	13878400	878	+	0
AT5G35715	5	13881221	13882937	1716	+	0
AT5G35720	5	13884062	13885277	1215	-	0
AT5G35725	5	13885444	13890247	4803	+	0
AT5G35730	5	13893706	13896974	3268	+	515
AT5G35732	5	13897939	13898387	448	+	46
AT5G35735	5	13900751	13902997	2246	-	220
AT5G35736	5	13905835	13906798	963	+	0
AT5G35737	5	13907163	13907535	372	+	0
AT5G35738	5	13909370	13909688	318	+	18
AT5G35740	5	13910417	13911160	743	-	197
AT5G35750	5	13911370	13916337	4967	-	892
AT5G35753	5	13922568	13925272	2704	-	166
AT5G35756	5	13926080	13931885	5805	-	0
AT5G35760	5	13934107	13934782	675	+	2
AT5G35770	5	13936085	13940867	4782	-	1
AT5G35775	5	13945013	13947770	2757	+	0
AT5G35777	5	13949227	13953802	4575	+	127
AT5G35780	5	13955412	13956421	1009	+	0
AT5G35790	5	13956689	13959753	3064	-	5154
AT5G35791	5	13961410	13963498	2088	+	0
AT5G35792	5	13964642	13965218	576	+	0
AT5G35794	5	13965555	13968112	2557	-	0
AT5G35796	5	13968536	13969932	1396	-	0
AT5G35798	5	13972006	13972578	572	-	0
AT5G35800	5	13975326	13975854	528	-	0
AT5G35802	5	13978446	13980051	1605	-	0
AT5G35805	5	13983309	13983651	342	-	0
AT5G35810	5	13993427	13994549	1122	-	0
AT5G35820	5	13995482	13999511	4029	+	0
AT5G35830	5	14000312	14001416	1104	-	0
AT5G35840	5	14007825	14011764	3939	+	1093
AT5G35860	5	14018385	14018925	540	-	0
AT5G35870	5	14021021	14021612	591	+	1
AT5G35880	5	14022865	14023024	159	-	0
AT5G35890	5	14025862	14026726	864	-	0
AT5G35900	5	14028681	14029426	745	+	0
AT5G35910	5	14029685	14035493	5808	-	714
AT5G35912	5	14037230	14038922	1692	-	0
AT5G35914	5	14042640	14043894	1254	+	18
AT5G35915	5	14044865	14045859	994	+	0
AT5G35917	5	14049122	14051128	2006	+	0
AT5G35918	5	14051736	14052722	986	+	0
AT5G35920	5	14056436	14056904	468	+	0
AT5G35923	5	14059148	14059757	609	+	0
AT5G35926	5	14062675	14065706	3031	+	21
AT5G35930	5	14066991	14074751	7760	-	342
AT5G35932	5	14076249	14078050	1801	+	4
AT5G35935	5	14083387	14089891	6504	-	339
AT5G35940	5	14090824	14092977	2153	+	0
AT5G35945	5	14093674	14094277	603	+	0
AT5G35950	5	14104942	14106764	1822	+	0
AT5G35960	5	14108523	14110536	2013	-	19
AT5G35965	5	14113310	14117927	4617	-	2
AT5G35970	5	14118875	14123340	4465	-	15951
AT5G35980	5	14127983	14136324	8341	+	2077
AT5G35995	5	14136549	14138628	2079	-	319
AT5G36000	5	14139995	14141892	1897	+	30
AT5G36001	5	14141640	14143436	1796	+	1
AT5G36002	5	14141897	14143241	1344	-	0
AT5G36005	5	14144013	14149194	5181	+	0
AT5G36010	5	14153201	14154092	891	+	0
AT5G36015	5	14156683	14157622	939	-	0
AT5G36020	5	14159320	14162948	3628	+	0
AT5G36030	5	14163043	14164523	1480	+	0
AT5G36035	5	14166592	14167380	788	-	0
AT5G36040	5	14168628	14169362	734	+	0
AT5G36050	5	14169977	14170985	1008	+	0
AT5G36060	5	14171714	14172280	566	+	0
AT5G36070	5	14172852	14173735	883	+	0
AT5G36075	5	14177276	14180402	3126	-	0
AT5G36080	5	14184422	14185277	855	+	0
AT5G36090	5	14189057	14189956	899	+	0
AT5G36100	5	14191710	14194176	2466	-	0
AT5G36110	5	14195376	14197613	2237	+	0
AT5G36120	5	14198586	14199243	657	-	938
AT5G36125	5	14204408	14208495	4087	+	0
AT5G36130	5	14209292	14209811	519	-	0
AT5G36140	5	14212211	14213259	1048	-	0
AT5G36150	5	14220736	14225422	4686	-	0
AT5G36160	5	14233109	14235151	2042	-	2304
AT5G36170	5	14235875	14238026	2151	-	2200
AT5G36180	5	14239027	14242135	3108	+	0
AT5G36185	5	14242542	14243058	516	+	0
AT5G36190	5	14243108	14243546	438	-	0
AT5G36200	5	14244105	14246296	2191	-	0
AT5G36210	5	14247912	14253295	5383	-	1734
AT5G36220	5	14253689	14256033	2344	-	49
AT5G36223	5	14256388	14259253	2865	-	0
AT5G36226	5	14268569	14271006	2437	+	0
AT5G36228	5	14271348	14273258	1910	+	0
AT5G36230	5	14273383	14277026	3643	+	3006
AT5G36240	5	14277971	14278924	953	-	0
AT5G36250	5	14282102	14284581	2479	+	895
AT5G36260	5	14284954	14288333	3379	-	10
AT5G36270	5	14292930	14293584	654	+	0
AT5G36275	5	14295282	14297046	1764	-	0
AT5G36280	5	14299234	14299462	228	-	1
AT5G36290	5	14302738	14305176	2438	+	930
AT5G36293	5	14306523	14307036	513	-	0
AT5G36296	5	14309407	14312221	2814	+	0
AT5G36297	5	14315807	14316053	246	+	0
AT5G36300	5	14320667	14322426	1759	+	0
AT5G36310	5	14324710	14325058	348	-	0
AT5G36320	5	14326900	14327257	357	-	0
AT5G36330	5	14329097	14330209	1112	-	0
AT5G36340	5	14331285	14331633	348	-	0
AT5G36350	5	14333472	14333829	357	-	0
AT5G36360	5	14335667	14336024	357	-	0
AT5G36370	5	14337864	14338221	357	-	0
AT5G36380	5	14340061	14340418	357	-	0
AT5G36390	5	14342256	14342613	357	-	0
AT5G36400	5	14344451	14344808	357	-	0
AT5G36410	5	14346646	14347003	357	-	0
AT5G36420	5	14348841	14349198	357	-	0
AT5G36430	5	14351036	14351393	357	-	0
AT5G36440	5	14353232	14353589	357	-	0
AT5G36450	5	14355429	14355786	357	-	0
AT5G36460	5	14357625	14357982	357	-	0
AT5G36470	5	14359686	14360179	493	-	0
AT5G36480	5	14362019	14362376	357	-	0
AT5G36490	5	14364216	14364573	357	-	0
AT5G36500	5	14366413	14366770	357	-	0
AT5G36510	5	14368611	14368968	357	-	0
AT5G36520	5	14370813	14371170	357	-	0
AT5G36530	5	14373007	14373364	357	-	0
AT5G36540	5	14375200	14375557	357	-	0
AT5G36550	5	14377393	14377750	357	-	0
AT5G36650	5	14380267	14380744	477	-	0
AT5G36655	5	14380887	14383080	2193	+	0
AT5G36657	5	14383876	14384176	300	-	0
AT5G36658	5	14386071	14386428	357	-	0
AT5G36659	5	14388321	14388621	300	-	0
AT5G36660	5	14396687	14399025	2338	+	0
AT5G36661	5	14390428	14390785	357	-	0
AT5G36662	5	14392618	14392975	357	-	0
AT5G36670	5	14401490	14406427	4937	+	1
AT5G36680	5	14406801	14409137	2336	-	0
AT5G36685	5	14413693	14414168	475	+	0
AT5G36690	5	14415184	14417288	2104	-	0
AT5G36700	5	14421575	14424511	2936	-	33
AT5G36710	5	14425264	14426109	845	-	0
AT5G36720	5	14429660	14429924	264	-	0
AT5G36722	5	14431598	14432216	618	-	0
AT5G36730	5	14436316	14437549	1233	+	0
AT5G36732	5	14443851	14446824	2973	+	0
AT5G36734	5	14447372	14448214	842	+	0
AT5G36736	5	14448811	14449312	501	-	0
AT5G36737	5	14455986	14458324	2338	+	0
AT5G36738	5	14449727	14450084	357	-	0
AT5G36739	5	14451917	14452274	357	-	0
AT5G36740	5	14460789	14465727	4938	+	2
AT5G36770	5	14466101	14468486	2385	-	0
AT5G36775	5	14472989	14473448	459	+	0
AT5G36780	5	14474484	14476588	2104	-	0
AT5G36790	5	14480873	14483814	2941	-	37
AT5G36800	5	14484564	14485409	845	-	0
AT5G36805	5	14488960	14489224	264	-	0
AT5G36810	5	14490769	14491516	747	-	0
AT5G36820	5	14495616	14496849	1233	+	0
AT5G36825	5	14503151	14506090	2939	+	0
AT5G36830	5	14506672	14507514	842	+	0
AT5G36840	5	14508086	14510203	2117	-	0
AT5G36850	5	14511169	14511865	696	-	0
AT5G36860	5	14512230	14517109	4879	-	0
AT5G36870	5	14518315	14533930	15615	+	4
AT5G36880	5	14534612	14540299	5687	-	2103
AT5G36890	5	14541349	14546230	4881	-	334
AT5G36900	5	14546923	14548203	1280	+	0
AT5G36903	5	14555137	14555523	386	+	0
AT5G36904	5	14556140	14556625	485	+	0
AT5G36905	5	14557797	14560184	2387	+	0
AT5G36910	5	14561816	14562750	934	-	766
AT5G36920	5	14564391	14564971	580	-	3
AT5G36925	5	14565812	14566244	432	-	1
AT5G36930	5	14567621	14572630	5009	-	579
AT5G36935	5	14574599	14584700	10101	+	0
AT5G36937	5	14586127	14586835	708	-	2
AT5G36940	5	14590165	14594384	4219	+	856
AT5G36950	5	14594980	14598371	3391	+	329
AT5G36960	5	14598692	14599988	1296	+	9
AT5G36970	5	14604366	14605194	828	-	1
AT5G36980	5	14606979	14607754	775	-	0
AT5G36990	5	14614925	14616135	1210	-	0
AT5G37000	5	14618106	14620282	2176	+	96
AT5G37010	5	14620731	14622941	2210	-	199
AT5G37017	5	14628220	14628847	627	-	0
AT5G37020	5	14630027	14634387	4360	+	1418
AT5G37030	5	14634613	14636939	2326	-	0
AT5G37040	5	14639134	14639934	800	+	0
AT5G37050	5	14640509	14641421	912	-	5
AT5G37055	5	14641550	14642440	890	-	103
AT5G37060	5	14642740	14645414	2674	-	0
AT5G37070	5	14651011	14652286	1275	+	289
AT5G37072	5	14652749	14653818	1069	-	19
AT5G37080	5	14659132	14662408	3276	+	0
AT5G37090	5	14663636	14664299	663	+	0
AT5G37100	5	14664935	14666217	1282	+	0
AT5G37110	5	14669593	14674913	5320	+	0
AT5G37120	5	14677665	14677962	297	+	0
AT5G37125	5	14678340	14680737	2397	-	2
AT5G37130	5	14681377	14686684	5307	+	786
AT5G37140	5	14690435	14692851	2416	+	0
AT5G37145	5	14694502	14696107	1605	+	0
AT5G37150	5	14701329	14704562	3233	+	0
AT5G37160	5	14705425	14708376	2951	+	0
AT5G37170	5	14712810	14714303	1493	+	0
AT5G37175	5	14715701	14716470	769	-	1
AT5G37180	5	14718237	14722913	4676	+	96
AT5G37190	5	14723143	14726694	3551	-	479
AT5G37200	5	14727831	14728485	654	+	0
AT5G37210	5	14729224	14731508	2284	-	0
AT5G37220	5	14733876	14734521	645	+	0
AT5G37230	5	14735153	14735780	627	+	0
AT5G37240	5	14737559	14739256	1697	-	3
AT5G37250	5	14750392	14750971	579	+	0
AT5G37260	5	14751343	14753088	1745	-	18
AT5G37270	5	14757932	14758559	627	-	0
AT5G37280	5	14761274	14761925	651	-	0
AT5G37290	5	14762369	14764344	1975	+	162
AT5G37300	5	14767498	14770249	2751	+	291
AT5G37310	5	14772511	14776207	3696	-	607
AT5G37320	5	14777930	14779717	1787	+	0
AT5G37330	5	14783435	14786027	2592	+	0
AT5G37340	5	14787263	14792772	5509	-	157
AT5G37350	5	14792983	14796027	3044	+	343
AT5G37351	5	14797305	14797497	192	-	0
AT5G37352	5	14796125	14797001	876	+	0
AT5G37360	5	14805228	14808236	3008	-	5069
AT5G37370	5	14812574	14816628	4054	-	1057
AT5G37380	5	14816758	14819296	2538	-	409
AT5G37381	5	14822783	14825642	2859	+	0
AT5G37383	5	14827029	14829390	2361	+	0
AT5G37385	5	14830452	14830960	508	+	0
AT5G37390	5	14831431	14833855	2424	-	0
AT5G37400	5	14834342	14836346	2004	+	32
AT5G37410	5	14836660	14838508	1848	+	50
AT5G37415	5	14839046	14840301	1255	-	0
AT5G37420	5	14840142	14842070	1928	+	0
AT5G37430	5	14842429	14844308	1879	+	1
AT5G37440	5	14844358	14845560	1202	-	12
AT5G37442	5	14848916	14849771	855	-	0
AT5G37445	5	14851653	14852479	826	-	0
AT5G37450	5	14852800	14857098	4298	-	5
AT5G37460	5	14858493	14860362	1869	-	0
AT5G37470	5	14861502	14863392	1890	-	0
AT5G37473	5	14870835	14871153	318	-	0
AT5G37474	5	14875185	14875527	342	-	0
AT5G37475	5	14866056	14868741	2685	-	654
AT5G37476	5	14875889	14876773	884	+	0
AT5G37478	5	14881559	14883989	2430	+	1
AT5G37480	5	14884330	14885969	1639	-	271
AT5G37485	5	14886192	14886979	787	-	5
AT5G37490	5	14887477	14889151	1674	+	0
AT5G37500	5	14889691	14895214	5523	-	96
AT5G37510	5	14897409	14900657	3248	+	3945
AT5G37520	5	14902669	14904211	1542	+	0
AT5G37530	5	14906458	14909177	2719	+	92
AT5G37540	5	14912834	14914431	1597	+	102
AT5G37550	5	14918900	14919868	968	-	66
AT5G37560	5	14921985	14923790	1805	+	0
AT5G37570	5	14924493	14926146	1653	-	32
AT5G37590	5	14927312	14932787	5475	-	178
AT5G37600	5	14933335	14935841	2506	-	902
AT5G37610	5	14938120	14938612	492	+	0
AT5G37620	5	14942395	14944354	1959	-	0
AT5G37630	5	14947329	14952765	5436	+	308
AT5G37640	5	14952781	14953750	969	-	0
AT5G37650	5	14954010	14955834	1824	-	0
AT5G37660	5	14959796	14961594	1798	+	110
AT5G37665	5	14962140	14967533	5393	-	0
AT5G37667	5	14968246	14968351	105	-	0
AT5G37670	5	14968990	14969509	519	+	32
AT5G37680	5	14969595	14971312	1717	-	358
AT5G37690	5	14973352	14976169	2817	-	27
AT5G37710	5	14979158	14981400	2242	+	174
AT5G37720	5	14981637	14984606	2969	-	591
AT5G37730	5	14986032	14986917	885	-	0
AT5G37732	5	14987705	14988261	556	-	0
AT5G37740	5	14992004	14993671	1667	+	95
AT5G37750	5	14995788	14997046	1258	+	4
AT5G37760	5	14997167	14998219	1052	+	7
AT5G37770	5	14998853	14999619	766	-	479
AT5G37780	5	15004526	15006205	1679	-	1073
AT5G37790	5	15008171	15011152	2981	-	398
AT5G37795	5	15032507	15032581	74	-	0
AT5G37800	5	15036196	15037574	1378	+	0
AT5G37810	5	15045231	15047807	2576	+	0
AT5G37820	5	15050260	15051542	1282	+	0
AT5G37830	5	15056187	15060777	4590	-	1390
AT5G37840	5	15062007	15063402	1395	-	0
AT5G37850	5	15065373	15068999	3626	+	990
AT5G37860	5	15069577	15070555	978	-	1
AT5G37870	5	15073763	15074851	1088	-	0
AT5G37872	5	15079743	15081114	1371	+	0
AT5G37875	5	15081741	15083988	2247	+	0
AT5G37880	5	15084459	15084988	529	-	0
AT5G37890	5	15090285	15091894	1609	-	160
AT5G37900	5	15093902	15094802	900	-	0
AT5G37910	5	15096209	15097318	1109	-	0
AT5G37920	5	15099340	15101170	1830	-	0
AT5G37930	5	15102199	15103669	1470	-	285
AT5G37940	5	15107295	15108966	1671	+	4
AT5G37950	5	15115882	15117617	1735	+	4
AT5G37960	5	15121437	15121836	399	+	0
AT5G37970	5	15123088	15124684	1596	-	1
AT5G37980	5	15131359	15133085	1726	+	11
AT5G37990	5	15133736	15135500	1764	-	15
AT5G38000	5	15141787	15143492	1705	+	10
AT5G38005	5	15155066	15156088	1022	+	43
AT5G38010	5	15158274	15160212	1938	+	35
AT5G38020	5	15165651	15167729	2078	-	4
AT5G38030	5	15171245	15175457	4212	-	8
AT5G38035	5	15176230	15180696	4466	+	0
AT5G38037	5	15183656	15184337	681	+	0
AT5G38040	5	15185076	15186508	1432	+	89
AT5G38050	5	15187518	15188783	1265	+	106
AT5G38060	5	15189443	15190132	689	+	199
AT5G38070	5	15190228	15191689	1461	+	45
AT5G38080	5	15191714	15192645	931	-	1
AT5G38090	5	15193465	15194089	624	-	0
AT5G38096	5	15198467	15204265	5798	-	6
AT5G38100	5	15199488	15201197	1709	-	37
AT5G38110	5	15208469	15210215	1746	+	202
AT5G38120	5	15213764	15216205	2441	+	45
AT5G38130	5	15217909	15219372	1463	-	1
AT5G38140	5	15220207	15222272	2065	-	514
AT5G38150	5	15223115	15225107	1992	-	1110
AT5G38155	5	15225317	15225391	74	+	0
AT5G38160	5	15225766	15226208	442	+	0
AT5G38170	5	15227637	15228081	444	+	0
AT5G38180	5	15229809	15230243	434	+	0
AT5G38190	5	15234187	15237906	3719	+	0
AT5G38192	5	15238554	15244741	6187	-	0
AT5G38195	5	15246909	15247329	420	+	0
AT5G38197	5	15251023	15251314	291	+	0
AT5G38200	5	15256275	15258755	2480	+	24
AT5G38210	5	15261004	15265630	4626	+	70
AT5G38212	5	15262453	15265241	2788	-	118
AT5G38220	5	15268826	15271386	2560	+	345
AT5G38230	5	15274325	15276766	2441	+	30
AT5G38240	5	15277238	15279317	2079	-	76
AT5G38250	5	15280642	15282709	2067	-	1
AT5G38260	5	15283691	15285837	2146	-	0
AT5G38270	5	15289031	15290252	1221	+	0
AT5G38275	5	15290724	15292125	1401	-	0
AT5G38280	5	15293120	15297323	4203	-	14
AT5G38285	5	15298032	15300708	2676	-	0
AT5G38290	5	15303335	15305548	2213	+	461
AT5G38300	5	15305931	15307008	1077	+	42
AT5G38310	5	15310404	15311321	917	-	1
AT5G38314	5	15312955	15313078	123	-	0
AT5G38317	5	15314059	15315226	1167	+	0
AT5G38320	5	15316014	15316834	820	-	14
AT5G38330	5	15317766	15318445	679	+	0
AT5G38340	5	15320506	15324061	3555	+	33
AT5G38344	5	15325830	15326988	1158	+	0
AT5G38350	5	15328658	15331528	2870	+	1
AT5G38360	5	15331710	15333625	1915	-	493
AT5G38365	5	15334172	15339896	5724	+	0
AT5G38370	5	15340392	15340695	303	-	0
AT5G38378	5	15344447	15344711	264	+	0
AT5G38380	5	15345443	15348427	2984	+	279
AT5G38383	5	15351375	15360312	8937	+	3
AT5G38386	5	15363177	15364815	1638	+	0
AT5G38390	5	15366431	15368053	1622	+	0
AT5G38393	5	15368227	15372475	4248	+	1
AT5G38396	5	15373093	15374726	1633	+	0
AT5G38400	5	15375845	15376301	456	+	0
AT5G38410	5	15377172	15378416	1244	-	178232
AT5G38420	5	15380944	15382035	1091	-	72689
AT5G38430	5	15384116	15385247	1131	-	23272
AT5G38435	5	15388044	15388656	612	+	0
AT5G38437	5	15388779	15389428	649	+	0
AT5G38440	5	15390222	15390624	402	+	0
AT5G38450	5	15393753	15397279	3526	-	0
AT5G38460	5	15397739	15401095	3356	-	232
AT5G38470	5	15404641	15407711	3070	+	2707
AT5G38480	5	15409696	15411516	1820	+	4987
AT5G38490	5	15411671	15413132	1461	-	0
AT5G38500	5	15416017	15417253	1236	-	0
AT5G38510	5	15417732	15420606	2874	-	1606
AT5G38520	5	15421572	15423431	1859	+	5965
AT5G38530	5	15424037	15426470	2433	+	1033
AT5G38540	5	15426809	15428710	1901	-	0
AT5G38550	5	15432780	15435779	2999	-	2
AT5G38560	5	15439248	15443164	3916	+	639
AT5G38565	5	15444309	15446009	1700	-	36
AT5G38570	5	15449278	15450601	1323	-	0
AT5G38580	5	15451163	15451842	679	-	0
AT5G38590	5	15451932	15453897	1965	-	188
AT5G38595	5	15454385	15454905	520	+	0
AT5G38600	5	15456594	15460767	4173	+	329
AT5G38610	5	15460690	15461459	769	-	75
AT5G38620	5	15463857	15464907	1050	-	0
AT5G38630	5	15465991	15468185	2194	+	232
AT5G38640	5	15467678	15470724	3046	-	382
AT5G38650	5	15470960	15472815	1855	-	1
AT5G38660	5	15470899	15475585	4686	-	4692
AT5G38670	5	15475785	15476871	1086	+	0
AT5G38680	5	15477323	15479040	1717	+	0
AT5G38690	5	15479176	15483250	4074	-	383
AT5G38700	5	15489593	15490399	806	+	0
AT5G38705	5	15492041	15497246	5205	-	0
AT5G38710	5	15501244	15504109	2865	+	29
AT5G38720	5	15508243	15510559	2316	-	202
AT5G38730	5	15510900	15512691	1791	+	31
AT5G38740	5	15513024	15514305	1281	-	0
AT5G38750	5	15522649	15523180	531	+	1
AT5G38760	5	15524177	15524977	800	+	0
AT5G38770	5	15526113	15526407	294	+	8
AT5G38780	5	15530014	15531522	1508	+	40
AT5G38790	5	15533784	15534180	396	+	0
AT5G38800	5	15538196	15538802	606	-	0
AT5G38810	5	15540483	15541540	1057	-	0
AT5G38820	5	15543480	15545182	1702	+	0
AT5G38830	5	15545568	15548186	2618	-	1009
AT5G38840	5	15551295	15555077	3782	+	464
AT5G38850	5	15555155	15558732	3577	+	283
AT5G38860	5	15558955	15561126	2171	+	179
AT5G38870	5	15561464	15562122	658	+	120
AT5G38880	5	15563305	15569194	5889	-	722
AT5G38890	5	15569479	15571144	1665	+	94
AT5G38895	5	15571253	15573526	2273	+	154
AT5G38900	5	15573504	15575618	2114	-	9
AT5G38905	5	15575856	15575930	74	+	0
AT5G38910	5	15578810	15579584	774	+	0
AT5G38920	5	15581718	15582439	721	-	0
AT5G38930	5	15585072	15585841	769	+	33
AT5G38940	5	15588756	15589666	910	+	85
AT5G38950	5	15590692	15591050	358	+	0
AT5G38960	5	15592991	15593783	792	+	0
AT5G38970	5	15594673	15597885	3212	-	40
AT5G38975	5	15599619	15600044	425	+	0
AT5G38980	5	15606770	15607350	580	+	2690
AT5G38990	5	15608813	15611598	2785	+	1054
AT5G39000	5	15611859	15614481	2622	+	0
AT5G39010	5	15615947	15616457	510	+	0
AT5G39020	5	15616916	15619358	2442	+	65
AT5G39024	5	15619690	15619786	96	+	0
AT5G39030	5	15620065	15622486	2421	+	288
AT5G39040	5	15625577	15629802	4225	+	924
AT5G39050	5	15634585	15636065	1480	+	251
AT5G39060	5	15636612	15638509	1897	-	2
AT5G39070	5	15640052	15640789	737	-	1
AT5G39080	5	15641657	15643161	1504	+	766
AT5G39090	5	15643602	15645116	1514	+	34
AT5G39095	5	15646350	15650784	4434	-	0
AT5G39100	5	15653089	15654020	931	-	2
AT5G39110	5	15657801	15658584	783	-	0
AT5G39120	5	15662704	15663486	782	-	0
AT5G39130	5	15665501	15666444	943	-	0
AT5G39140	5	15667172	15667761	589	-	0
AT5G39150	5	15669897	15670808	911	-	0
AT5G39155	5	15671636	15676129	4493	-	0
AT5G39160	5	15679013	15680002	989	-	1
AT5G39170	5	15680730	15681325	595	-	0
AT5G39180	5	15683463	15684353	890	-	0
AT5G39185	5	15685227	15689705	4478	-	0
AT5G39190	5	15692590	15693581	991	-	0
AT5G39200	5	15694306	15695042	736	-	0
AT5G39205	5	15700769	15700976	207	+	0
AT5G39210	5	15703120	15704104	984	+	575
AT5G39220	5	15705815	15708228	2413	+	44
AT5G39230	5	15709473	15709925	452	+	0
AT5G39240	5	15712682	15713003	321	-	7
AT5G39245	5	15718363	15722158	3795	-	0
AT5G39250	5	15724486	15725756	1270	+	108
AT5G39260	5	15726377	15727458	1081	-	3
AT5G39270	5	15729117	15730150	1033	-	0
AT5G39280	5	15730712	15731706	994	-	0
AT5G39290	5	15735870	15736908	1038	-	0
AT5G39300	5	15737426	15738387	961	-	0
AT5G39310	5	15739279	15740514	1235	-	0
AT5G39320	5	15742761	15744943	2182	+	614
AT5G39330	5	15746233	15747119	886	+	0
AT5G39340	5	15748850	15750507	1657	+	486
AT5G39350	5	15750928	15752962	2034	+	21
AT5G39360	5	15752991	15754677	1686	-	315
AT5G39365	5	15756298	15756884	586	-	0
AT5G39370	5	15757716	15758109	393	+	0
AT5G39380	5	15758716	15760686	1970	-	88
AT5G39390	5	15763714	15765469	1755	-	0
AT5G39400	5	15766036	15768244	2208	+	0
AT5G39410	5	15768192	15770410	2218	-	136
AT5G39420	5	15772079	15775171	3092	+	12
AT5G39430	5	15775301	15777599	2298	-	0
AT5G39440	5	15781906	15784699	2793	+	0
AT5G39450	5	15785716	15787946	2230	+	134
AT5G39460	5	15788288	15790004	1716	-	0
AT5G39470	5	15791951	15793062	1111	-	1
AT5G39471	5	15793964	15795596	1632	-	32
AT5G39473	5	15797757	15799724	1967	-	5
AT5G39480	5	15801634	15803341	1707	-	0
AT5G39490	5	15805807	15807508	1701	-	0
AT5G39493	5	15810268	15810667	399	-	0
AT5G39500	5	15815273	15820045	4772	+	651
AT5G39510	5	15821441	15823840	2399	+	1223
AT5G39520	5	15823734	15825492	1758	-	3
AT5G39530	5	15826088	15828035	1947	-	3283
AT5G39532	5	15830984	15831271	287	-	0
AT5G39533	5	15831989	15833439	1450	-	0
AT5G39535	5	15827025	15827097	72	-	0
AT5G39540	5	15833742	15834420	678	-	0
AT5G39550	5	15837209	15840638	3429	-	144
AT5G39560	5	15841691	15843169	1478	-	0
AT5G39570	5	15843958	15846178	2220	+	6303
AT5G39580	5	15847077	15849108	2031	-	1
AT5G39581	5	15849154	15849301	147	-	0
AT5G39590	5	15851391	15853990	2599	+	1307
AT5G39600	5	15853928	15855192	1264	-	228
AT5G39610	5	15858399	15859788	1389	-	4
AT5G39620	5	15864165	15865782	1617	-	0
AT5G39630	5	15868261	15869714	1453	+	0
AT5G39635	5	15870589	15871000	411	-	0
AT5G39640	5	15873038	15873269	231	-	0
AT5G39645	5	15873391	15873680	289	-	0
AT5G39650	5	15875198	15876116	918	+	1
AT5G39660	5	15878698	15881044	2346	+	207
AT5G39670	5	15883178	15884067	889	+	98
AT5G39680	5	15884000	15886388	2388	-	9
AT5G39690	5	15888170	15890187	2017	+	0
AT5G39693	5	15891578	15891873	295	-	0
AT5G39700	5	15893760	15894424	664	-	0
AT5G39710	5	15895728	15897972	2244	+	190
AT5G39720	5	15899645	15900653	1008	+	0
AT5G39730	5	15901678	15902870	1192	+	752
AT5G39740	5	15903295	15905464	2169	+	5260
AT5G39750	5	15906874	15907942	1068	+	0
AT5G39760	5	15911415	15912830	1415	+	163
AT5G39770	5	15919240	15927549	8309	-	0
AT5G39785	5	15929187	15932276	3089	+	100
AT5G39790	5	15932713	15935261	2548	-	220
AT5G39800	5	15935463	15937132	1669	+	109
AT5G39810	5	15937277	15938344	1067	-	0
AT5G39820	5	15939299	15940491	1192	-	2
AT5G39830	5	15942796	15945827	3031	+	2372
AT5G39840	5	15946768	15949186	2418	+	132
AT5G39850	5	15950021	15951425	1404	+	147
AT5G39860	5	15957416	15958455	1039	+	253
AT5G39861	5	15960353	15961397	1044	-	0
AT5G39862	5	15961510	15964681	3171	+	0
AT5G39863	5	15964720	15965170	450	-	0
AT5G39865	5	15965460	15967173	1713	-	16
AT5G39870	5	15968621	15970046	1425	-	0
AT5G39880	5	15970886	15972237	1351	+	0
AT5G39890	5	15974392	15976270	1878	+	7
AT5G39895	5	15976286	15976359	73	+	0
AT5G39900	5	15976546	15979001	2455	-	141
AT5G39910	5	15979411	15981671	2260	-	0
AT5G39920	5	15982172	15983136	964	-	0
AT5G39930	5	15985024	15987339	2315	-	0
AT5G39940	5	15987460	15990701	3241	+	315
AT5G39950	5	15990686	15991931	1245	-	761
AT5G39955	5	15992433	15992928	495	-	0
AT5G39960	5	15994020	15997058	3038	+	160
AT5G39970	5	15998024	16000813	2789	+	25
AT5G39980	5	16000711	16003072	2361	-	193
AT5G39990	5	16004280	16006740	2460	+	490
AT5G39995	5	16008537	16009596	1059	+	1
AT5G40000	5	16011071	16012484	1413	-	0
AT5G40010	5	16020217	16021762	1545	-	13
AT5G40020	5	16022752	16024316	1564	-	59
AT5G40030	5	16026226	16028283	2057	+	26
AT5G40040	5	16029751	16030313	562	-	0
AT5G40050	5	16032082	16033551	1469	-	0
AT5G40060	5	16034575	16039096	4521	+	451
AT5G40070	5	16039178	16039747	569	+	0
AT5G40080	5	16039944	16041623	1679	-	106
AT5G40090	5	16041918	16043494	1576	-	7
AT5G40100	5	16043928	16047355	3427	+	13
AT5G40110	5	16049933	16050776	843	+	0
AT5G40120	5	16051878	16053036	1158	+	0
AT5G40130	5	16053696	16054056	360	-	0
AT5G40140	5	16057346	16058999	1653	+	183
AT5G40150	5	16059508	16061043	1535	-	219
AT5G40155	5	16061890	16062548	658	+	0
AT5G40160	5	16062478	16064349	1871	-	765
AT5G40170	5	16065090	16067574	2484	-	752
AT5G40180	5	16067922	16068206	284	+	1
AT5G40190	5	16069176	16069948	772	-	294
AT5G40200	5	16070329	16073314	2985	+	560
AT5G40210	5	16073619	16076117	2498	-	34
AT5G40212	5	16076673	16078037	1364	-	0
AT5G40220	5	16078389	16079364	975	-	0
AT5G40230	5	16079647	16081735	2088	-	14
AT5G40240	5	16082124	16084810	2686	-	208
AT5G40250	5	16085763	16087543	1780	+	433
AT5G40260	5	16089756	16091753	1997	+	1
AT5G40270	5	16093171	16097232	4061	-	250
AT5G40275	5	16098189	16100051	1862	-	0
AT5G40280	5	16101390	16104961	3571	+	241
AT5G40290	5	16105258	16108501	3243	-	0
AT5G40300	5	16110687	16112968	2281	+	193
AT5G40310	5	16113271	16115816	2545	-	0
AT5G40316	5	16119295	16120018	723	-	6
AT5G40320	5	16121756	16123541	1785	+	0
AT5G40330	5	16127724	16129655	1931	+	80
AT5G40340	5	16131653	16134916	3263	-	1064
AT5G40348	5	16136593	16141361	4768	+	0
AT5G40350	5	16138543	16141134	2591	-	0
AT5G40360	5	16145140	16146621	1481	+	0
AT5G40370	5	16147593	16149198	1605	-	2099
AT5G40380	5	16151771	16155177	3406	+	635
AT5G40382	5	16155085	16155683	598	-	1
AT5G40384	5	16157822	16157948	126	-	0
AT5G40390	5	16161514	16165357	3843	+	1077
AT5G40395	5	16166179	16166387	208	-	1
AT5G40400	5	16166437	16168841	2404	+	85
AT5G40405	5	16169314	16171153	1839	+	31
AT5G40410	5	16171373	16173226	1853	+	13
AT5G40420	5	16173392	16174783	1391	-	0
AT5G40430	5	16176426	16177731	1305	-	0
AT5G40440	5	16181681	16184627	2946	+	284
AT5G40450	5	16184649	16195651	11002	-	3155
AT5G40460	5	16202246	16202932	686	+	31
AT5G40470	5	16208008	16209897	1889	-	163
AT5G40480	5	16213221	16224058	10837	+	766
AT5G40490	5	16225375	16227709	2334	+	380
AT5G40500	5	16227833	16228693	860	+	757
AT5G40510	5	16229187	16231098	1911	+	3
AT5G40520	5	16231253	16234316	3063	-	342
AT5G40530	5	16234496	16236256	1760	+	178
AT5G40540	5	16237297	16239601	2304	+	84
AT5G40545	5	16239637	16239709	72	-	0
AT5G40550	5	16241008	16243381	2373	+	129
AT5G40560	5	16244542	16246519	1977	+	0
AT5G40570	5	16246785	16248390	1605	+	31
AT5G40580	5	16248285	16250894	2609	-	900
AT5G40590	5	16251436	16252412	976	-	0
AT5G40595	5	16253509	16254079	570	+	0
AT5G40600	5	16253468	16256829	3361	-	137
AT5G40605	5	16259228	16264465	5237	+	0
AT5G40610	5	16264860	16267354	2494	-	620
AT5G40620	5	16269262	16269655	393	+	0
AT5G40630	5	16271139	16272470	1331	-	21
AT5G40640	5	16277041	16280424	3383	+	297
AT5G40645	5	16280282	16280972	690	-	0
AT5G40650	5	16281403	16283527	2124	+	580
AT5G40660	5	16283507	16285326	1819	-	238
AT5G40670	5	16285710	16287793	2083	+	995
AT5G40680	5	16288753	16290001	1248	+	1
AT5G40690	5	16290710	16291583	873	+	47
AT5G40700	5	16291754	16293513	1759	-	67
AT5G40710	5	16295035	16297004	1969	+	179
AT5G40720	5	16297897	16300001	2104	+	71
AT5G40730	5	16301074	16301520	446	+	14
AT5G40740	5	16301913	16306413	4500	-	356
AT5G40750	5	16308355	16309819	1464	+	0
AT5G40760	5	16310747	16314774	4027	+	603
AT5G40770	5	16314849	16316719	1870	-	1013
AT5G40780	5	16323650	16327281	3631	+	121
AT5G40790	5	16330114	16331026	912	-	23
AT5G40800	5	16334809	16335628	819	-	69
AT5G40810	5	16339892	16342644	2752	+	2885
AT5G40820	5	16342744	16353898	11154	-	111
AT5G40830	5	16354379	16356289	1910	-	475
AT5G40840	5	16359429	16363814	4385	-	49
AT5G40847	5	16365724	16365841	117	-	0
AT5G40850	5	16366352	16369099	2747	+	1318
AT5G40855	5	16369113	16369350	237	-	0
AT5G40860	5	16370367	16371985	1618	+	0
AT5G40870	5	16374907	16378652	3745	+	571
AT5G40880	5	16378894	16381335	2441	+	153
AT5G40890	5	16381313	16385319	4006	-	1857
AT5G40900	5	16391835	16393375	1540	+	1
AT5G40910	5	16395506	16399129	3623	+	1084
AT5G40920	5	16400653	16404325	3672	+	336
AT5G40930	5	16404456	16406002	1546	+	525
AT5G40940	5	16406655	16407930	1275	-	0
AT5G40942	5	16408165	16409165	1000	+	57
AT5G40945	5	16410584	16410665	81	+	0
AT5G40950	5	16410781	16412063	1282	+	13070
AT5G40960	5	16412590	16413202	612	-	53
AT5G40970	5	16414037	16414504	467	+	118
AT5G40980	5	16414847	16415220	373	-	44
AT5G40981	5	16415856	16415952	96	-	0
AT5G40990	5	16418919	16420400	1481	+	0
AT5G41000	5	16420779	16423830	3051	+	162
AT5G41010	5	16424049	16424952	903	+	174
AT5G41020	5	16425882	16427797	1915	-	436
AT5G41030	5	16428705	16429437	732	+	3
AT5G41040	5	16431373	16433305	1932	+	57
AT5G41050	5	16433316	16434318	1002	-	533
AT5G41060	5	16435321	16437699	2378	+	193
AT5G41070	5	16438306	16440046	1740	+	192
AT5G41071	5	16440068	16440251	183	+	0
AT5G41080	5	16441743	16443985	2242	+	45
AT5G41090	5	16445763	16446537	774	+	1
AT5G41100	5	16447221	16450881	3660	+	177
AT5G41109	5	16452452	16452593	141	-	0
AT5G41110	5	16451469	16454989	3520	+	206
AT5G41120	5	16455187	16459237	4050	-	106
AT5G41130	5	16459583	16463272	3689	-	122
AT5G41140	5	16468433	16472810	4377	+	1435
AT5G41150	5	16472763	16477013	4250	-	355
AT5G41160	5	16477359	16478436	1077	+	17
AT5G41170	5	16478485	16480584	2099	-	23
AT5G41180	5	16483870	16487426	3556	+	212
AT5G41190	5	16487474	16490101	2627	-	536
AT5G41200	5	16490543	16491536	993	+	0
AT5G41210	5	16492319	16493994	1675	-	1512
AT5G41220	5	16494425	16497068	2643	-	282
AT5G41240	5	16498154	16500858	2704	-	243
AT5G41250	5	16501216	16502902	1686	-	0
AT5G41260	5	16503773	16507475	3702	+	552
AT5G41265	5	16507532	16507604	72	-	0
AT5G41270	5	16507708	16508879	1171	+	61
AT5G41280	5	16509508	16510929	1421	+	0
AT5G41290	5	16512325	16513500	1175	+	3
AT5G41300	5	16515003	16516102	1099	+	0
AT5G41310	5	16516633	16522392	5759	-	1
AT5G41315	5	16529454	16532879	3425	+	16
AT5G41320	5	16534441	16535989	1548	+	11
AT5G41330	5	16535338	16537903	2565	-	227
AT5G41340	5	16538080	16540130	2050	-	831
AT5G41350	5	16541461	16543972	2511	-	261
AT5G41360	5	16544339	16549280	4941	+	333
AT5G41370	5	16551118	16556003	4885	+	1109
AT5G41380	5	16561277	16563732	2455	-	2
AT5G41390	5	16565302	16567483	2181	+	0
AT5G41400	5	16569376	16570177	801	-	359
AT5G41401	5	16572024	16572189	165	-	0
AT5G41410	5	16580043	16584008	3965	+	820
AT5G41420	5	16585118	16585316	198	-	0
AT5G41430	5	16586118	16586604	486	-	0
AT5G41440	5	16587234	16587609	375	-	0
AT5G41450	5	16588599	16589094	495	-	0
AT5G41460	5	16589597	16592241	2644	-	449
AT5G41470	5	16593952	16595568	1616	+	25
AT5G41471	5	16598795	16598905	110	+	0
AT5G41480	5	16595926	16598636	2710	+	356
AT5G41490	5	16600444	16601608	1164	+	0
AT5G41491	5	16601969	16602446	477	-	0
AT5G41494	5	16602588	16603438	850	+	0
AT5G41500	5	16604001	16605213	1212	+	0
AT5G41505	5	16605490	16606228	738	-	0
AT5G41510	5	16607123	16608326	1203	+	0
AT5G41520	5	16609152	16610692	1540	-	3327
AT5G41530	5	16611659	16612088	429	+	0
AT5G41540	5	16612658	16616063	3405	-	0
AT5G41550	5	16617231	16620785	3554	-	10
AT5G41560	5	16621250	16622656	1406	-	186
AT5G41570	5	16624213	16625977	1764	+	1
AT5G41580	5	16626336	16630783	4447	-	305
AT5G41590	5	16632085	16633896	1811	-	28
AT5G41600	5	16636129	16637693	1564	+	1033
AT5G41605	5	16638165	16638249	84	+	0
AT5G41610	5	16638369	16641728	3359	-	55
AT5G41612	5	16638578	16639863	1285	+	1
AT5G41614	5	16644075	16644195	120	-	0
AT5G41620	5	16646329	16648968	2639	+	134
AT5G41630	5	16650281	16651835	1554	+	0
AT5G41640	5	16653336	16654635	1299	-	0
AT5G41650	5	16654912	16655810	898	+	15
AT5G41660	5	16656707	16658405	1698	+	0
AT5G41663	5	16660468	16660640	172	-	2
AT5G41670	5	16665282	16667171	1889	-	1121
AT5G41675	5	16667435	16667507	72	-	0
AT5G41680	5	16667884	16669489	1605	+	3
AT5G41685	5	16669148	16669723	575	-	251
AT5G41690	5	16670000	16674966	4966	-	126
AT5G41700	5	16675581	16677509	1928	+	5924
AT5G41710	5	16677826	16679816	1990	+	8
AT5G41720	5	16683164	16683942	778	-	0
AT5G41730	5	16684913	16687145	2232	-	1
AT5G41740	5	16688625	16693119	4494	+	237
AT5G41750	5	16693908	16698943	5035	+	174
AT5G41755	5	16700027	16705892	5865	+	0
AT5G41760	5	16706879	16709909	3030	+	395
AT5G41761	5	16711436	16712031	595	+	51
AT5G41765	5	16716551	16717064	513	-	0
AT5G41770	5	16717995	16721222	3227	+	892
AT5G41774	5	16722096	16722288	192	-	0
AT5G41780	5	16723074	16724833	1759	+	30
AT5G41790	5	16727529	16732847	5318	+	3878
AT5G41800	5	16733772	16735991	2219	+	152
AT5G41810	5	16738061	16739663	1602	+	267
AT5G41820	5	16740803	16743433	2630	+	13
AT5G41830	5	16743761	16745334	1573	-	0
AT5G41835	5	16748797	16753756	4959	+	9
AT5G41840	5	16754435	16756263	1828	-	0
AT5G41850	5	16756697	16758220	1523	-	115
AT5G41860	5	16757950	16758718	768	+	78
AT5G41870	5	16758708	16760576	1868	-	530
AT5G41880	5	16760907	16764276	3369	+	233
AT5G41890	5	16764210	16766680	2470	-	1
AT5G41900	5	16768952	16771696	2744	+	350
AT5G41905	5	16775523	16775658	135	-	0
AT5G41908	5	16777282	16777438	156	+	1
AT5G41910	5	16778054	16779274	1220	-	76
AT5G41920	5	16779748	16781245	1497	+	229
AT5G41940	5	16781946	16785576	3630	+	577
AT5G41950	5	16785713	16789514	3801	+	1053
AT5G41960	5	16789713	16791042	1329	+	389
AT5G41970	5	16791181	16793257	2076	+	958
AT5G41980	5	16793613	16795006	1393	+	64
AT5G41990	5	16794966	16798006	3040	-	0
AT5G41992	5	16794966	16798006	3040	-	0
AT5G42000	5	16799353	16801028	1675	+	296
AT5G42010	5	16802279	16805013	2734	+	31
AT5G42020	5	16807482	16810646	3164	-	1856
AT5G42030	5	16811383	16813183	1800	-	2001
AT5G42040	5	16813834	16814749	915	-	21
AT5G42050	5	16815488	16817301	1813	+	1642
AT5G42053	5	16817707	16817872	165	+	0
AT5G42060	5	16818387	16818955	568	-	120
AT5G42070	5	16818983	16820195	1212	-	1548
AT5G42080	5	16820283	16824757	4474	-	3393
AT5G42090	5	16826697	16828454	1757	+	1013
AT5G42092	5	16826837	16827583	746	-	0
AT5G42100	5	16829150	16831239	2089	-	2141
AT5G42110	5	16831727	16832279	552	-	215
AT5G42120	5	16833072	16835148	2076	-	4
AT5G42130	5	16835298	16836839	1541	-	911
AT5G42140	5	16837339	16841640	4301	-	334
AT5G42146	5	16844344	16844969	625	+	128
AT5G42150	5	16846149	16848279	2130	+	287
AT5G42170	5	16848785	16851707	2922	+	0
AT5G42180	5	16852629	16854224	1595	+	3
AT5G42190	5	16854190	16855645	1455	-	1230
AT5G42200	5	16860466	16861232	766	+	44
AT5G42203	5	16863119	16863215	96	+	0
AT5G42210	5	16866039	16870887	4848	+	89
AT5G42220	5	16872341	16877666	5325	+	1276
AT5G42223	5	16878609	16878945	336	-	0
AT5G42230	5	16880953	16884064	3111	+	6
AT5G42232	5	16884961	16885309	348	+	0
AT5G42235	5	16886915	16887570	655	+	0
AT5G42240	5	16888225	16891192	2967	+	916
AT5G42242	5	16891187	16891909	722	-	0
AT5G42250	5	16894008	16897620	3612	+	485
AT5G42260	5	16898711	16900235	1524	+	0
AT5G42265	5	16901585	16901845	260	-	0
AT5G42270	5	16902485	16905294	2809	+	24781
AT5G42280	5	16905201	16908007	2806	-	58
AT5G42290	5	16911636	16912161	525	+	0
AT5G42300	5	16912332	16913930	1598	-	2282
AT5G42310	5	16915782	16918569	2787	+	2002
AT5G42320	5	16918488	16921245	2757	-	447
AT5G42323	5	16923170	16923748	578	-	0
AT5G42325	5	16924101	16924851	750	-	0
AT5G42330	5	16926607	16927503	896	+	64
AT5G42340	5	16927909	16930472	2563	-	0
AT5G42350	5	16931533	16934003	2470	+	79
AT5G42360	5	16936132	16938486	2354	-	129
AT5G42370	5	16938980	16941734	2754	-	115
AT5G42380	5	16942575	16943366	791	-	6
AT5G42390	5	16945250	16953100	7850	+	8369
AT5G42400	5	16954468	16960671	6203	-	569
AT5G42405	5	16962850	16962976	126	+	0
AT5G42410	5	16964763	16965099	336	+	0
AT5G42420	5	16968657	16970432	1775	+	238
AT5G42430	5	16971311	16972499	1188	-	0
AT5G42440	5	16973303	16974574	1271	-	66
AT5G42445	5	16976271	16976613	342	+	2
AT5G42450	5	16977296	16979016	1720	+	17
AT5G42460	5	16979772	16981115	1343	+	50
AT5G42470	5	16982304	16984884	2580	+	472
AT5G42480	5	16985181	16988440	3259	+	1145
AT5G42490	5	16988608	16992622	4014	-	15
AT5G42500	5	16994239	16994930	691	-	5
AT5G42504	5	16996899	16997127	228	+	0
AT5G42505	5	16997167	16997754	587	+	0
AT5G42510	5	16998267	16998816	549	-	0
AT5G42520	5	17000258	17002607	2349	+	671
AT5G42530	5	17004737	17005393	656	-	13826
AT5G42540	5	17007388	17014801	7413	+	1170
AT5G42560	5	17014922	17017252	2330	+	525
AT5G42565	5	17020006	17020354	348	-	0
AT5G42567	5	17018058	17018406	348	-	0
AT5G42568	5	17020873	17021056	183	+	0
AT5G42570	5	17021309	17022583	1274	-	300
AT5G42580	5	17023645	17025229	1584	-	0
AT5G42590	5	17031110	17033726	2616	-	0
AT5G42591	5	17036672	17036780	108	+	0
AT5G42600	5	17053516	17058245	4729	+	0
AT5G42610	5	17062479	17064047	1568	+	46
AT5G42620	5	17066277	17071963	5686	+	1141
AT5G42630	5	17073778	17075856	2078	-	13
AT5G42635	5	17076226	17076725	499	+	0
AT5G42640	5	17088694	17089597	903	+	0
AT5G42645	5	17090937	17095801	4864	-	0
AT5G42650	5	17097594	17099395	1801	-	4418
AT5G42655	5	17102212	17102602	390	-	0
AT5G42660	5	17102923	17105966	3043	-	325
AT5G42670	5	17108261	17110761	2500	+	272
AT5G42677	5	17113636	17113905	269	+	0
AT5G42680	5	17114097	17115417	1320	+	114
AT5G42690	5	17116427	17119838	3411	-	34
AT5G42700	5	17122170	17124353	2183	+	38
AT5G42710	5	17125577	17128847	3270	+	26
AT5G42720	5	17130185	17132843	2658	+	921
AT5G42730	5	17133084	17134215	1131	+	73
AT5G42740	5	17135691	17140892	5201	+	2566
AT5G42750	5	17142819	17144160	1341	-	214
AT5G42760	5	17148807	17150451	1644	+	449
AT5G42765	5	17150237	17151681	1444	-	1033
AT5G42770	5	17151987	17154522	2535	+	240
AT5G42780	5	17154775	17155757	982	+	66
AT5G42785	5	17156907	17157779	872	-	0
AT5G42790	5	17159043	17161070	2027	-	1509
AT5G42797	5	17163195	17163574	379	+	0
AT5G42800	5	17164140	17165918	1778	-	782
AT5G42810	5	17166817	17169459	2642	+	550
AT5G42820	5	17169282	17171704	2422	-	736
AT5G42825	5	17171963	17172742	779	+	353
AT5G42830	5	17176383	17178018	1635	+	46
AT5G42840	5	17179117	17181276	2159	+	8
AT5G42850	5	17181706	17182623	917	-	881
AT5G42860	5	17183065	17184916	1851	-	103
AT5G42870	5	17185462	17189943	4481	-	651
AT5G42880	5	17191576	17194131	2555	+	99
AT5G42890	5	17194196	17196032	1836	-	633
AT5G42895	5	17196794	17197163	369	+	0
AT5G42900	5	17197640	17199793	2153	-	3
AT5G42905	5	17201413	17202323	910	-	0
AT5G42910	5	17203741	17205380	1639	+	0
AT5G42920	5	17206150	17209545	3395	-	594
AT5G42930	5	17210545	17214220	3675	-	2
AT5G42940	5	17216329	17220490	4161	-	614
AT5G42950	5	17224435	17231355	6920	+	1861
AT5G42955	5	17231841	17232324	483	-	0
AT5G42957	5	17233598	17234132	534	-	0
AT5G42960	5	17235091	17236679	1588	+	466
AT5G42965	5	17236735	17237125	390	+	1
AT5G42970	5	17237164	17240733	3569	-	504
AT5G42980	5	17242606	17243912	1306	+	20754
AT5G42990	5	17243986	17245988	2002	-	465
AT5G43000	5	17246353	17247202	849	-	0
AT5G43010	5	17248289	17251134	2845	-	855
AT5G43015	5	17251761	17254245	2484	-	0
AT5G43020	5	17255290	17257742	2452	-	400
AT5G43030	5	17258990	17260685	1695	-	1
AT5G43035	5	17261343	17261756	413	-	0
AT5G43040	5	17263964	17265620	1656	-	15
AT5G43050	5	17268024	17269024	1000	+	377
AT5G43060	5	17269506	17272164	2658	-	378
AT5G43065	5	17278181	17282396	4215	+	0
AT5G43066	5	17284582	17284807	225	+	0
AT5G43070	5	17289099	17289776	677	-	212
AT5G43080	5	17293226	17294789	1563	+	130
AT5G43090	5	17295932	17298171	2239	+	3
AT5G43100	5	17299122	17303058	3936	+	694
AT5G43105	5	17304710	17308952	4242	+	0
AT5G43110	5	17309841	17311937	2096	+	0
AT5G43120	5	17312601	17314368	1767	+	20
AT5G43130	5	17315448	17321185	5737	-	936
AT5G43140	5	17321544	17323408	1864	+	239
AT5G43150	5	17325012	17325923	911	+	1580
AT5G43160	5	17329274	17331352	2078	+	88
AT5G43170	5	17330944	17331646	702	-	29
AT5G43175	5	17334120	17335234	1114	+	0
AT5G43180	5	17336329	17337872	1543	-	47
AT5G43185	5	17338461	17338861	400	-	0
AT5G43190	5	17340137	17341569	1432	-	166
AT5G43196	5	17344552	17344885	333	+	0
AT5G43200	5	17346140	17346764	624	-	1
AT5G43210	5	17347566	17348641	1075	+	94
AT5G43211	5	17348721	17348886	165	-	0
AT5G43230	5	17348875	17352747	3872	+	0
AT5G43240	5	17352985	17355122	2137	-	11
AT5G43245	5	17355685	17355823	138	-	0
AT5G43250	5	17356173	17356566	393	-	48
AT5G43260	5	17357376	17358082	706	-	614
AT5G43270	5	17360286	17363773	3487	-	772
AT5G43280	5	17367887	17369399	1512	+	407
AT5G43285	5	17370474	17370857	383	-	0
AT5G43290	5	17371837	17373201	1364	-	2
AT5G43300	5	17376733	17379277	2544	-	4
AT5G43310	5	17379485	17385535	6050	-	1089
AT5G43320	5	17385866	17389527	3661	-	2092
AT5G43330	5	17390432	17392645	2213	+	728
AT5G43340	5	17393597	17395148	1551	-	0
AT5G43350	5	17399788	17401949	2161	-	0
AT5G43360	5	17409523	17411214	1691	+	0
AT5G43370	5	17415771	17417798	2027	+	0
AT5G43380	5	17419818	17421982	2164	-	62
AT5G43390	5	17422798	17424964	2166	-	0
AT5G43400	5	17425943	17428223	2280	-	207
AT5G43401	5	17428581	17429097	516	-	0
AT5G43403	5	17430538	17431765	1227	-	98
AT5G43405	5	17432644	17433009	365	+	0
AT5G43410	5	17435009	17435405	396	-	0
AT5G43415	5	17440087	17445889	5802	+	0
AT5G43420	5	17451668	17453124	1456	+	26
AT5G43430	5	17453597	17455297	1700	+	454
AT5G43440	5	17455232	17456657	1425	-	711
AT5G43450	5	17457124	17458797	1673	-	343
AT5G43455	5	17459174	17459247	73	-	0
AT5G43460	5	17459872	17461751	1879	+	1016
AT5G43470	5	17462546	17467448	4902	-	1982
AT5G43480	5	17467397	17467643	246	-	1
AT5G43490	5	17468470	17469312	842	-	1
AT5G43500	5	17469674	17473591	3917	+	380
AT5G43510	5	17474110	17474478	368	+	0
AT5G43513	5	17477998	17478390	392	+	0
AT5G43516	5	17482274	17482644	370	+	0
AT5G43518	5	17484365	17484852	487	+	0
AT5G43520	5	17485438	17486191	753	-	0
AT5G43525	5	17488148	17488516	368	+	0
AT5G43530	5	17489326	17494830	5504	+	22
AT5G43535	5	17495540	17495611	71	-	0
AT5G43540	5	17496992	17497406	414	+	0
AT5G43550	5	17497891	17498263	372	+	0
AT5G43560	5	17500409	17505646	5237	+	1206
AT5G43570	5	17506400	17507600	1200	+	0
AT5G43580	5	17507882	17508668	786	-	18
AT5G43590	5	17509367	17511477	2110	-	0
AT5G43600	5	17512475	17515495	3020	+	951
AT5G43603	5	17516307	17516398	91	+	0
AT5G43610	5	17519078	17521008	1930	+	0
AT5G43620	5	17522519	17524001	1482	+	36
AT5G43630	5	17526750	17530516	3766	+	1935
AT5G43640	5	17531301	17532370	1069	+	0
AT5G43650	5	17533192	17534796	1604	-	0
AT5G43660	5	17536336	17538595	2259	-	8
AT5G43670	5	17538760	17541934	3174	-	288
AT5G43680	5	17544028	17545752	1724	+	247
AT5G43690	5	17546172	17547434	1262	+	5
AT5G43695	5	17548248	17548551	303	+	0
AT5G43700	5	17550232	17551581	1349	+	923
AT5G43710	5	17552129	17556670	4541	-	506
AT5G43720	5	17557165	17559354	2189	-	396
AT5G43725	5	17559540	17564223	4683	+	46
AT5G43730	5	17560178	17562929	2751	+	117
AT5G43740	5	17564737	17568802	4065	+	497
AT5G43745	5	17569146	17574971	5825	-	1127
AT5G43750	5	17579965	17581222	1257	-	4833
AT5G43755	5	17582976	17583772	796	-	0
AT5G43760	5	17585762	17588597	2835	+	2058
AT5G43770	5	17588789	17589467	678	+	0
AT5G43780	5	17589393	17591535	2142	-	1217
AT5G43790	5	17592006	17593481	1475	-	119
AT5G43800	5	17597378	17605019	7641	+	0
AT5G43810	5	17610971	17616797	5826	+	1093
AT5G43820	5	17618947	17620588	1641	+	66
AT5G43822	5	17618804	17621979	3175	+	100
AT5G43830	5	17622335	17624329	1994	-	2714
AT5G43840	5	17625436	17626364	928	-	7
AT5G43850	5	17627181	17629159	1978	-	3587
AT5G43860	5	17630449	17632312	1863	+	89
AT5G43870	5	17632345	17635912	3567	-	721
AT5G43880	5	17639817	17643648	3831	-	838
AT5G43890	5	17648856	17650131	1275	-	3
AT5G43900	5	17656893	17667451	10558	-	1705
AT5G43910	5	17667309	17670239	2930	-	94
AT5G43920	5	17672668	17675845	3177	+	591
AT5G43930	5	17676815	17681100	4285	+	427
AT5G43935	5	17682178	17683446	1268	+	0
AT5G43940	5	17684155	17686534	2379	+	5011
AT5G43950	5	17686499	17688668	2169	-	207
AT5G43960	5	17688787	17691939	3152	-	1003
AT5G43970	5	17692806	17693403	597	+	646
AT5G43980	5	17694679	17696622	1943	-	54
AT5G43990	5	17697685	17702005	4320	+	327
AT5G44000	5	17702089	17703963	1874	-	750
AT5G44005	5	17704902	17705558	656	-	76
AT5G44010	5	17706964	17709199	2235	-	49
AT5G44020	5	17712408	17714336	1928	+	2874
AT5G44030	5	17714644	17719723	5079	+	411
AT5G44040	5	17719658	17721580	1922	-	231
AT5G44050	5	17722483	17726379	3896	+	377
AT5G44060	5	17731004	17731905	901	+	198
AT5G44065	5	17733484	17733712	228	+	2
AT5G44070	5	17734737	17737859	3122	+	1119
AT5G44080	5	17738651	17739873	1222	-	313
AT5G44090	5	17742765	17748396	5631	-	968
AT5G44100	5	17749117	17752716	3599	-	1231
AT5G44110	5	17754063	17755742	1679	-	212
AT5G44120	5	17756263	17758288	2025	-	2
AT5G44130	5	17761089	17762003	914	+	900
AT5G44140	5	17762490	17763629	1139	+	3
AT5G44150	5	17763680	17765420	1740	-	158
AT5G44160	5	17772940	17775686	2746	+	56
AT5G44170	5	17780377	17781283	906	+	153
AT5G44180	5	17783171	17790011	6840	+	1300
AT5G44190	5	17798368	17800824	2456	+	4824
AT5G44200	5	17801813	17804130	2317	-	600
AT5G44210	5	17806471	17807534	1063	+	18
AT5G44220	5	17810476	17811364	888	+	0
AT5G44230	5	17814335	17816309	1974	+	55
AT5G44240	5	17817027	17823708	6681	+	1049
AT5G44250	5	17823744	17825762	2018	-	456
AT5G44255	5	17827732	17828292	560	+	0
AT5G44260	5	17829625	17831225	1600	-	20
AT5G44265	5	17832778	17833316	538	-	1
AT5G44270	5	17833635	17835740	2105	+	4
AT5G44280	5	17835848	17839254	3406	-	134
AT5G44283	5	17839584	17839656	72	-	0
AT5G44286	5	17840219	17840304	85	+	1
AT5G44290	5	17840423	17843751	3328	-	1292
AT5G44300	5	17845165	17846197	1032	-	0
AT5G44306	5	17847198	17847372	174	-	0
AT5G44310	5	17847780	17849536	1756	-	0
AT5G44313	5	17851013	17851727	714	+	0
AT5G44316	5	17852910	17854521	1611	+	0
AT5G44320	5	17854588	17856680	2092	-	917
AT5G44330	5	17857324	17859056	1732	+	0
AT5G44340	5	17859194	17861101	1907	-	3947
AT5G44345	5	17862112	17863079	967	+	0
AT5G44350	5	17864519	17865707	1188	+	4
AT5G44360	5	17871923	17873698	1775	-	0
AT5G44370	5	17874884	17877564	2680	-	214
AT5G44375	5	17877679	17877752	73	-	0
AT5G44380	5	17878721	17881440	2719	-	14
AT5G44390	5	17882195	17885004	2809	-	29
AT5G44400	5	17886193	17888480	2287	-	749
AT5G44410	5	17891221	17892978	1757	-	425
AT5G44415	5	17893945	17896375	2430	+	0
AT5G44416	5	17896963	17900821	3858	-	0
AT5G44417	5	17901831	17903346	1515	-	0
AT5G44418	5	17905909	17906434	525	-	0
AT5G44420	5	17907068	17907598	530	-	9
AT5G44430	5	17908944	17909507	563	-	0
AT5G44440	5	17910556	17912312	1756	-	0
AT5G44450	5	17914022	17916019	1997	-	462
AT5G44460	5	17917225	17917983	758	+	0
AT5G44470	5	17918738	17919164	426	+	0
AT5G44480	5	17921514	17923643	2129	+	13
AT5G44490	5	17924034	17925843	1809	+	139
AT5G44495	5	17926350	17926710	360	-	0
AT5G44500	5	17927442	17929463	2021	+	119
AT5G44510	5	17929672	17934188	4516	-	1039
AT5G44520	5	17934286	17936527	2241	-	1384
AT5G44530	5	17937688	17941292	3604	+	1366
AT5G44540	5	17941286	17941646	360	-	1
AT5G44550	5	17941874	17943213	1339	-	60
AT5G44555	5	17944808	17945167	359	+	0
AT5G44560	5	17945956	17948400	2444	+	146
AT5G44562	5	17947616	17948398	782	-	4
AT5G44565	5	17951511	17953133	1622	+	49
AT5G44568	5	17961200	17962202	1002	-	96
AT5G44569	5	17963285	17963990	705	+	26
AT5G44570	5	17964415	17966496	2081	+	4
AT5G44572	5	17968151	17969563	1412	+	39
AT5G44574	5	17970692	17971449	757	+	8
AT5G44575	5	17973837	17974998	1161	+	9
AT5G44578	5	17977176	17978638	1462	+	13
AT5G44580	5	17979310	17980411	1101	+	633
AT5G44582	5	17980861	17981807	946	+	27
AT5G44585	5	17984615	17985473	858	+	2
AT5G44590	5	17987590	17989227	1637	+	1
AT5G44600	5	17989860	17991672	1812	+	415
AT5G44610	5	17993564	17994676	1112	-	0
AT5G44620	5	17997778	17999558	1780	-	8
AT5G44630	5	18003254	18005616	2362	+	0
AT5G44635	5	18006430	18010542	4112	-	404
AT5G44640	5	18011145	18012882	1737	+	0
AT5G44650	5	18013148	18015403	2255	+	3038
AT5G44660	5	18015770	18017177	1407	+	490
AT5G44670	5	18018904	18021385	2481	-	538
AT5G44680	5	18024214	18025991	1777	-	2101
AT5G44690	5	18029337	18032293	2956	-	0
AT5G44700	5	18032863	18036894	4031	-	1
AT5G44705	5	18040787	18040861	74	+	0
AT5G44710	5	18040909	18042560	1651	+	155
AT5G44720	5	18042970	18045496	2526	+	1505
AT5G44730	5	18045495	18046931	1436	-	234
AT5G44740	5	18047783	18051879	4096	-	162
AT5G44750	5	18052607	18060169	7562	+	1049
AT5G44760	5	18060585	18062764	2179	+	0
AT5G44770	5	18065054	18066680	1626	+	1
AT5G44780	5	18068059	18070654	2595	+	130
AT5G44785	5	18070680	18073129	2449	-	704
AT5G44790	5	18075609	18079988	4379	-	1226
AT5G44800	5	18083418	18093452	10034	-	1587
AT5G44820	5	18095712	18097585	1873	-	82
AT5G44830	5	18100127	18101885	1758	-	0
AT5G44840	5	18104850	18107127	2277	-	0
AT5G44850	5	18108303	18109593	1290	+	0
AT5G44860	5	18110457	18111812	1355	-	411
AT5G44870	5	18114665	18118608	3943	+	806
AT5G44875	5	18121330	18124682	3352	+	0
AT5G44880	5	18125667	18126153	486	+	0
AT5G44890	5	18126683	18131125	4442	-	0
AT5G44894	5	18133144	18133297	153	+	0
AT5G44900	5	18135445	18136438	993	+	0
AT5G44910	5	18137353	18138235	882	+	16
AT5G44920	5	18138774	18140190	1416	+	8
AT5G44925	5	18142273	18146632	4359	-	0
AT5G44930	5	18138774	18142147	3373	-	304
AT5G44940	5	18149368	18150892	1524	+	0
AT5G44950	5	18151664	18153164	1500	+	0
AT5G44960	5	18153851	18155391	1540	+	0
AT5G44970	5	18155836	18157340	1504	+	0
AT5G44973	5	18157641	18158207	566	-	1
AT5G44980	5	18160289	18162264	1975	+	32
AT5G44990	5	18163131	18164768	1637	+	0
AT5G45000	5	18165382	18167193	1811	+	3
AT5G45010	5	18167243	18168374	1131	-	614
AT5G45020	5	18168681	18170775	2094	+	214
AT5G45030	5	18172409	18176207	3798	+	475
AT5G45040	5	18175370	18176888	1518	-	99
AT5G45050	5	18176913	18181805	4892	-	672
AT5G45060	5	18182037	18186495	4458	+	693
AT5G45070	5	18187629	18189431	1802	-	4
AT5G45080	5	18191574	18193207	1633	-	55
AT5G45082	5	18194298	18196851	2553	-	0
AT5G45085	5	18197689	18201523	3834	-	0
AT5G45090	5	18202752	18205000	2248	-	1
AT5G45095	5	18207362	18209045	1683	+	8
AT5G45100	5	18218585	18219960	1375	+	440
AT5G45105	5	18223452	18224946	1494	-	0
AT5G45110	5	18228909	18231522	2613	+	361
AT5G45113	5	18232276	18233521	1245	-	0
AT5G45116	5	18233905	18237928	4023	+	0
AT5G45120	5	18241002	18242478	1476	+	0
AT5G45130	5	18244265	18246450	2185	+	957
AT5G45140	5	18247227	18258138	10911	-	367
AT5G45150	5	18260440	18264346	3906	+	21
AT5G45160	5	18264716	18270283	5567	+	499
AT5G45170	5	18270343	18273187	2844	-	2173
AT5G45180	5	18274178	18276586	2408	-	0
AT5G45190	5	18277619	18281875	4256	-	714
AT5G45200	5	18283966	18290332	6366	-	1
AT5G45210	5	18295520	18298434	2914	+	0
AT5G45220	5	18298925	18301069	2144	-	4
AT5G45230	5	18302146	18308303	6157	-	0
AT5G45240	5	18313705	18319089	5384	+	9
AT5G45250	5	18321913	18326022	4109	-	394
AT5G45260	5	18326202	18332609	6407	+	412
AT5G45275	5	18334404	18337380	2976	-	292
AT5G45276	5	18338753	18340436	1683	-	15
AT5G45280	5	18345594	18349695	4101	+	635
AT5G45290	5	18349781	18352498	2717	-	400
AT5G45300	5	18353607	18356875	3268	+	530
AT5G45307	5	18358804	18358893	89	-	0
AT5G45310	5	18359274	18361114	1840	-	62
AT5G45320	5	18362110	18363168	1058	-	20
AT5G45330	5	18363405	18366672	3267	-	161
AT5G45340	5	18368641	18370991	2350	-	59
AT5G45350	5	18381836	18383699	1863	-	3249
AT5G45360	5	18384520	18386785	2265	-	627
AT5G45370	5	18388290	18390420	2130	+	120
AT5G45380	5	18391123	18395894	4771	+	251
AT5G45390	5	18396301	18398116	1815	+	7536
AT5G45400	5	18398989	18401644	2655	+	94
AT5G45410	5	18401907	18403800	1893	-	1898
AT5G45420	5	18404068	18406606	2538	-	672
AT5G45428	5	18407387	18411967	4580	+	0
AT5G45430	5	18407335	18411977	4642	+	0
AT5G45440	5	18412307	18413555	1248	-	11
AT5G45450	5	18415160	18415811	651	+	2
AT5G45460	5	18416613	18419481	2868	-	102
AT5G45469	5	18421743	18421962	219	+	17
AT5G45470	5	18421984	18425042	3058	-	147
AT5G45472	5	18422367	18425035	2668	+	0
AT5G45475	5	18425836	18427016	1180	+	10
AT5G45480	5	18426103	18429090	2987	-	487
AT5G45490	5	18429046	18432397	3351	+	831
AT5G45500	5	18432457	18435469	3012	-	893
AT5G45510	5	18444656	18449446	4790	+	2063
AT5G45520	5	18449508	18453012	3504	-	161
AT5G45530	5	18454315	18457277	2962	-	81
AT5G45540	5	18458153	18460821	2668	-	63
AT5G45550	5	18462161	18465097	2936	+	745
AT5G45560	5	18465354	18470926	5572	+	268
AT5G45570	5	18472300	18475574	3274	+	0
AT5G45573	5	18475757	18476576	819	-	0
AT5G45576	5	18476995	18479429	2434	-	0
AT5G45580	5	18481091	18482643	1552	-	6
AT5G45590	5	18484449	18486284	1835	-	228
AT5G45595	5	18486674	18487339	665	-	0
AT5G45600	5	18487901	18489869	1968	+	344
AT5G45605	5	18490915	18495757	4842	-	0
AT5G45610	5	18496310	18499673	3363	-	350
AT5G45620	5	18501485	18504117	2632	+	878
AT5G45630	5	18505808	18506323	515	-	7
AT5G45640	5	18507488	18511616	4128	-	12
AT5G45650	5	18513430	18518868	5438	-	1375
AT5G45660	5	18525070	18527007	1937	+	56
AT5G45670	5	18528493	18530450	1957	+	1105
AT5G45680	5	18530879	18532337	1458	+	2917
AT5G45690	5	18534998	18536316	1318	-	0
AT5G45700	5	18537348	18538196	848	+	115
AT5G45710	5	18540849	18542863	2014	+	241
AT5G45715	5	18542979	18543051	72	-	0
AT5G45720	5	18542972	18547205	4233	-	60
AT5G45730	5	18551946	18553658	1712	+	26
AT5G45740	5	18556974	18558097	1123	-	9
AT5G45745	5	18558844	18558916	72	+	0
AT5G45750	5	18559115	18560842	1727	+	309
AT5G45760	5	18561110	18563195	2085	+	265
AT5G45770	5	18563567	18564921	1354	+	40
AT5G45775	5	18565061	18566569	1508	-	1981
AT5G45780	5	18566811	18569625	2814	-	162
AT5G45790	5	18572300	18573664	1364	+	46
AT5G45800	5	18575535	18579107	3572	-	1018
AT5G45810	5	18584941	18586393	1452	+	2
AT5G45820	5	18586979	18588543	1564	-	1849
AT5G45830	5	18589481	18591400	1919	-	32
AT5G45840	5	18593916	18597995	4079	-	205
AT5G45850	5	18599758	18601570	1812	-	73
AT5G45860	5	18604100	18604586	486	-	5
AT5G45870	5	18606563	18607043	480	-	0
AT5G45875	5	18608456	18608911	455	-	0
AT5G45880	5	18609663	18611166	1503	-	0
AT5G45890	5	18613258	18614930	1672	+	0
AT5G45900	5	18615221	18618560	3339	+	314
AT5G45905	5	18619460	18619870	410	+	0
AT5G45910	5	18620298	18622301	2003	-	0
AT5G45920	5	18622758	18624785	2027	+	72
AT5G45930	5	18628006	18629697	1691	+	2413
AT5G45940	5	18629561	18630706	1145	-	261
AT5G45950	5	18634078	18636699	2621	+	2241
AT5G45960	5	18637022	18640361	3339	-	91
AT5G45970	5	18643733	18645966	2233	+	19
AT5G45973	5	18646927	18647038	111	-	0
AT5G45980	5	18648908	18650836	1928	+	0
AT5G45990	5	18651323	18653892	2569	+	15
AT5G46000	5	18654318	18656376	2058	-	0
AT5G46010	5	18660583	18661183	600	+	0
AT5G46013	5	18661759	18661909	150	-	0
AT5G46020	5	18662845	18664874	2029	-	2555
AT5G46025	5	18665254	18665596	342	-	0
AT5G46030	5	18670116	18671373	1257	+	884
AT5G46040	5	18671396	18673551	2155	-	1
AT5G46050	5	18675034	18679146	4112	-	21
AT5G46060	5	18681325	18682630	1305	+	0
AT5G46070	5	18683363	18688707	5344	+	1053
AT5G46080	5	18689541	18690857	1316	-	42
AT5G46090	5	18693484	18694129	645	+	32
AT5G46100	5	18694315	18695734	1419	-	45
AT5G46105	5	18698661	18698733	72	-	3
AT5G46110	5	18697234	18700656	3422	+	59781
AT5G46115	5	18701319	18701740	421	+	9
AT5G46120	5	18702623	18702875	252	-	0
AT5G46130	5	18702913	18704484	1571	-	9
AT5G46140	5	18704996	18706708	1712	-	49
AT5G46150	5	18707645	18710593	2948	-	424
AT5G46160	5	18711159	18712532	1373	-	394
AT5G46170	5	18714964	18716953	1989	-	534
AT5G46180	5	18718474	18721375	2901	-	672
AT5G46190	5	18723115	18726200	3085	-	857
AT5G46195	5	18726803	18727439	636	+	0
AT5G46200	5	18727801	18730331	2530	-	0
AT5G46210	5	18731417	18736810	5393	-	1973
AT5G46220	5	18738748	18742011	3263	+	194
AT5G46230	5	18742439	18743045	606	-	70
AT5G46240	5	18743565	18746730	3165	-	754
AT5G46250	5	18755310	18758281	2971	+	1491
AT5G46260	5	18759101	18763358	4257	-	129
AT5G46270	5	18764348	18769090	4742	-	645
AT5G46280	5	18769696	18773658	3962	-	665
AT5G46290	5	18774085	18776742	2657	-	3657
AT5G46295	5	18779795	18780205	410	-	1
AT5G46300	5	18783609	18784786	1177	+	0
AT5G46310	5	18785671	18786956	1285	+	0
AT5G46315	5	18787078	18787990	912	+	0
AT5G46320	5	18788245	18788888	643	-	0
AT5G46325	5	18790307	18790387	80	+	0
AT5G46330	5	18791735	18795546	3811	+	40
AT5G46340	5	18795925	18800094	4169	-	537
AT5G46350	5	18801217	18804043	2826	-	27
AT5G46360	5	18806562	18808224	1662	-	0
AT5G46370	5	18809575	18811772	2197	-	0
AT5G46380	5	18813087	18815974	2887	-	2
AT5G46390	5	18816584	18819348	2764	+	845
AT5G46400	5	18820031	18824650	4619	+	378
AT5G46410	5	18825102	18829221	4119	+	649
AT5G46417	5	18829780	18829888	108	-	1
AT5G46420	5	18829954	18832953	2999	+	3749
AT5G46430	5	18833266	18834564	1298	+	2757
AT5G46440	5	18834642	18835153	511	+	22
AT5G46450	5	18835617	18839546	3929	+	603
AT5G46460	5	18840304	18842398	2094	+	25
AT5G46470	5	18842700	18849741	7041	+	2398
AT5G46490	5	18850775	18853843	3068	+	376
AT5G46500	5	18856453	18857787	1334	+	31
AT5G46510	5	18860450	18867013	6563	+	351
AT5G46520	5	18867766	18872415	4649	+	32
AT5G46530	5	18875524	18876898	1374	+	100
AT5G46540	5	18877191	18882347	5156	-	3
AT5G46550	5	18884308	18886939	2631	-	426
AT5G46560	5	18888060	18890462	2402	+	380
AT5G46570	5	18894401	18897406	3005	+	581
AT5G46580	5	18897444	18899645	2201	-	2058
AT5G46590	5	18905324	18906848	1524	+	30
AT5G46595	5	18907522	18907594	72	+	0
AT5G46600	5	18907670	18910838	3168	-	37
AT5G46610	5	18912666	18915779	3113	-	0
AT5G46620	5	18917612	18919420	1808	-	217
AT5G46630	5	18920437	18923550	3113	+	1449
AT5G46640	5	18924476	18926575	2099	+	74
AT5G46645	5	18927456	18929493	2037	-	0
AT5G46650	5	18930442	18931312	870	+	1
AT5G46660	5	18932180	18933098	918	+	3
AT5G46665	5	18935311	18938345	3034	-	4
AT5G46670	5	18939040	18940039	999	+	5
AT5G46680	5	18940968	18942602	1634	+	21
AT5G46690	5	18945614	18947637	2023	+	510
AT5G46700	5	18950916	18952629	1713	+	366
AT5G46710	5	18952615	18954692	2077	-	60
AT5G46720	5	18959168	18959749	581	+	27
AT5G46730	5	18964011	18965068	1057	+	514
AT5G46740	5	18965270	18968742	3472	-	286
AT5G46750	5	18969748	18971932	2184	-	981
AT5G46760	5	18974230	18976009	1779	+	1090
AT5G46770	5	18977407	18978160	753	+	1
AT5G46780	5	18978976	18980057	1081	+	303
AT5G46790	5	18983869	18984759	890	-	600
AT5G46795	5	18986987	18988197	1210	-	0
AT5G46800	5	18988630	18990772	2142	-	5082
AT5G46810	5	18991163	18993376	2213	+	0
AT5G46820	5	18993632	18996672	3040	+	0
AT5G46830	5	19002718	19004254	1536	+	69
AT5G46840	5	19005600	19007770	2170	+	481
AT5G46845	5	19009097	19009178	81	-	1
AT5G46850	5	19010607	19012038	1431	+	128
AT5G46860	5	19012020	19014004	1984	-	494
AT5G46870	5	19015232	19017063	1831	+	111
AT5G46871	5	19018100	19018443	343	+	3
AT5G46873	5	19021204	19021529	325	+	0
AT5G46874	5	19022382	19022699	317	+	0
AT5G46875	5	19024402	19024970	568	+	0
AT5G46877	5	19025894	19026269	375	+	0
AT5G46880	5	19031349	19035731	4382	+	234
AT5G46890	5	19036295	19036916	621	-	0
AT5G46900	5	19039700	19040402	702	-	0
AT5G46910	5	19046857	19050880	4023	+	180
AT5G46915	5	19051567	19053200	1633	-	5
AT5G46920	5	19053627	19056007	2380	+	164
AT5G46930	5	19056654	19057191	537	-	0
AT5G46940	5	19058167	19058814	647	-	0
AT5G46950	5	19059518	19060121	603	-	0
AT5G46960	5	19062173	19062780	607	-	1
AT5G46970	5	19063917	19064412	495	-	0
AT5G46980	5	19065452	19066007	555	-	0
AT5G46990	5	19067691	19068255	564	-	0
AT5G47000	5	19068943	19070333	1390	-	0
AT5G47010	5	19072008	19079334	7326	+	2500
AT5G47020	5	19081457	19090023	8566	+	1626
AT5G47030	5	19090297	19092314	2017	+	4470
AT5G47040	5	19093151	19098715	5564	-	5886
AT5G47050	5	19106339	19108348	2009	+	485
AT5G47060	5	19116787	19118046	1259	+	223
AT5G47070	5	19118542	19120909	2367	-	203
AT5G47075	5	19122502	19122826	324	-	0
AT5G47077	5	19123505	19123779	274	-	0
AT5G47080	5	19124611	19126653	2042	-	396
AT5G47090	5	19127258	19128769	1511	+	230
AT5G47100	5	19129639	19132283	2644	-	231
AT5G47110	5	19133985	19135317	1332	-	7897
AT5G47120	5	19136022	19137942	1920	+	1285
AT5G47130	5	19141015	19142011	996	+	11
AT5G47140	5	19144634	19147489	2855	+	319
AT5G47150	5	19150044	19151793	1749	+	1
AT5G47160	5	19156730	19157978	1248	+	40
AT5G47170	5	19158507	19158960	453	-	4
AT5G47175	5	19160065	19160412	347	-	1
AT5G47180	5	19161141	19163797	2656	-	238
AT5G47190	5	19164245	19166107	1862	-	5825
AT5G47200	5	19166901	19169026	2125	+	1381
AT5G47210	5	19169021	19171263	2242	-	7380
AT5G47220	5	19171861	19172823	962	-	16
AT5G47225	5	19174588	19175831	1243	+	0
AT5G47229	5	19179693	19179849	156	-	0
AT5G47230	5	19179938	19181129	1191	+	14
AT5G47240	5	19183600	19185644	2044	+	174
AT5G47250	5	19185793	19188745	2952	-	154
AT5G47260	5	19189410	19192516	3106	+	0
AT5G47280	5	19193156	19195559	2403	+	0
AT5G47290	5	19197039	19197431	392	-	0
AT5G47300	5	19198124	19199375	1251	+	0
AT5G47306	5	19200252	19200375	123	+	0
AT5G47310	5	19200781	19202921	2140	+	784
AT5G47320	5	19203150	19205272	2122	+	890
AT5G47330	5	19207098	19208822	1724	+	99
AT5G47340	5	19209506	19211134	1628	+	0
AT5G47350	5	19212688	19214453	1765	+	2
AT5G47360	5	19214444	19215878	1434	-	106
AT5G47370	5	19216311	19217909	1598	-	563
AT5G47380	5	19221471	19224591	3120	-	357
AT5G47390	5	19226789	19228858	2069	+	978
AT5G47400	5	19229161	19232586	3425	+	126
AT5G47420	5	19232835	19235059	2224	+	290
AT5G47430	5	19235630	19241256	5626	-	867
AT5G47435	5	19241702	19243988	2286	+	1240
AT5G47440	5	19243530	19245350	1820	-	50
AT5G47445	5	19246345	19247917	1572	-	64
AT5G47450	5	19248248	19249504	1256	-	1
AT5G47455	5	19250718	19252491	1773	+	84
AT5G47460	5	19252462	19254193	1731	-	25
AT5G47470	5	19254597	19256378	1781	+	5
AT5G47480	5	19257419	19263424	6005	+	1572
AT5G47490	5	19264674	19270800	6126	+	532
AT5G47500	5	19270958	19272883	1925	-	1432
AT5G47510	5	19275047	19277056	2009	+	49
AT5G47520	5	19277360	19279736	2376	-	312
AT5G47530	5	19281373	19283061	1688	+	7
AT5G47540	5	19283028	19285698	2670	-	682
AT5G47550	5	19286449	19286995	546	-	223
AT5G47560	5	19287368	19290465	3097	-	3859
AT5G47570	5	19292607	19294737	2130	-	1896
AT5G47580	5	19294845	19297418	2573	-	160
AT5G47590	5	19297816	19299152	1336	-	29
AT5G47600	5	19299781	19300499	718	-	8
AT5G47610	5	19301187	19301913	726	-	361
AT5G47620	5	19302189	19304816	2627	-	1009
AT5G47630	5	19306143	19307094	951	+	272
AT5G47635	5	19307047	19307895	848	-	8
AT5G47640	5	19309226	19310272	1046	+	997
AT5G47650	5	19310191	19312438	2247	-	492
AT5G47660	5	19313007	19314636	1629	+	183
AT5G47670	5	19315022	19316169	1147	+	6
AT5G47680	5	19316131	19317522	1391	-	421
AT5G47690	5	19317715	19327334	9619	+	3459
AT5G47700	5	19327802	19328983	1181	-	2193
AT5G47710	5	19329674	19331329	1655	+	383
AT5G47720	5	19331546	19334427	2881	+	437
AT5G47730	5	19334249	19337101	2852	-	403
AT5G47740	5	19338510	19339775	1265	+	2
AT5G47750	5	19339702	19342361	2659	-	688
AT5G47760	5	19342883	19345039	2156	-	445
AT5G47770	5	19345172	19347629	2457	+	1845
AT5G47780	5	19347918	19350669	2751	+	1713
AT5G47790	5	19351291	19353444	2153	+	280
AT5G47800	5	19353675	19356300	2625	+	231
AT5G47810	5	19356355	19358125	1770	-	120
AT5G47815	5	19358617	19363928	5311	+	0
AT5G47818	5	19364136	19364679	543	-	0
AT5G47820	5	19366482	19372789	6307	+	1875
AT5G47830	5	19372897	19374331	1434	-	151
AT5G47840	5	19375440	19378339	2899	+	3774
AT5G47850	5	19378700	19381082	2382	-	2
AT5G47860	5	19381518	19384422	2904	+	847
AT5G47870	5	19384367	19385869	1502	-	737
AT5G47880	5	19386099	19388562	2463	-	1141
AT5G47890	5	19388736	19390629	1893	+	1254
AT5G47900	5	19392233	19395135	2902	+	399
AT5G47910	5	19397442	19402061	4619	+	1276
AT5G47920	5	19403172	19404088	916	-	12
AT5G47928	5	19405750	19405921	171	-	0
AT5G47930	5	19406162	19407400	1238	-	2415
AT5G47940	5	19409241	19411893	2652	-	180
AT5G47950	5	19417030	19418546	1516	-	0
AT5G47960	5	19421383	19422533	1150	-	5
AT5G47970	5	19422202	19425811	3609	+	410
AT5G47980	5	19428887	19430476	1589	+	0
AT5G47990	5	19434826	19436689	1863	+	0
AT5G48000	5	19444137	19447850	3713	-	0
AT5G48010	5	19456959	19461689	4730	+	0
AT5G48020	5	19462657	19464957	2300	-	979
AT5G48030	5	19466010	19469902	3892	-	496
AT5G48040	5	19470138	19472445	2307	+	114
AT5G48050	5	19472660	19473770	1110	-	11
AT5G48060	5	19475295	19479002	3707	+	110
AT5G48070	5	19482105	19483452	1347	+	0
AT5G48090	5	19484164	19488657	4493	+	16
AT5G48100	5	19489326	19492744	3418	-	0
AT5G48110	5	19501156	19504357	3201	-	0
AT5G48120	5	19507901	19514854	6953	-	543
AT5G48130	5	19516101	19518513	2412	+	0
AT5G48140	5	19518769	19520528	1759	-	0
AT5G48150	5	19522254	19524698	2444	-	1262
AT5G48160	5	19527832	19530316	2484	-	1521
AT5G48170	5	19532536	19533265	729	-	17
AT5G48175	5	19539157	19539781	624	+	1
AT5G48180	5	19540936	19542426	1490	-	1280
AT5G48190	5	19543478	19544169	691	+	0
AT5G48200	5	19545254	19547270	2016	+	0
AT5G48205	5	19546936	19547787	851	-	0
AT5G48210	5	19548413	19549141	728	+	0
AT5G48220	5	19549675	19552267	2592	+	1570
AT5G48230	5	19552141	19555529	3388	-	1198
AT5G48240	5	19559242	19561275	2033	+	258
AT5G48250	5	19561318	19563722	2404	-	51
AT5G48270	5	19564421	19565857	1436	-	0
AT5G48280	5	19567063	19567688	625	-	0
AT5G48290	5	19568895	19569799	904	+	4
AT5G48300	5	19570239	19572804	2565	+	11944
AT5G48310	5	19574779	19580391	5612	-	184
AT5G48320	5	19581704	19584748	3044	-	45
AT5G48330	5	19585935	19587841	1906	+	157
AT5G48335	5	19587992	19589606	1614	+	424
AT5G48340	5	19590435	19593000	2565	+	340
AT5G48350	5	19593216	19594441	1225	+	0
AT5G48360	5	19595656	19598492	2836	+	762
AT5G48370	5	19598522	19600644	2122	-	273
AT5G48375	5	19601302	19603883	2581	-	0
AT5G48380	5	19604088	19607059	2971	-	509
AT5G48385	5	19608559	19612007	3448	+	1802
AT5G48390	5	19612061	19615383	3322	+	9
AT5G48400	5	19616243	19619246	3003	+	4
AT5G48410	5	19620266	19623425	3159	+	2
AT5G48412	5	19623515	19624232	717	-	324
AT5G48420	5	19626361	19626790	429	-	0
AT5G48430	5	19627711	19629163	1452	-	0
AT5G48440	5	19629657	19632639	2982	-	377
AT5G48450	5	19632790	19635664	2874	-	175
AT5G48460	5	19636100	19639488	3388	-	649
AT5G48465	5	19641602	19641674	72	+	0
AT5G48470	5	19641743	19644362	2619	+	402
AT5G48480	5	19644674	19645889	1215	+	465
AT5G48485	5	19646231	19646802	571	-	421
AT5G48490	5	19647834	19648281	447	-	739
AT5G48500	5	19652990	19654244	1254	+	232
AT5G48510	5	19658079	19658882	803	+	0
AT5G48515	5	19659856	19660201	345	-	0
AT5G48520	5	19661212	19666436	5224	+	482
AT5G48530	5	19666836	19668830	1994	-	132
AT5G48540	5	19668963	19669920	957	-	232
AT5G48543	5	19674391	19675292	901	+	0
AT5G48545	5	19676116	19678109	1993	+	816
AT5G48550	5	19678916	19680560	1644	+	20
AT5G48560	5	19684005	19687151	3146	+	40
AT5G48570	5	19690541	19693845	3304	-	332
AT5G48575	5	19694149	19695065	916	-	0
AT5G48580	5	19695928	19698712	2784	-	753
AT5G48590	5	19698406	19699947	1541	+	895
AT5G48595	5	19700639	19701022	383	+	0
AT5G48600	5	19701802	19709216	7414	+	596
AT5G48605	5	19710214	19710578	364	+	0
AT5G48610	5	19711541	19715910	4369	+	206
AT5G48620	5	19716475	19721452	4977	+	1877
AT5G48630	5	19721502	19723234	1732	-	457
AT5G48640	5	19723532	19725689	2157	-	315
AT5G48650	5	19726732	19729654	2922	+	36
AT5G48655	5	19731149	19733043	1894	-	448
AT5G48657	5	19733883	19735550	1667	-	14
AT5G48660	5	19736646	19738538	1892	+	175
AT5G48670	5	19738715	19739841	1126	-	23
AT5G48675	5	19744174	19744246	72	-	0
AT5G48680	5	19744430	19746190	1760	-	273
AT5G48690	5	19747025	19749061	2036	-	39
AT5G48700	5	19749493	19750013	520	-	0
AT5G48710	5	19755064	19755572	508	-	0
AT5G48720	5	19758880	19761721	2841	+	162
AT5G48730	5	19763151	19765272	2121	+	514
AT5G48740	5	19765194	19769369	4175	-	50
AT5G48750	5	19770051	19770819	768	-	0
AT5G48760	5	19771137	19772738	1601	-	978
AT5G48770	5	19773276	19777242	3966	-	47
AT5G48775	5	19774169	19776460	2291	+	8
AT5G48780	5	19777452	19779815	2363	+	16
AT5G48790	5	19779859	19782050	2191	-	3238
AT5G48800	5	19786763	19789129	2366	+	275
AT5G48810	5	19789066	19790334	1268	-	2463
AT5G48820	5	19792269	19794408	2139	-	42
AT5G48830	5	19800113	19803098	2985	-	892
AT5G48835	5	19803134	19803172	38	+	0
AT5G48840	5	19803556	19805077	1521	-	332
AT5G48850	5	19805436	19807759	2323	-	32
AT5G48860	5	19811650	19812865	1215	-	0
AT5G48870	5	19813345	19814554	1209	+	330
AT5G48880	5	19814394	19817897	3503	-	2314
AT5G48890	5	19820352	19820874	522	+	1
AT5G48900	5	19825136	19829092	3956	+	1144
AT5G48905	5	19831283	19831787	504	+	0
AT5G48910	5	19832871	19834934	2063	-	612
AT5G48920	5	19835336	19836122	786	+	150
AT5G48930	5	19836298	19838162	1864	-	4716
AT5G48940	5	19839709	19843807	4098	+	4
AT5G48945	5	19844777	19845518	741	+	0
AT5G48950	5	19846152	19847435	1283	+	5
AT5G48953	5	19847710	19848250	540	-	1
AT5G48960	5	19849542	19853564	4022	+	599
AT5G48965	5	19853990	19856859	2869	+	168
AT5G48970	5	19856829	19859763	2934	-	253
AT5G48980	5	19860707	19862018	1311	+	1
AT5G48990	5	19862288	19863625	1337	+	152
AT5G49000	5	19864512	19865755	1243	+	76
AT5G49010	5	19866230	19868365	2135	+	81
AT5G49015	5	19869016	19870329	1313	+	42
AT5G49020	5	19871250	19874920	3670	+	433
AT5G49030	5	19874943	19883297	8354	-	4219
AT5G49040	5	19882675	19883251	576	-	0
AT5G49050	5	19883928	19884381	453	+	0
AT5G49060	5	19886497	19888463	1966	+	174
AT5G49070	5	19888750	19890145	1395	-	8
AT5G49080	5	19890783	19892809	2026	-	0
AT5G49090	5	19893713	19894233	520	-	0
AT5G49100	5	19897369	19899114	1745	-	776
AT5G49110	5	19900202	19905925	5723	+	48
AT5G49120	5	19908625	19909399	774	-	57
AT5G49130	5	19915871	19917525	1654	+	0
AT5G49138	5	19915867	19917277	1410	-	0
AT5G49140	5	19919084	19923415	4331	-	0
AT5G49150	5	19924382	19928527	4145	+	0
AT5G49152	5	19924321	19929377	5056	+	18
AT5G49160	5	19932229	19938369	6140	+	981
AT5G49170	5	19938575	19939571	996	-	58
AT5G49180	5	19940677	19943007	2330	-	0
AT5G49190	5	19943281	19947189	3908	-	21
AT5G49200	5	19947795	19949055	1260	-	2
AT5G49210	5	19949721	19951687	1966	+	411
AT5G49215	5	19953486	19956116	2630	+	476
AT5G49220	5	19956436	19958833	2397	+	450
AT5G49230	5	19958872	19960544	1672	-	405
AT5G49240	5	19962933	19964351	1418	+	0
AT5G49250	5	19965342	19965945	603	+	0
AT5G49260	5	19966798	19967527	729	+	0
AT5G49270	5	19971908	19974444	2536	-	0
AT5G49280	5	19976593	19977449	856	-	125
AT5G49290	5	19980194	19983869	3675	+	54
AT5G49300	5	19984848	19985697	849	-	43
AT5G49301	5	19986785	19987570	785	-	0
AT5G49310	5	19992015	19994516	2501	-	6
AT5G49320	5	19995024	19996314	1290	-	23
AT5G49330	5	19998951	20001378	2427	-	66
AT5G49334	5	20003967	20004102	135	-	0
AT5G49340	5	20007347	20009038	1691	-	0
AT5G49350	5	20009740	20011099	1359	-	0
AT5G49360	5	20011878	20016742	4864	-	1371
AT5G49370	5	20023455	20024530	1075	+	11
AT5G49380	5	20025564	20027078	1514	+	20
AT5G49390	5	20027339	20030361	3022	+	95
AT5G49400	5	20030699	20032175	1476	+	294
AT5G49410	5	20032462	20034001	1539	+	16
AT5G49420	5	20034673	20036170	1497	-	0
AT5G49430	5	20037337	20045454	8117	-	767
AT5G49435	5	20046822	20046894	72	+	0
AT5G49440	5	20048238	20049597	1359	+	1360
AT5G49448	5	20051828	20052735	907	+	0
AT5G49450	5	20051828	20052735	907	+	0
AT5G49460	5	20054522	20058464	3942	+	1570
AT5G49465	5	20059841	20062191	2350	-	0
AT5G49470	5	20063447	20068665	5218	+	419
AT5G49480	5	20070742	20071638	896	+	933
AT5G49490	5	20075327	20076185	858	+	0
AT5G49500	5	20077555	20080206	2651	-	108
AT5G49510	5	20080613	20082921	2308	+	557
AT5G49520	5	20090775	20093346	2571	+	27
AT5G49525	5	20097039	20097486	447	-	14
AT5G49530	5	20100578	20104447	3869	+	379
AT5G49540	5	20104480	20106122	1642	-	564
AT5G49550	5	20106652	20107191	539	-	148
AT5G49555	5	20107228	20110636	3408	-	940
AT5G49560	5	20110960	20111785	825	-	30
AT5G49570	5	20111858	20116185	4327	-	563
AT5G49580	5	20123822	20126813	2991	-	587
AT5G49590	5	20128735	20129554	819	+	0
AT5G49600	5	20130779	20131295	516	+	0
AT5G49610	5	20131273	20132729	1456	-	166
AT5G49615	5	20134199	20134786	587	+	6
AT5G49620	5	20137393	20139529	2136	-	0
AT5G49630	5	20142469	20146498	4029	-	1727
AT5G49640	5	20151162	20151842	680	+	424
AT5G49650	5	20152780	20155768	2988	+	1302
AT5G49660	5	20161205	20164729	3524	-	1518
AT5G49665	5	20167001	20169474	2473	-	247
AT5G49680	5	20176384	20188307	11923	+	47
AT5G49690	5	20189654	20191390	1736	-	2
AT5G49700	5	20192598	20193429	831	+	20
AT5G49710	5	20195409	20197353	1944	+	291
AT5G49720	5	20197390	20200288	2898	-	5556
AT5G49730	5	20201100	20204513	3413	-	7898
AT5G49740	5	20205341	20208730	3389	-	4457
AT5G49743	5	20209065	20209306	241	+	0
AT5G49746	5	20209339	20209659	320	+	0
AT5G49750	5	20210877	20213734	2857	+	0
AT5G49760	5	20216371	20221299	4928	+	2374
AT5G49770	5	20222668	20227267	4599	+	2
AT5G49780	5	20229255	20233095	3840	+	12
AT5G49790	5	20233145	20233511	366	+	0
AT5G49800	5	20234641	20236184	1543	-	94
AT5G49810	5	20239342	20246380	7038	+	2364
AT5G49820	5	20246499	20249545	3046	-	736
AT5G49830	5	20250485	20255039	4554	-	986
AT5G49840	5	20255190	20259300	4110	+	717
AT5G49850	5	20259907	20262585	2678	-	0
AT5G49860	5	20264566	20265334	768	-	0
AT5G49870	5	20270191	20272548	2357	-	0
AT5G49880	5	20282164	20288084	5920	+	504
AT5G49890	5	20288118	20292350	4232	-	1068
AT5G49900	5	20296517	20302346	5829	-	132
AT5G49910	5	20303413	20306469	3056	+	10794
AT5G49920	5	20306408	20307943	1535	-	3
AT5G49930	5	20308032	20312808	4776	-	673
AT5G49940	5	20315397	20317401	2004	+	2130
AT5G49945	5	20317404	20319830	2426	+	306
AT5G49950	5	20319732	20323616	3884	-	391
AT5G49960	5	20323963	20327828	3865	-	252
AT5G49970	5	20329186	20333155	3969	+	2492
AT5G49980	5	20333963	20336665	2702	-	1657
AT5G49990	5	20337640	20341881	4241	-	338
AT5G50000	5	20342586	20345133	2547	-	1348
AT5G50010	5	20348614	20350830	2216	+	0
AT5G50011	5	20348614	20350830	2216	+	0
AT5G50012	5	20348614	20350830	2216	+	0
AT5G50020	5	20351159	20354436	3277	+	547
AT5G50030	5	20354588	20355627	1039	+	2
AT5G50040	5	20357125	20358107	982	+	0
AT5G50050	5	20360023	20361031	1008	+	0
AT5G50060	5	20362549	20363461	912	+	3
AT5G50070	5	20364555	20365429	874	+	0
AT5G50080	5	20365721	20366835	1114	+	0
AT5G50090	5	20369850	20371094	1244	+	45
AT5G50100	5	20371852	20373441	1589	+	1498
AT5G50110	5	20373514	20376207	2693	+	201
AT5G50111	5	20376310	20376942	632	-	0
AT5G50115	5	20379488	20381036	1548	+	0
AT5G50120	5	20382614	20383874	1260	-	21
AT5G50130	5	20389996	20393263	3267	+	153
AT5G50136	5	20394869	20395010	141	-	0
AT5G50140	5	20395855	20398197	2342	+	1
AT5G50150	5	20402256	20406731	4475	-	462
AT5G50160	5	20415770	20418742	2972	+	2045
AT5G50170	5	20421072	20425586	4514	+	237
AT5G50175	5	20428094	20428719	625	+	0
AT5G50180	5	20430595	20433100	2505	+	765
AT5G50190	5	20433506	20434543	1037	-	0
AT5G50200	5	20436179	20437726	1547	+	36
AT5G50210	5	20442646	20445991	3345	+	1102
AT5G50220	5	20446067	20447200	1133	-	0
AT5G50230	5	20448369	20450881	2512	-	310
AT5G50240	5	20451227	20452569	1342	+	393
AT5G50250	5	20452486	20454013	1527	-	2014
AT5G50260	5	20455316	20457029	1713	+	18
AT5G50270	5	20457486	20458873	1387	+	1
AT5G50280	5	20459237	20461504	2267	+	471
AT5G50290	5	20461776	20464177	2401	+	17
AT5G50300	5	20466067	20468124	2057	-	0
AT5G50310	5	20474486	20479455	4969	+	890
AT5G50315	5	20479590	20481077	1487	+	29
AT5G50320	5	20480625	20484850	4225	-	398
AT5G50330	5	20485222	20488684	3462	-	114
AT5G50335	5	20489093	20489727	634	-	11
AT5G50340	5	20491416	20495931	4515	-	467
AT5G50345	5	20497400	20497868	468	+	0
AT5G50350	5	20498475	20501680	3205	-	202
AT5G50360	5	20505179	20506338	1159	-	0
AT5G50361	5	20506380	20506578	198	-	0
AT5G50370	5	20509158	20510703	1545	-	478
AT5G50375	5	20511666	20514249	2583	+	348
AT5G50380	5	20516111	20518573	2462	-	628
AT5G50390	5	20520788	20522980	2192	-	107
AT5G50400	5	20523574	20526469	2895	-	768
AT5G50410	5	20528198	20529827	1629	-	282
AT5G50420	5	20530205	20532856	2651	-	404
AT5G50423	5	20532859	20533471	612	-	0
AT5G50430	5	20534172	20537117	2945	-	449
AT5G50440	5	20537524	20538943	1419	-	63
AT5G50450	5	20543309	20544753	1444	-	39
AT5G50460	5	20551436	20552566	1130	-	756
AT5G50470	5	20555119	20555758	639	-	0
AT5G50480	5	20557573	20558487	914	-	1
AT5G50490	5	20560433	20561187	754	-	0
AT5G50500	5	20562149	20562557	408	-	0
AT5G50510	5	20567385	20568075	690	-	0
AT5G50520	5	20569562	20571615	2053	-	0
AT5G50530	5	20571680	20575250	3570	-	68
AT5G50540	5	20574576	20575538	962	-	0
AT5G50550	5	20576869	20578913	2044	+	0
AT5G50560	5	20579120	20579588	468	+	5
AT5G50562	5	20580268	20580442	174	-	0
AT5G50565	5	20580255	20582103	1848	+	0
AT5G50570	5	20582082	20584559	2477	-	12
AT5G50580	5	20585348	20587620	2272	+	0
AT5G50590	5	20587987	20589296	1309	+	0
AT5G50600	5	20589701	20591689	1988	-	0
AT5G50610	5	20593701	20594259	558	+	0
AT5G50620	5	20600726	20601416	690	-	0
AT5G50630	5	20602920	20604956	2036	-	0
AT5G50640	5	20605217	20608594	3377	-	0
AT5G50645	5	20607918	20608880	962	-	0
AT5G50650	5	20610211	20612255	2044	+	0
AT5G50660	5	20612574	20612778	204	+	0
AT5G50665	5	20613633	20615470	1837	+	9
AT5G50670	5	20615703	20617901	2198	-	0
AT5G50680	5	20618742	20620962	2220	+	0
AT5G50690	5	20621329	20622638	1309	+	0
AT5G50700	5	20623023	20625034	2011	-	0
AT5G50710	5	20627043	20627601	558	+	0
AT5G50715	5	20631643	20632311	668	+	0
AT5G50717	5	20632513	20632637	124	+	0
AT5G50720	5	20633192	20634552	1360	-	118
AT5G50740	5	20635865	20637996	2131	-	951
AT5G50750	5	20640991	20642660	1669	+	9
AT5G50760	5	20644660	20645469	809	+	2
AT5G50770	5	20646679	20648725	2046	-	0
AT5G50780	5	20650268	20655212	4944	+	286
AT5G50790	5	20656252	20658001	1749	-	15
AT5G50800	5	20665076	20667304	2228	-	220
AT5G50801	5	20668112	20668268	156	-	0
AT5G50805	5	20675221	20675293	72	+	0
AT5G50810	5	20675633	20676612	979	-	375
AT5G50820	5	20679224	20680125	901	+	42
AT5G50830	5	20683278	20684855	1577	+	0
AT5G50840	5	20685819	20688918	3099	+	291
AT5G50850	5	20689389	20693285	3896	+	3560
AT5G50860	5	20693462	20697039	3577	-	590
AT5G50870	5	20699432	20701206	1774	-	735
AT5G50880	5	20701365	20701644	279	-	0
AT5G50890	5	20702683	20704235	1552	+	155
AT5G50900	5	20704803	20706778	1975	-	375
AT5G50910	5	20708408	20709282	874	-	0
AT5G50915	5	20710208	20712315	2107	-	326
AT5G50920	5	20715468	20720374	4906	-	43920
AT5G50930	5	20722068	20724440	2372	+	33
AT5G50940	5	20724577	20726479	1902	+	21
AT5G50950	5	20729611	20733926	4315	+	7384
AT5G50960	5	20734166	20736055	1889	+	773
AT5G50970	5	20736336	20739295	2959	+	278
AT5G50990	5	20739418	20741281	1863	+	72
AT5G50995	5	20741677	20741714	37	-	0
AT5G51000	5	20742532	20743669	1137	-	0
AT5G51010	5	20744565	20745703	1138	+	2689
AT5G51020	5	20745348	20747277	1929	-	1417
AT5G51030	5	20747758	20749506	1748	-	37
AT5G51040	5	20750659	20752024	1365	+	930
AT5G51050	5	20753380	20755714	2334	+	280
AT5G51055	5	20756329	20756411	82	+	0
AT5G51060	5	20757283	20762431	5148	-	37
AT5G51070	5	20764314	20768681	4367	+	3535
AT5G51080	5	20768803	20771032	2229	-	113
AT5G51090	5	20772236	20773194	958	-	0
AT5G51100	5	20773295	20775701	2406	-	645
AT5G51105	5	20777573	20778118	545	+	0
AT5G51110	5	20778131	20779464	1333	-	6551
AT5G51120	5	20779326	20781557	2231	+	606
AT5G51130	5	20781815	20784071	2256	+	87
AT5G51140	5	20783930	20786816	2886	-	720
AT5G51150	5	20788983	20791808	2825	+	662
AT5G51160	5	20792210	20793841	1631	+	0
AT5G51170	5	20793793	20795399	1606	-	107
AT5G51174	5	20795935	20796051	116	+	3
AT5G51180	5	20797016	20800214	3198	+	394
AT5G51190	5	20800583	20801416	833	-	36
AT5G51195	5	20803105	20804268	1163	-	0
AT5G51200	5	20804925	20819592	14667	+	1210
AT5G51210	5	20820100	20820944	844	+	1
AT5G51220	5	20821214	20823266	2052	-	200
AT5G51230	5	20823735	20829564	5829	+	685
AT5G51250	5	20830742	20831849	1107	+	0
AT5G51260	5	20832024	20833782	1758	-	263
AT5G51270	5	20835136	20838262	3126	-	10
AT5G51280	5	20841244	20843806	2562	+	468
AT5G51290	5	20843997	20848340	4343	-	575
AT5G51300	5	20848896	20852334	3438	-	1152
AT5G51310	5	20852853	20854718	1865	-	36
AT5G51320	5	20856068	20856864	796	-	0
AT5G51330	5	20858705	20861711	3006	-	8
AT5G51340	5	20862942	20867370	4428	+	595
AT5G51350	5	20867601	20870745	3144	-	159
AT5G51360	5	20871917	20872277	360	+	0
AT5G51370	5	20872761	20874284	1523	+	121
AT5G51380	5	20875875	20877989	2114	+	73
AT5G51390	5	20877966	20878464	498	-	13
AT5G51400	5	20878612	20880134	1522	-	905
AT5G51410	5	20880740	20883908	3168	-	747
AT5G51420	5	20885418	20886726	1308	-	0
AT5G51430	5	20886837	20890907	4070	-	959
AT5G51440	5	20891162	20892211	1049	+	18
AT5G51450	5	20892642	20897817	5175	+	419
AT5G51451	5	20898107	20898763	656	+	21
AT5G51460	5	20900976	20904539	3563	+	873
AT5G51470	5	20907286	20909340	2054	+	7
AT5G51480	5	20910243	20913451	3208	+	2
AT5G51490	5	20913552	20915606	2054	-	0
AT5G51500	5	20917928	20919838	1910	-	0
AT5G51510	5	20921432	20922978	1546	+	229
AT5G51520	5	20925979	20926594	615	+	0
AT5G51530	5	20927117	20931502	4385	-	23
AT5G51540	5	20932030	20936413	4383	+	141
AT5G51545	5	20936425	20937413	988	+	1008
AT5G51550	5	20939493	20940895	1402	-	1447
AT5G51560	5	20945684	20948854	3170	+	698
AT5G51570	5	20949403	20951497	2094	+	129
AT5G51580	5	20952441	20953393	952	-	20
AT5G51590	5	20956566	20959113	2547	-	82
AT5G51600	5	20960910	20964484	3574	-	345
AT5G51610	5	20965576	20966805	1229	+	0
AT5G51620	5	20967045	20968252	1207	+	195
AT5G51630	5	20969442	20974916	5474	+	195
AT5G51640	5	20975179	20977625	2446	-	186
AT5G51650	5	20978202	20979249	1047	-	0
AT5G51660	5	20980214	20989427	9213	+	761
AT5G51670	5	20993536	20995644	2108	+	137
AT5G51680	5	20997319	20998907	1588	+	0
AT5G51690	5	20997412	21001046	3634	-	275
AT5G51700	5	21001208	21003205	1997	-	268
AT5G51710	5	21004277	21008718	4441	-	369
AT5G51720	5	21009591	21010345	754	+	2950
AT5G51730	5	21011417	21013657	2240	+	322
AT5G51740	5	21017026	21019221	2195	+	233
AT5G51750	5	21020206	21022781	2575	+	1232
AT5G51760	5	21026915	21029188	2273	+	0
AT5G51770	5	21031029	21032994	1965	+	175
AT5G51780	5	21034822	21036773	1951	+	0
AT5G51790	5	21039761	21040594	833	+	9
AT5G51795	5	21043082	21044194	1112	-	37
AT5G51800	5	21048190	21052012	3822	+	2
AT5G51810	5	21055187	21056808	1621	-	3
AT5G51812	5	21058538	21058772	234	+	0
AT5G51820	5	21063367	21068057	4690	-	3434
AT5G51830	5	21069571	21071735	2164	+	334
AT5G51840	5	21071943	21074438	2495	+	355
AT5G51845	5	21077142	21077502	360	+	0
AT5G51850	5	21079251	21081578	2327	+	212
AT5G51860	5	21081843	21084427	2584	-	0
AT5G51870	5	21085461	21088004	2543	-	0
AT5G51880	5	21089382	21090941	1559	+	563
AT5G51890	5	21090991	21092405	1414	-	649
AT5G51900	5	21093680	21094454	774	-	1
AT5G51910	5	21094546	21095848	1302	-	111
AT5G51920	5	21097105	21098959	1854	-	16
AT5G51930	5	21101122	21103568	2446	+	0
AT5G51940	5	21104570	21105947	1377	+	467
AT5G51950	5	21105908	21108605	2697	-	11
AT5G51960	5	21110339	21111348	1009	+	263
AT5G51970	5	21111444	21113403	1959	+	3507
AT5G51980	5	21113360	21116197	2837	-	539
AT5G51990	5	21117112	21117787	675	-	0
AT5G52000	5	21119023	21121119	2096	-	2
AT5G52010	5	21121482	21122985	1503	-	668
AT5G52020	5	21123957	21124948	991	-	3
AT5G52030	5	21128128	21130090	1962	+	713
AT5G52040	5	21130319	21133621	3302	+	1222
AT5G52050	5	21138861	21140643	1782	+	20
AT5G52055	5	21147954	21148865	911	+	2
AT5G52060	5	21152213	21154244	2031	-	2610
AT5G52065	5	21157311	21158579	1268	-	0
AT5G52067	5	21160153	21160483	330	-	0
AT5G52070	5	21161310	21165025	3715	+	134
AT5G52080	5	21167242	21167350	108	+	0
AT5G52090	5	21167431	21169462	2031	-	0
AT5G52100	5	21170144	21172346	2202	+	902
AT5G52110	5	21171633	21174005	2372	-	307
AT5G52120	5	21176421	21180310	3889	-	123
AT5G52130	5	21182467	21183875	1408	-	0
AT5G52140	5	21184521	21186872	2351	-	0
AT5G52145	5	21188601	21189001	400	+	0
AT5G52150	5	21189987	21191303	1316	-	0
AT5G52160	5	21195043	21195763	720	+	0
AT5G52170	5	21196973	21199959	2986	+	3
AT5G52180	5	21200054	21201610	1556	-	307
AT5G52190	5	21201729	21202543	814	-	388
AT5G52200	5	21202548	21204759	2211	-	439
AT5G52210	5	21204990	21207098	2108	+	237
AT5G52220	5	21207096	21207716	620	-	37
AT5G52230	5	21207887	21211986	4099	-	241
AT5G52240	5	21213057	21214739	1682	+	1320
AT5G52250	5	21216854	21218226	1372	+	58
AT5G52260	5	21220164	21221288	1124	+	0
AT5G52270	5	21221642	21222600	958	-	8
AT5G52272	5	21223177	21223844	667	-	0
AT5G52280	5	21226832	21230254	3422	+	793
AT5G52290	5	21230352	21236554	6202	-	13
AT5G52300	5	21237055	21239529	2474	+	16
AT5G52310	5	21240848	21243613	2765	+	1434
AT5G52320	5	21244977	21246682	1705	-	448
AT5G52330	5	21247595	21250425	2830	-	0
AT5G52340	5	21250801	21253939	3138	+	14
AT5G52350	5	21254910	21257618	2708	+	0
AT5G52355	5	21257833	21257915	82	-	0
AT5G52360	5	21257933	21259342	1409	-	0
AT5G52370	5	21260277	21261287	1010	-	353
AT5G52380	5	21261352	21263151	1799	-	127
AT5G52390	5	21263935	21265264	1329	-	26
AT5G52400	5	21272948	21275509	2561	+	0
AT5G52410	5	21275955	21279444	3489	+	308
AT5G52415	5	21279903	21281298	1395	+	0
AT5G52420	5	21281772	21282806	1034	+	960
AT5G52430	5	21282749	21285271	2522	-	227
AT5G52440	5	21286759	21288904	2145	+	3439
AT5G52450	5	21288897	21291862	2965	-	356
AT5G52460	5	21292374	21293758	1384	-	0
AT5G52470	5	21294186	21296704	2518	+	1970
AT5G52471	5	21295735	21295809	74	+	7
AT5G52480	5	21296832	21297858	1026	-	0
AT5G52490	5	21298856	21300239	1383	+	0
AT5G52495	5	21300879	21300963	84	-	0
AT5G52500	5	21301524	21302829	1305	+	1
AT5G52510	5	21307048	21309302	2254	+	800
AT5G52520	5	21311062	21314180	3118	+	2168
AT5G52530	5	21317139	21321236	4097	+	1663
AT5G52540	5	21321427	21323780	2353	-	1279
AT5G52545	5	21323780	21325596	1816	-	53
AT5G52547	5	21326118	21327471	1353	-	29
AT5G52550	5	21327711	21330136	2425	-	0
AT5G52552	5	21327711	21330136	2425	-	0
AT5G52560	5	21330638	21334811	4173	+	987
AT5G52570	5	21334792	21337002	2210	-	899
AT5G52580	5	21337860	21342985	5125	+	1182
AT5G52600	5	21343101	21343968	867	-	6
AT5G52605	5	21345215	21345600	385	-	0
AT5G52610	5	21346422	21347478	1056	-	0
AT5G52620	5	21348553	21349681	1128	-	0
AT5G52630	5	21350374	21352141	1767	+	54
AT5G52640	5	21352398	21355361	2963	+	275
AT5G52650	5	21355554	21357105	1551	-	2771
AT5G52660	5	21359058	21362160	3102	-	353
AT5G52670	5	21363654	21364302	648	+	0
AT5G52680	5	21365812	21366863	1051	+	0
AT5G52690	5	21370498	21371499	1001	+	0
AT5G52700	5	21372819	21374195	1376	+	0
AT5G52710	5	21375752	21378172	2420	+	0
AT5G52720	5	21378856	21379744	888	+	0
AT5G52730	5	21380173	21380865	692	+	6
AT5G52740	5	21382529	21383180	651	+	13
AT5G52750	5	21384042	21384924	882	+	85
AT5G52760	5	21386823	21387703	880	+	50
AT5G52770	5	21389765	21390189	424	+	0
AT5G52780	5	21390872	21391474	602	-	1015
AT5G52790	5	21391716	21394359	2643	-	13
AT5G52797	5	21395544	21395629	85	-	0
AT5G52800	5	21395943	21399419	3476	+	38
AT5G52810	5	21399330	21400603	1273	+	392
AT5G52815	5	21401143	21401215	72	+	0
AT5G52820	5	21401348	21404385	3037	+	510
AT5G52830	5	21410851	21412340	1489	+	87
AT5G52840	5	21413645	21415006	1361	+	1981
AT5G52850	5	21414934	21417616	2682	-	17
AT5G52860	5	21419775	21421567	1792	-	98
AT5G52870	5	21427946	21429447	1501	-	253
AT5G52880	5	21431835	21433712	1877	-	302
AT5G52882	5	21433878	21438659	4781	-	414
AT5G52890	5	21444834	21447240	2406	-	133
AT5G52900	5	21452441	21453808	1367	-	417
AT5G52901	5	21454425	21454653	228	+	0
AT5G52910	5	21457626	21463159	5533	-	163
AT5G52920	5	21463537	21466880	3343	+	4031
AT5G52930	5	21470298	21471861	1563	+	30
AT5G52940	5	21472200	21473602	1402	+	11
AT5G52950	5	21473886	21476939	3053	-	132
AT5G52960	5	21477145	21478437	1292	+	1424
AT5G52965	5	21478840	21479203	363	+	0
AT5G52970	5	21479598	21481226	1628	+	1933
AT5G52975	5	21481456	21482035	579	+	0
AT5G52980	5	21482159	21483722	1563	-	119
AT5G52990	5	21483927	21485287	1360	+	22
AT5G53000	5	21485454	21487991	2537	-	643
AT5G53010	5	21488489	21496537	8048	-	301
AT5G53020	5	21499898	21502401	2503	+	492
AT5G53030	5	21505073	21506620	1547	+	51
AT5G53040	5	21506966	21507948	982	-	0
AT5G53045	5	21508384	21509609	1225	-	128
AT5G53048	5	21509860	21511850	1990	+	34
AT5G53050	5	21510094	21513576	3482	-	805
AT5G53060	5	21515025	21520421	5396	+	339
AT5G53070	5	21518592	21520421	1829	+	214
AT5G53080	5	21520512	21523266	2754	+	222
AT5G53090	5	21523378	21525697	2319	+	105
AT5G53100	5	21526249	21528323	2074	+	0
AT5G53110	5	21529021	21533159	4138	+	9
AT5G53120	5	21534472	21537816	3344	+	1322
AT5G53130	5	21537720	21541029	3309	-	1144
AT5G53135	5	21542928	21546555	3627	+	0
AT5G53140	5	21548472	21552470	3998	+	2755
AT5G53144	5	21553621	21553720	99	+	12
AT5G53150	5	21554790	21557491	2701	+	511
AT5G53160	5	21560717	21562260	1543	+	559
AT5G53170	5	21562746	21568012	5266	-	3857
AT5G53180	5	21568199	21571902	3703	-	718
AT5G53190	5	21572250	21574329	2079	-	0
AT5G53200	5	21582773	21584145	1372	+	280
AT5G53205	5	21585597	21585774	177	-	0
AT5G53210	5	21586605	21588941	2336	-	127
AT5G53220	5	21595989	21598224	2235	+	139
AT5G53230	5	21598865	21599942	1077	+	1
AT5G53240	5	21601480	21602739	1259	+	0
AT5G53250	5	21603619	21604231	612	+	0
AT5G53260	5	21604661	21605674	1013	-	0
AT5G53270	5	21606270	21607297	1027	-	0
AT5G53280	5	21607506	21609418	1912	+	504
AT5G53290	5	21617812	21619267	1455	-	25
AT5G53300	5	21632020	21634247	2227	-	7189
AT5G53310	5	21634580	21636355	1775	+	498
AT5G53320	5	21636240	21638398	2158	-	16
AT5G53330	5	21639216	21640963	1747	+	582
AT5G53340	5	21640808	21643562	2754	-	320
AT5G53350	5	21643897	21647707	3810	+	3959
AT5G53360	5	21647901	21649567	1666	+	104
AT5G53370	5	21649531	21651593	2062	-	2186
AT5G53380	5	21654600	21656539	1939	+	0
AT5G53390	5	21656733	21659262	2529	-	13
AT5G53400	5	21661444	21663572	2128	+	536
AT5G53410	5	21667938	21668046	108	+	0
AT5G53420	5	21673524	21675733	2209	+	917
AT5G53430	5	21677145	21683494	6349	+	469
AT5G53440	5	21683678	21687970	4292	-	909
AT5G53450	5	21688762	21692429	3667	+	992
AT5G53451	5	21693268	21693373	105	+	0
AT5G53460	5	21700201	21710066	9865	+	5168
AT5G53470	5	21710350	21712611	2261	+	341
AT5G53480	5	21713365	21717782	4417	+	2237
AT5G53486	5	21721730	21722838	1108	+	280
AT5G53487	5	21723113	21723184	71	-	0
AT5G53490	5	21723306	21724642	1336	-	3955
AT5G53500	5	21725440	21729300	3860	-	1077
AT5G53510	5	21738848	21742082	3234	+	1
AT5G53520	5	21743449	21745981	2532	+	0
AT5G53530	5	21746034	21748595	2561	-	506
AT5G53540	5	21749285	21751237	1952	-	704
AT5G53550	5	21755290	21758921	3631	+	1233
AT5G53560	5	21759366	21760578	1212	+	1825
AT5G53570	5	21760589	21763462	2873	-	480
AT5G53580	5	21765053	21767000	1947	-	2096
AT5G53588	5	21771810	21772794	984	+	0
AT5G53590	5	21771810	21772794	984	+	0
AT5G53592	5	21773687	21774927	1240	+	10
AT5G53600	5	21777106	21777442	336	+	1
AT5G53610	5	21779060	21779393	333	+	0
AT5G53620	5	21780946	21785230	4284	+	1194
AT5G53635	5	21785998	21787444	1446	-	0
AT5G53640	5	21788310	21790690	2380	-	1
AT5G53650	5	21791176	21792441	1265	+	341
AT5G53660	5	21794535	21796046	1511	+	22
AT5G53670	5	21796996	21797731	735	+	0
AT5G53680	5	21798381	21799109	728	+	0
AT5G53690	5	21800486	21800717	231	+	0
AT5G53700	5	21801142	21802787	1645	+	5
AT5G53710	5	21805258	21805794	536	-	6
AT5G53720	5	21806621	21807012	391	+	1
AT5G53730	5	21807973	21808810	837	-	84
AT5G53740	5	21811632	21814908	3276	+	7
AT5G53742	5	21813670	21814018	348	+	0
AT5G53750	5	21817365	21818843	1478	+	95
AT5G53760	5	21822485	21826451	3966	+	482
AT5G53770	5	21826655	21829983	3328	+	233
AT5G53775	5	21831517	21836800	5283	-	0
AT5G53780	5	21839817	21841977	2160	-	0
AT5G53790	5	21843500	21845261	1761	+	0
AT5G53800	5	21848134	21850111	1977	+	352
AT5G53810	5	21850178	21853011	2833	-	16
AT5G53815	5	21851783	21852218	435	+	21
AT5G53820	5	21853396	21854117	721	+	4
AT5G53830	5	21857049	21857984	935	+	95
AT5G53840	5	21859147	21860672	1525	-	0
AT5G53850	5	21860996	21864973	3977	-	2348
AT5G53860	5	21865267	21868948	3681	+	1756
AT5G53870	5	21869863	21871284	1421	-	41
AT5G53880	5	21872793	21873303	510	-	598
AT5G53890	5	21876860	21880461	3601	+	261
AT5G53895	5	21880618	21881204	586	+	5
AT5G53900	5	21881141	21883416	2275	-	531
AT5G53902	5	21887965	21888667	702	+	1
AT5G53905	5	21888147	21889254	1107	-	0
AT5G53910	5	21890642	21891335	693	+	0
AT5G53920	5	21892123	21894267	2144	+	76
AT5G53930	5	21894231	21896427	2196	-	310
AT5G53940	5	21896994	21898610	1616	-	491
AT5G53950	5	21901965	21903823	1858	-	7
AT5G53960	5	21907637	21908666	1029	+	0
AT5G53970	5	21910532	21912777	2245	+	1177
AT5G53980	5	21914044	21914749	705	+	1
AT5G53990	5	21915549	21917149	1600	-	0
AT5G54000	5	21917775	21919064	1289	-	0
AT5G54010	5	21919780	21921189	1409	-	0
AT5G54020	5	21921863	21923534	1671	-	1
AT5G54030	5	21925983	21927243	1260	-	0
AT5G54040	5	21928846	21930637	1791	-	0
AT5G54045	5	21932252	21933067	815	-	0
AT5G54050	5	21933622	21935995	2373	-	0
AT5G54060	5	21936878	21938369	1491	-	164
AT5G54062	5	21938792	21939623	831	+	0
AT5G54064	5	21940179	21941679	1500	+	47
AT5G54067	5	21941601	21942146	545	-	0
AT5G54070	5	21943982	21945651	1669	+	0
AT5G54075	5	21945348	21945709	361	-	0
AT5G54080	5	21945868	21948913	3045	+	357
AT5G54090	5	21948123	21952550	4427	-	255
AT5G54095	5	21952732	21953507	775	-	0
AT5G54100	5	21953786	21956564	2778	-	191
AT5G54110	5	21958213	21960601	2388	+	871
AT5G54130	5	21962599	21965604	3005	+	1343
AT5G54140	5	21965832	21968061	2229	+	54
AT5G54145	5	21972464	21973083	619	+	164
AT5G54148	5	21975784	21977104	1320	-	8
AT5G54150	5	21977460	21978237	777	-	0
AT5G54160	5	21981995	21984363	2368	+	4080
AT5G54165	5	21984568	21984964	396	+	2
AT5G54170	5	21984877	21987208	2331	-	853
AT5G54180	5	21988456	21990228	1772	+	386
AT5G54190	5	21990911	21992812	1901	-	32
AT5G54200	5	21993348	21997076	3728	-	328
AT5G54203	5	22002218	22006640	4422	-	0
AT5G54206	5	22006902	22008432	1530	+	0
AT5G54210	5	22008611	22009532	921	+	0
AT5G54215	5	22010062	22010410	348	+	0
AT5G54220	5	22011348	22011796	448	+	0
AT5G54225	5	22013877	22014321	444	+	0
AT5G54230	5	22016249	22017933	1684	-	5
AT5G54240	5	22022977	22024461	1484	-	35
AT5G54250	5	22025285	22030099	4814	-	999
AT5G54260	5	22032068	22037991	5923	+	163
AT5G54270	5	22038272	22039568	1296	+	234390
AT5G54280	5	22039382	22046298	6916	-	564
AT5G54290	5	22051033	22054028	2995	+	2332
AT5G54300	5	22053968	22055430	1462	-	294
AT5G54310	5	22057051	22061270	4219	-	1420
AT5G54320	5	22062804	22063914	1110	+	0
AT5G54330	5	22064992	22066063	1071	+	0
AT5G54340	5	22066830	22067565	735	+	0
AT5G54350	5	22070134	22071347	1213	+	0
AT5G54360	5	22071861	22072674	813	+	0
AT5G54365	5	22074405	22074478	73	+	0
AT5G54370	5	22075282	22076777	1495	+	1
AT5G54375	5	22076861	22076934	73	+	0
AT5G54380	5	22077091	22079880	2789	-	638
AT5G54390	5	22085997	22088017	2020	+	1575
AT5G54400	5	22090532	22092126	1594	+	20
AT5G54410	5	22094246	22094906	660	-	0
AT5G54420	5	22095803	22096079	276	+	0
AT5G54430	5	22097165	22099758	2593	-	1009
AT5G54440	5	22099935	22107833	7898	+	1243
AT5G54450	5	22108272	22109379	1107	-	0
AT5G54460	5	22110424	22110949	525	-	0
AT5G54470	5	22114303	22115472	1169	-	192
AT5G54480	5	22118003	22120166	2163	+	0
AT5G54490	5	22121403	22121931	528	+	35
AT5G54500	5	22124510	22126504	1994	+	872
AT5G54510	5	22131092	22133678	2586	-	711
AT5G54520	5	22146513	22149120	2607	-	110
AT5G54530	5	22152724	22154429	1705	+	173
AT5G54531	5	22154729	22154894	165	+	0
AT5G54540	5	22156497	22158054	1557	+	2387
AT5G54550	5	22158400	22159560	1160	+	0
AT5G54560	5	22161133	22162216	1083	+	0
AT5G54569	5	22167348	22170538	3190	+	19
AT5G54570	5	22167635	22170235	2600	-	20
AT5G54580	5	22171215	22172977	1762	+	423
AT5G54585	5	22175538	22176691	1153	+	506
AT5G54590	5	22179752	22182826	3074	+	351
AT5G54600	5	22182977	22184567	1590	+	9564
AT5G54610	5	22184778	22186525	1747	-	873
AT5G54620	5	22187760	22189746	1986	-	0
AT5G54630	5	22192498	22194308	1810	-	918
AT5G54640	5	22196476	22197492	1016	+	589
AT5G54650	5	22197628	22202110	4482	-	155
AT5G54660	5	22203904	22205152	1248	+	447
AT5G54661	5	22205309	22205758	449	+	0
AT5G54670	5	22209471	22214134	4663	+	376
AT5G54680	5	22217054	22219274	2220	+	2237
AT5G54690	5	22219223	22221840	2617	-	58
AT5G54700	5	22223095	22225509	2414	-	0
AT5G54710	5	22227573	22230500	2927	-	307
AT5G54720	5	22232194	22232949	755	-	87
AT5G54730	5	22233788	22237341	3553	-	460
AT5G54740	5	22238357	22239187	830	-	0
AT5G54745	5	22240255	22241233	978	-	0
AT5G54750	5	22241480	22243721	2241	+	566
AT5G54760	5	22243799	22245770	1971	+	2031
AT5G54770	5	22246591	22248332	1741	+	84101
AT5G54780	5	22248446	22251863	3417	-	213
AT5G54790	5	22253985	22255663	1678	-	0
AT5G54800	5	22261270	22263921	2651	+	721
AT5G54810	5	22264593	22266785	2192	-	1996
AT5G54820	5	22269858	22271777	1919	+	0
AT5G54830	5	22273069	22276301	3232	+	341
AT5G54840	5	22276512	22278423	1911	-	207
AT5G54850	5	22280582	22282352	1770	-	49
AT5G54855	5	22282766	22284387	1621	+	344
AT5G54860	5	22284580	22287206	2626	+	150
AT5G54865	5	22287625	22287697	72	-	0
AT5G54870	5	22289134	22291799	2665	+	849
AT5G54880	5	22291885	22293300	1415	+	95
AT5G54890	5	22293324	22295144	1820	+	124
AT5G54900	5	22295382	22298346	2964	+	1127
AT5G54910	5	22298556	22301719	3163	-	258
AT5G54920	5	22302000	22305795	3795	+	276
AT5G54930	5	22305732	22307564	1832	-	92
AT5G54940	5	22308270	22309410	1140	-	3689
AT5G54950	5	22309831	22310242	411	-	1
AT5G54960	5	22310686	22312761	2075	-	353
AT5G54970	5	22313209	22313764	555	+	198
AT5G54980	5	22315698	22316601	903	+	259
AT5G54990	5	22317504	22318185	681	+	2
AT5G55000	5	22318309	22321750	3441	+	296
AT5G55010	5	22321899	22322229	330	+	50
AT5G55020	5	22324598	22326248	1650	-	0
AT5G55040	5	22327194	22331813	4619	-	991
AT5G55045	5	22338671	22338744	73	-	1
AT5G55050	5	22337700	22340100	2400	+	324
AT5G55055	5	22340500	22340573	73	-	0
AT5G55056	5	22340982	22341111	129	+	0
AT5G55060	5	22341951	22346577	4626	+	416
AT5G55070	5	22347210	22350817	3607	+	1899
AT5G55080	5	22351575	22353058	1483	-	0
AT5G55090	5	22356851	22358198	1347	-	16
AT5G55100	5	22361101	22364780	3679	-	985
AT5G55110	5	22367869	22368361	492	+	0
AT5G55120	5	22369094	22371867	2773	+	869
AT5G55125	5	22372019	22373209	1190	+	203
AT5G55130	5	22373167	22376086	2919	-	383
AT5G55131	5	22376582	22376989	407	+	0
AT5G55132	5	22378905	22379548	643	+	0
AT5G55135	5	22379920	22380386	466	+	0
AT5G55140	5	22380995	22382028	1033	+	252
AT5G55150	5	22382274	22383392	1118	-	1
AT5G55160	5	22383559	22384925	1366	-	1433
AT5G55170	5	22385306	22386114	808	-	15
AT5G55180	5	22388781	22390714	1933	+	620
AT5G55190	5	22392175	22394172	1997	+	2107
AT5G55200	5	22394606	22396572	1966	+	204
AT5G55210	5	22396425	22397446	1021	-	475
AT5G55220	5	22397615	22400842	3227	+	5104
AT5G55230	5	22401996	22405492	3496	+	1807
AT5G55240	5	22405925	22407351	1426	+	0
AT5G55250	5	22407472	22410944	3472	-	50
AT5G55260	5	22416598	22418864	2266	+	448
AT5G55270	5	22419156	22420410	1254	+	4
AT5G55280	5	22420651	22422649	1998	-	1613
AT5G55290	5	22422886	22424317	1431	-	365
AT5G55300	5	22424576	22429502	4926	-	1351
AT5G55310	5	22430175	22435076	4901	-	982
AT5G55320	5	22435679	22436699	1020	-	0
AT5G55330	5	22437824	22438865	1041	-	2
AT5G55340	5	22439850	22441005	1155	-	37
AT5G55350	5	22442355	22443393	1038	-	1
AT5G55360	5	22443723	22444752	1029	-	0
AT5G55370	5	22445084	22446116	1032	-	2
AT5G55380	5	22446623	22447898	1275	-	171
AT5G55390	5	22447965	22454802	6837	-	1166
AT5G55400	5	22455534	22458950	3416	-	457
AT5G55410	5	22460549	22461309	760	+	0
AT5G55420	5	22461839	22462156	317	+	0
AT5G55430	5	22464588	22465218	630	+	0
AT5G55440	5	22465692	22467209	1517	+	0
AT5G55450	5	22467429	22468263	834	+	268
AT5G55460	5	22468686	22469304	618	+	41
AT5G55470	5	22469244	22472706	3462	-	64
AT5G55480	5	22474229	22478132	3903	+	736
AT5G55490	5	22478711	22481148	2437	-	33
AT5G55500	5	22482159	22484631	2472	+	457
AT5G55505	5	22484769	22484842	73	-	0
AT5G55507	5	22485098	22485712	614	-	1
AT5G55508	5	22485871	22486015	144	+	0
AT5G55510	5	22486425	22488015	1590	-	327
AT5G55520	5	22488073	22491266	3193	-	229
AT5G55530	5	22492939	22495956	3017	+	587
AT5G55540	5	22496195	22500543	4348	-	806
AT5G55550	5	22501534	22504052	2518	-	377
AT5G55560	5	22506301	22507879	1578	-	37
AT5G55565	5	22510016	22513588	3572	-	0
AT5G55570	5	22514474	22515458	984	-	313
AT5G55580	5	22515439	22517929	2490	+	431
AT5G55590	5	22519910	22521858	1948	+	6
AT5G55600	5	22521842	22525645	3803	-	792
AT5G55610	5	22525806	22528110	2304	+	505
AT5G55620	5	22530201	22530939	738	+	1407
AT5G55630	5	22531357	22533122	1765	+	650
AT5G55640	5	22533158	22534117	959	-	287
AT5G55650	5	22536359	22536824	465	+	0
AT5G55660	5	22538612	22543474	4862	+	1787
AT5G55670	5	22543939	22546801	2862	-	637
AT5G55680	5	22547734	22548361	627	-	15
AT5G55690	5	22548789	22549623	834	-	0
AT5G55700	5	22551746	22554964	3218	+	327
AT5G55710	5	22554877	22555650	773	-	1508
AT5G55720	5	22556046	22557725	1679	+	33
AT5G55730	5	22558147	22560461	2314	-	1407
AT5G55740	5	22561940	22564433	2493	-	842
AT5G55750	5	22564800	22566021	1221	-	0
AT5G55760	5	22567221	22570963	3742	+	159
AT5G55770	5	22571644	22573732	2088	+	0
AT5G55780	5	22576610	22578668	2058	+	0
AT5G55790	5	22580669	22581335	666	-	312
AT5G55800	5	22581693	22583430	1737	+	0
AT5G55810	5	22583984	22586347	2363	-	109
AT5G55820	5	22586286	22594035	7749	+	302
AT5G55830	5	22594654	22596843	2189	+	49
AT5G55835	5	22597011	22597117	106	-	0
AT5G55840	5	22598037	22602566	4529	+	279
AT5G55850	5	22603371	22605268	1897	+	716
AT5G55855	5	22606253	22606491	238	+	0
AT5G55856	5	22607926	22608640	714	+	0
AT5G55860	5	22609531	22612393	2862	+	340
AT5G55870	5	22612636	22613311	675	-	0
AT5G55875	5	22613518	22617994	4476	-	0
AT5G55880	5	22619103	22620204	1101	-	0
AT5G55890	5	22622736	22623837	1101	-	0
AT5G55893	5	22624737	22625892	1155	-	1
AT5G55896	5	22628016	22633342	5326	-	837
AT5G55900	5	22637530	22639761	2231	+	81
AT5G55910	5	22639843	22642354	2511	-	1596
AT5G55920	5	22645482	22649447	3965	-	603
AT5G55930	5	22652714	22656106	3392	+	167
AT5G55940	5	22655997	22658048	2051	-	591
AT5G55950	5	22658111	22660434	2323	-	73
AT5G55960	5	22662575	22665087	2512	+	1236
AT5G55970	5	22667234	22669545	2311	+	145
AT5G55980	5	22670300	22670642	342	+	0
AT5G55990	5	22671451	22673855	2404	+	547
AT5G56000	5	22677450	22680152	2702	-	507
AT5G56010	5	22681304	22684129	2825	+	3983
AT5G56020	5	22684404	22686369	1965	+	194
AT5G56030	5	22686801	22689650	2849	+	3934
AT5G56040	5	22694877	22698628	3751	+	650
AT5G56050	5	22700961	22702116	1155	-	11
AT5G56060	5	22704007	22704892	885	+	1
AT5G56061	5	22705279	22705701	422	-	0
AT5G56070	5	22708678	22709204	526	+	0
AT5G56075	5	22709755	22710809	1054	+	0
AT5G56080	5	22711401	22712364	963	-	0
AT5G56090	5	22714517	22716835	2318	+	200
AT5G56100	5	22717114	22717751	637	+	221
AT5G56110	5	22719190	22720664	1474	+	0
AT5G56120	5	22721372	22722613	1241	+	294
AT5G56130	5	22722481	22725095	2614	-	356
AT5G56140	5	22725368	22728343	2975	+	783
AT5G56150	5	22729175	22731187	2012	+	587
AT5G56160	5	22731973	22735590	3617	+	104
AT5G56170	5	22735914	22737311	1397	+	909
AT5G56180	5	22737324	22741031	3707	-	437
AT5G56190	5	22742004	22745177	3173	+	478
AT5G56200	5	22747767	22749249	1482	+	0
AT5G56210	5	22750554	22752732	2178	-	467
AT5G56220	5	22754817	22757920	3103	+	119
AT5G56230	5	22758767	22759371	604	-	8
AT5G56240	5	22759802	22764587	4785	-	845
AT5G56250	5	22768576	22772896	4320	-	763
AT5G56260	5	22775324	22777304	1980	-	1032
AT5G56270	5	22779692	22783268	3576	+	269
AT5G56280	5	22783383	22785577	2194	-	524
AT5G56290	5	22786505	22792161	5656	+	1662
AT5G56300	5	22799506	22801692	2186	+	0
AT5G56310	5	22802315	22804377	2062	+	32
AT5G56320	5	22808640	22810237	1597	+	41
AT5G56325	5	22812212	22813263	1051	+	0
AT5G56330	5	22813767	22816162	2395	+	0
AT5G56340	5	22817559	22819657	2098	+	395
AT5G56350	5	22820005	22822766	2761	-	1100
AT5G56360	5	22823301	22828025	4724	-	1011
AT5G56365	5	22828130	22828204	74	+	0
AT5G56367	5	22830445	22833244	2799	+	0
AT5G56368	5	22833963	22834645	682	+	0
AT5G56369	5	22835445	22835823	378	+	0
AT5G56370	5	22835981	22837941	1960	-	51
AT5G56380	5	22838671	22841015	2344	-	550
AT5G56390	5	22842789	22844273	1484	-	0
AT5G56400	5	22846068	22847615	1547	-	0
AT5G56410	5	22848507	22850331	1824	-	0
AT5G56420	5	22850583	22852740	2157	-	153
AT5G56430	5	22853322	22854575	1253	-	0
AT5G56440	5	22855741	22857117	1376	-	0
AT5G56450	5	22858508	22860062	1554	-	126
AT5G56452	5	22860449	22861818	1369	-	0
AT5G56460	5	22865109	22867996	2887	+	167
AT5G56470	5	22869059	22869958	899	+	0
AT5G56480	5	22870325	22870817	492	-	0
AT5G56490	5	22871462	22873444	1982	+	51
AT5G56500	5	22873790	22877402	3612	+	615
AT5G56510	5	22881720	22883842	2122	+	0
AT5G56520	5	22885191	22886541	1350	+	228
AT5G56530	5	22889131	22891853	2722	+	503
AT5G56540	5	22893150	22893642	492	+	18
AT5G56544	5	22894501	22895791	1290	+	1
AT5G56550	5	22895615	22896653	1038	-	54
AT5G56560	5	22899723	22901985	2262	+	0
AT5G56570	5	22902735	22904596	1861	+	0
AT5G56580	5	22904688	22906661	1973	-	110
AT5G56590	5	22907318	22909559	2241	+	316
AT5G56600	5	22909684	22910821	1137	-	1136
AT5G56605	5	22915290	22916027	737	+	0
AT5G56610	5	22916709	22918338	1629	+	93
AT5G56620	5	22918520	22921139	2619	-	4
AT5G56630	5	22923921	22926963	3042	+	616
AT5G56640	5	22927328	22929643	2315	-	0
AT5G56650	5	22930824	22932778	1954	+	679
AT5G56660	5	22933266	22935316	2050	+	299
AT5G56670	5	22935210	22936060	850	-	1878
AT5G56680	5	22936542	22939036	2494	+	993
AT5G56690	5	22939722	22941099	1377	+	0
AT5G56700	5	22941793	22943378	1585	+	11
AT5G56710	5	22943830	22944971	1141	-	3467
AT5G56720	5	22945536	22946718	1182	+	54
AT5G56730	5	22946905	22952576	5671	-	460
AT5G56740	5	22952795	22955664	2869	-	437
AT5G56745	5	22955840	22955912	72	+	0
AT5G56747	5	22956285	22957213	928	+	117
AT5G56750	5	22957876	22960916	3040	+	370
AT5G56760	5	22961308	22962660	1352	-	997
AT5G56770	5	22962993	22963989	996	-	0
AT5G56780	5	22964264	22966241	1977	-	140
AT5G56790	5	22967938	22971536	3598	+	434
AT5G56795	5	22972041	22972449	408	-	5
AT5G56800	5	22972988	22974308	1320	+	0
AT5G56810	5	22974519	22975992	1473	+	35
AT5G56820	5	22976333	22977838	1505	+	0
AT5G56830	5	22978330	22979059	729	+	0
AT5G56840	5	22980692	22982342	1650	+	284
AT5G56850	5	22985192	22988013	2821	-	3419
AT5G56860	5	22989264	22991467	2203	-	1308
AT5G56865	5	22997961	22998126	165	-	0
AT5G56870	5	23004195	23008649	4454	+	120
AT5G56880	5	23009097	23009709	612	-	2
AT5G56890	5	23010522	23015671	5149	-	1299
AT5G56900	5	23019325	23022670	3345	-	697
AT5G56910	5	23022921	23024205	1284	+	294
AT5G56920	5	23024895	23025915	1020	+	0
AT5G56930	5	23027891	23030565	2674	-	204
AT5G56940	5	23030785	23032411	1626	+	341
AT5G56950	5	23032448	23035661	3213	+	541
AT5G56960	5	23038702	23041174	2472	-	1
AT5G56970	5	23044943	23048268	3325	-	4
AT5G56975	5	23054770	23054844	74	-	0
AT5G56980	5	23056079	23057742	1663	-	374
AT5G56990	5	23060871	23062311	1440	-	81
AT5G57000	5	23063714	23065350	1636	-	157
AT5G57010	5	23068036	23070412	2376	+	13
AT5G57015	5	23071096	23074843	3747	+	627
AT5G57020	5	23074866	23076901	2035	+	1098
AT5G57030	5	23077264	23080053	2789	+	4281
AT5G57035	5	23080660	23083988	3328	+	333
AT5G57040	5	23083897	23085246	1349	-	4433
AT5G57050	5	23087234	23089627	2393	+	440
AT5G57060	5	23090151	23091988	1837	+	171
AT5G57070	5	23096173	23098451	2278	+	164
AT5G57080	5	23098958	23099368	410	+	17
AT5G57090	5	23100692	23104735	4043	+	4
AT5G57100	5	23106301	23108795	2494	-	216
AT5G57110	5	23109437	23117563	8126	-	253
AT5G57120	5	23122539	23124513	1974	-	616
AT5G57123	5	23126921	23127654	733	-	22
AT5G57126	5	23135524	23139406	3882	-	0
AT5G57130	5	23144979	23149568	4589	+	422
AT5G57140	5	23149879	23151370	1491	+	160
AT5G57150	5	23152173	23155066	2893	+	282
AT5G57160	5	23154964	23161746	6782	-	354
AT5G57170	5	23162070	23163280	1210	-	533
AT5G57180	5	23167841	23170999	3158	+	1463
AT5G57181	5	23171061	23171160	99	+	0
AT5G57190	5	23171530	23175364	3834	-	133
AT5G57200	5	23177695	23180601	2906	+	0
AT5G57210	5	23180832	23183811	2979	-	408
AT5G57220	5	23187839	23189857	2018	+	29
AT5G57230	5	23189993	23191617	1624	+	55
AT5G57240	5	23193162	23195476	2314	+	28
AT5G57250	5	23194832	23198524	3692	-	275
AT5G57260	5	23198636	23200318	1682	-	0
AT5G57270	5	23200613	23203792	3179	-	575
AT5G57280	5	23204460	23206659	2199	+	163
AT5G57290	5	23206801	23207926	1125	-	2568
AT5G57300	5	23208476	23211139	2663	-	424
AT5G57310	5	23211029	23211620	591	+	3
AT5G57320	5	23212689	23217549	4860	+	48
AT5G57330	5	23218213	23221089	2876	+	1595
AT5G57340	5	23226085	23229282	3197	+	186
AT5G57345	5	23229406	23230638	1232	-	6509
AT5G57350	5	23230878	23236572	5694	-	8983
AT5G57360	5	23241426	23244590	3164	+	1074
AT5G57370	5	23244733	23246420	1687	+	270
AT5G57380	5	23246394	23249504	3110	-	0
AT5G57390	5	23253458	23256450	2992	-	99
AT5G57391	5	23257064	23257184	120	+	0
AT5G57400	5	23261984	23263457	1473	-	0
AT5G57410	5	23264313	23267883	3570	-	180
AT5G57420	5	23270023	23270990	967	+	0
AT5G57440	5	23271126	23272929	1803	-	609
AT5G57450	5	23273092	23274976	1884	-	10
AT5G57460	5	23275168	23277488	2320	+	922
AT5G57480	5	23279405	23280968	1563	-	14
AT5G57490	5	23283679	23285934	2255	-	1000
AT5G57500	5	23286236	23287571	1335	-	9
AT5G57510	5	23289163	23289556	393	-	0
AT5G57520	5	23295963	23296683	720	+	6
AT5G57530	5	23300320	23301605	1285	-	0
AT5G57535	5	23302414	23302549	135	-	0
AT5G57540	5	23302995	23304049	1054	-	0
AT5G57550	5	23304887	23306421	1534	-	2
AT5G57560	5	23307129	23308282	1153	-	224
AT5G57565	5	23310283	23311564	1281	+	183
AT5G57567	5	23312044	23312399	355	-	5
AT5G57570	5	23313435	23314415	980	-	26
AT5G57580	5	23314715	23318125	3410	-	931
AT5G57590	5	23318507	23322770	4263	-	228
AT5G57610	5	23324790	23329347	4557	+	1267
AT5G57620	5	23334816	23336566	1750	+	2
AT5G57625	5	23337849	23338807	958	+	0
AT5G57630	5	23340846	23343258	2412	-	251
AT5G57640	5	23344625	23345594	969	+	3
AT5G57650	5	23345796	23346285	489	-	1
AT5G57655	5	23346759	23350039	3280	+	901
AT5G57660	5	23355463	23356989	1526	+	3329
AT5G57670	5	23360399	23363757	3358	-	15
AT5G57685	5	23366003	23366867	864	-	127
AT5G57690	5	23372062	23374469	2407	-	5
AT5G57700	5	23374873	23377142	2269	+	351
AT5G57710	5	23384793	23388353	3560	+	2462
AT5G57720	5	23389744	23391620	1876	-	0
AT5G57730	5	23393381	23393510	129	-	0
AT5G57735	5	23394004	23394500	496	+	2
AT5G57740	5	23394584	23397650	3066	-	237
AT5G57747	5	23399102	23399219	117	+	0
AT5G57750	5	23399667	23400300	633	+	0
AT5G57760	5	23400714	23401267	553	+	0
AT5G57770	5	23400863	23403130	2267	-	0
AT5G57780	5	23405323	23406351	1028	-	269
AT5G57785	5	23408895	23409422	527	-	153
AT5G57790	5	23412024	23413627	1603	-	148
AT5G57800	5	23420208	23424052	3844	+	1746
AT5G57810	5	23424269	23425647	1378	-	10
AT5G57815	5	23426667	23427856	1189	+	685
AT5G57820	5	23428600	23429346	746	+	4
AT5G57830	5	23429290	23430996	1706	-	78
AT5G57840	5	23432803	23435232	2429	-	74
AT5G57850	5	23435290	23437327	2037	-	1025
AT5G57860	5	23437596	23439312	1716	+	282
AT5G57870	5	23439497	23443781	4284	+	2856
AT5G57880	5	23443976	23447244	3268	+	92
AT5G57885	5	23445993	23446065	72	+	2
AT5G57887	5	23446720	23447249	529	+	15
AT5G57890	5	23447406	23449679	2273	-	140
AT5G57900	5	23449710	23450933	1223	-	274
AT5G57910	5	23451148	23452614	1466	-	117
AT5G57920	5	23453598	23454397	799	+	2
AT5G57930	5	23454603	23456493	1890	+	4103
AT5G57940	5	23456564	23460613	4049	+	1254
AT5G57950	5	23460708	23462388	1680	+	199
AT5G57960	5	23462769	23466503	3734	-	1269
AT5G57970	5	23466717	23469015	2298	+	152
AT5G57980	5	23469049	23469768	719	-	1
AT5G57990	5	23470013	23474104	4091	-	1448
AT5G58000	5	23477410	23479598	2188	+	253
AT5G58003	5	23479803	23482048	2245	+	256
AT5G58005	5	23482186	23483165	979	+	402
AT5G58010	5	23483544	23484889	1345	-	0
AT5G58020	5	23485499	23486818	1319	+	773
AT5G58030	5	23486776	23488620	1844	-	536
AT5G58040	5	23488747	23494000	5253	+	1132
AT5G58050	5	23494248	23497581	3333	-	1
AT5G58060	5	23498138	23500384	2246	+	939
AT5G58070	5	23500060	23501209	1149	-	2433
AT5G58080	5	23501784	23504143	2359	-	0
AT5G58090	5	23505365	23507288	1923	-	577
AT5G58100	5	23507653	23515020	7367	+	1272
AT5G58110	5	23515155	23516639	1484	+	892
AT5G58120	5	23517491	23521067	3576	+	474
AT5G58130	5	23521048	23523797	2749	-	499
AT5G58140	5	23524426	23533111	8685	+	9957
AT5G58150	5	23530080	23532840	2760	-	0
AT5G58160	5	23533700	23539465	5765	+	352
AT5G58170	5	23540048	23543345	3297	-	0
AT5G58180	5	23544010	23545760	1750	+	0
AT5G58190	5	23546328	23549605	3277	+	226
AT5G58200	5	23549549	23552052	2503	+	1128
AT5G58210	5	23552093	23554402	2309	+	155
AT5G58220	5	23554385	23555883	1498	-	555
AT5G58230	5	23556011	23558245	2234	+	529
AT5G58240	5	23558113	23559353	1240	-	447
AT5G58250	5	23559473	23560513	1040	+	3228
AT5G58260	5	23560875	23561944	1069	-	2682
AT5G58270	5	23562141	23567190	5049	+	1121
AT5G58280	5	23567337	23568670	1333	+	12
AT5G58290	5	23569061	23571340	2279	+	1652
AT5G58300	5	23571878	23575084	3206	+	482
AT5G58310	5	23574991	23576084	1093	-	901
AT5G58320	5	23577438	23579786	2348	+	230
AT5G58330	5	23579721	23582395	2674	-	13786
AT5G58340	5	23582494	23585148	2654	+	331
AT5G58350	5	23584788	23587801	3013	+	823
AT5G58360	5	23590078	23590969	891	-	16
AT5G58370	5	23593116	23596026	2910	+	309
AT5G58375	5	23596271	23596960	689	+	310
AT5G58380	5	23596961	23599242	2281	-	437
AT5G58390	5	23599566	23601325	1759	-	182
AT5G58400	5	23605201	23607028	1827	-	1
AT5G58410	5	23609662	23617386	7724	+	895
AT5G58412	5	23618108	23618345	237	+	0
AT5G58420	5	23619505	23621094	1589	+	2589
AT5G58430	5	23621182	23623444	2262	-	788
AT5G58440	5	23623857	23626787	2930	-	707
AT5G58450	5	23626825	23632223	5398	+	807
AT5G58460	5	23632360	23635037	2677	-	0
AT5G58465	5	23636946	23637066	120	+	0
AT5G58470	5	23637706	23640920	3214	-	757
AT5G58480	5	23641141	23642853	1712	-	269
AT5G58490	5	23643017	23644598	1581	+	1086
AT5G58495	5	23644710	23644792	82	+	0
AT5G58500	5	23645534	23646083	549	-	20
AT5G58510	5	23648152	23654552	6400	-	604
AT5G58520	5	23655233	23658162	2929	+	336
AT5G58530	5	23660385	23661349	964	+	134
AT5G58540	5	23663135	23665317	2182	+	321
AT5G58550	5	23665181	23668474	3293	-	385
AT5G58560	5	23670394	23672877	2483	+	740
AT5G58570	5	23672694	23673287	593	-	36
AT5G58575	5	23673999	23675498	1499	+	139
AT5G58580	5	23676905	23677832	927	-	51
AT5G58590	5	23680078	23681798	1720	-	532
AT5G58595	5	23682879	23682963	84	-	0
AT5G58600	5	23683790	23685725	1935	-	99
AT5G58610	5	23686770	23691053	4283	-	12
AT5G58620	5	23693339	23696222	2883	+	226
AT5G58630	5	23696107	23697452	1345	-	6
AT5G58640	5	23697840	23699767	1927	+	426
AT5G58650	5	23699707	23700226	519	-	135
AT5G58660	5	23701466	23703988	2522	+	9
AT5G58670	5	23704230	23706800	2570	-	621
AT5G58680	5	23708111	23709351	1240	-	43
AT5G58690	5	23709528	23712131	2603	-	66
AT5G58700	5	23712999	23716098	3099	-	109
AT5G58710	5	23717774	23719765	1991	+	1165
AT5G58720	5	23719701	23723137	3436	-	903
AT5G58730	5	23723403	23725465	2062	-	220
AT5G58740	5	23725773	23727614	1841	-	709
AT5G58750	5	23728787	23730122	1335	+	0
AT5G58760	5	23730499	23733698	3199	-	240
AT5G58770	5	23734375	23735634	1259	+	1502
AT5G58780	5	23735628	23737335	1707	-	3
AT5G58782	5	23738146	23739468	1322	-	0
AT5G58784	5	23739949	23741279	1330	-	0
AT5G58787	5	23742449	23744619	2170	+	254
AT5G58790	5	23744875	23745981	1106	+	40
AT5G58800	5	23745882	23747274	1392	-	668
AT5G58810	5	23747961	23750853	2892	+	0
AT5G58820	5	23751955	23754773	2818	+	1
AT5G58830	5	23755774	23758684	2910	+	0
AT5G58840	5	23759002	23762059	3057	+	8
AT5G58850	5	23763944	23765441	1497	+	0
AT5G58860	5	23765813	23768049	2236	-	22
AT5G58870	5	23769810	23773780	3970	-	4532
AT5G58880	5	23775965	23779504	3539	+	0
AT5G58890	5	23780831	23781716	885	+	0
AT5G58900	5	23783122	23785334	2212	-	318
AT5G58910	5	23789521	23791681	2160	-	4
AT5G58920	5	23793128	23794245	1117	+	207
AT5G58930	5	23794314	23796461	2147	-	766
AT5G58940	5	23798561	23800823	2262	+	88
AT5G58950	5	23800927	23803673	2746	-	2855
AT5G58960	5	23805716	23808478	2762	+	949
AT5G58970	5	23808460	23811258	2798	-	394
AT5G58980	5	23811448	23814683	3235	-	434
AT5G58990	5	23814992	23816143	1151	+	317
AT5G59000	5	23818183	23820237	2054	+	126
AT5G59010	5	23820367	23823265	2898	-	169
AT5G59020	5	23826974	23830437	3463	-	121
AT5G59030	5	23833727	23834511	784	-	954
AT5G59040	5	23836685	23837259	574	+	0
AT5G59050	5	23839156	23842677	3521	-	476
AT5G59055	5	23844205	23844277	72	+	0
AT5G59060	5	23844300	23844777	477	-	1
AT5G59070	5	23845197	23847393	2196	+	38
AT5G59080	5	23847404	23848557	1153	-	595
AT5G59090	5	23851904	23855275	3371	-	0
AT5G59100	5	23858893	23862129	3236	-	0
AT5G59105	5	23862458	23863053	595	-	0
AT5G59110	5	23863529	23864048	519	-	0
AT5G59120	5	23864729	23868052	3323	-	0
AT5G59130	5	23870097	23873720	3623	-	1462
AT5G59140	5	23874410	23875695	1285	-	442
AT5G59150	5	23876585	23878429	1844	+	347
AT5G59160	5	23879336	23881688	2352	+	1124
AT5G59170	5	23881987	23883122	1135	+	1
AT5G59180	5	23883416	23885208	1792	+	259
AT5G59190	5	23885854	23888673	2819	+	2
AT5G59200	5	23888792	23890427	1635	-	7
AT5G59210	5	23890605	23893665	3060	-	461
AT5G59220	5	23894403	23896619	2216	-	113
AT5G59230	5	23901554	23902379	825	+	2
AT5G59240	5	23902464	23903733	1269	-	22
AT5G59250	5	23903891	23906977	3086	+	2408
AT5G59260	5	23907900	23909925	2025	-	3
AT5G59270	5	23911150	23913235	2085	-	0
AT5G59280	5	23914140	23915139	999	-	0
AT5G59290	5	23915529	23918192	2663	-	1306
AT5G59300	5	23919596	23921304	1708	-	647
AT5G59305	5	23923200	23923910	710	+	12
AT5G59310	5	23925084	23925852	768	-	27
AT5G59320	5	23928970	23929745	775	+	335
AT5G59330	5	23931317	23931889	572	+	46
AT5G59340	5	23933403	23934690	1287	-	26
AT5G59350	5	23940781	23942213	1432	+	622
AT5G59360	5	23945344	23946430	1086	-	25
AT5G59370	5	23949738	23951837	2099	+	4
AT5G59380	5	23952260	23953707	1447	+	101
AT5G59385	5	23953941	23954013	72	+	0
AT5G59390	5	23954933	23957151	2218	+	0
AT5G59395	5	23957429	23957501	72	+	0
AT5G59400	5	23957736	23959707	1971	+	428
AT5G59410	5	23959572	23960878	1306	-	196
AT5G59420	5	23961574	23964824	3250	+	1314
AT5G59430	5	23967312	23970945	3633	+	1125
AT5G59440	5	23971230	23972924	1694	+	221
AT5G59450	5	23974667	23976791	2124	+	324
AT5G59460	5	23976722	23978399	1677	-	183
AT5G59470	5	23978555	23979478	923	+	134
AT5G59480	5	23979389	23981590	2201	-	1079
AT5G59490	5	23982723	23984617	1894	-	1
AT5G59500	5	23985928	23987381	1453	+	807
AT5G59505	5	23988471	23988596	125	+	0
AT5G59510	5	23990073	23990696	623	+	3
AT5G59520	5	23991252	23992798	1546	-	5
AT5G59530	5	23994169	23995734	1565	-	0
AT5G59540	5	23996072	23997590	1518	-	1217
AT5G59550	5	23998258	23999793	1535	-	174
AT5G59560	5	24000555	24001957	1402	-	216
AT5G59570	5	24003887	24005512	1625	+	0
AT5G59580	5	24006078	24007689	1611	-	1
AT5G59590	5	24008982	24010649	1667	-	0
AT5G59600	5	24010999	24013025	2026	-	48
AT5G59610	5	24013164	24015071	1907	+	401
AT5G59613	5	24015393	24016610	1217	-	2484
AT5G59616	5	24017510	24018077	567	+	0
AT5G59620	5	24018935	24020605	1670	-	0
AT5G59630	5	24021432	24023925	2493	-	1
AT5G59640	5	24025991	24030772	4781	+	8
AT5G59650	5	24031345	24035100	3755	+	134
AT5G59660	5	24035686	24039979	4293	+	97
AT5G59662	5	24039141	24040411	1270	-	15
AT5G59670	5	24041493	24045652	4159	+	609
AT5G59680	5	24046791	24050801	4010	+	141
AT5G59690	5	24051551	24052143	592	+	1899
AT5G59700	5	24052384	24055425	3041	-	307
AT5G59710	5	24057406	24061918	4512	+	964
AT5G59720	5	24062576	24063277	701	+	54
AT5G59730	5	24063876	24066170	2294	-	257
AT5G59732	5	24064477	24066154	1677	+	0
AT5G59740	5	24070050	24073055	3005	-	57
AT5G59750	5	24073274	24075542	2268	+	1533
AT5G59760	5	24075627	24076512	885	-	3
AT5G59770	5	24079391	24081216	1825	-	963
AT5G59780	5	24082196	24083431	1235	-	694
AT5G59790	5	24090714	24093168	2454	+	145
AT5G59800	5	24094473	24096532	2059	-	208
AT5G59810	5	24096814	24100557	3743	-	0
AT5G59820	5	24102971	24103787	816	+	13
AT5G59830	5	24105077	24107233	2156	+	329
AT5G59840	5	24107214	24109251	2037	-	583
AT5G59845	5	24111323	24112020	697	+	27
AT5G59850	5	24112199	24113617	1418	-	1858
AT5G59860	5	24113461	24114449	988	+	3
AT5G59870	5	24115380	24116220	840	-	1761
AT5G59880	5	24120230	24121894	1664	+	4529
AT5G59890	5	24122411	24123912	1501	+	2586
AT5G59900	5	24123982	24126706	2724	-	113
AT5G59910	5	24127127	24127935	808	+	3947
AT5G59920	5	24128755	24130888	2133	+	418
AT5G59930	5	24134525	24136496	1971	+	0
AT5G59940	5	24137411	24139367	1956	+	1
AT5G59945	5	24139945	24140019	74	-	0
AT5G59950	5	24139938	24141867	1929	+	969
AT5G59960	5	24142013	24145333	3320	-	599
AT5G59970	5	24146174	24146726	552	-	666
AT5G59980	5	24147206	24149783	2577	+	92
AT5G59990	5	24150982	24153084	2102	-	44
AT5G60000	5	24159330	24159780	450	-	0
AT5G60010	5	24160455	24164755	4300	+	0
AT5G60020	5	24167995	24170462	2467	+	279
AT5G60022	5	24167140	24170261	3121	-	6
AT5G60030	5	24172081	24172975	894	-	216
AT5G60040	5	24173258	24183641	10383	+	211
AT5G60050	5	24183566	24185629	2063	-	201
AT5G60060	5	24188599	24189724	1125	-	0
AT5G60070	5	24190439	24192894	2455	-	0
AT5G60080	5	24193180	24194909	1729	-	0
AT5G60090	5	24196081	24197725	1644	-	0
AT5G60100	5	24197997	24201404	3407	-	3
AT5G60110	5	24201953	24202937	984	+	0
AT5G60120	5	24207688	24211743	4055	+	438
AT5G60130	5	24211870	24213164	1294	-	6
AT5G60140	5	24214076	24215453	1377	-	0
AT5G60142	5	24216179	24217691	1512	-	44
AT5G60150	5	24217981	24223366	5385	+	105
AT5G60160	5	24223715	24226883	3168	-	873
AT5G60170	5	24227414	24232873	5459	+	1936
AT5G60180	5	24233023	24234007	984	-	4
AT5G60190	5	24234540	24236163	1623	+	112
AT5G60200	5	24240974	24242523	1549	+	312
AT5G60210	5	24243030	24245968	2938	-	595
AT5G60220	5	24248956	24250065	1109	+	12
AT5G60230	5	24250090	24251613	1523	-	77
AT5G60240	5	24251381	24251628	247	+	0
AT5G60250	5	24252157	24254849	2692	+	24
AT5G60260	5	24255433	24256285	852	-	15
AT5G60270	5	24257744	24260043	2299	+	119
AT5G60280	5	24260562	24262536	1974	+	119
AT5G60285	5	24262579	24262660	81	+	1
AT5G60290	5	24262863	24263843	980	+	28
AT5G60300	5	24264621	24268029	3408	+	308
AT5G60310	5	24268010	24269982	1972	+	5
AT5G60320	5	24270807	24272835	2028	+	1
AT5G60330	5	24273127	24273634	507	-	4
AT5G60335	5	24273878	24274551	673	-	10
AT5G60340	5	24274961	24276055	1094	-	790
AT5G60350	5	24277729	24279147	1418	+	0
AT5G60360	5	24279896	24282397	2501	+	10723
AT5G60370	5	24282837	24285033	2196	+	311
AT5G60380	5	24285919	24287808	1889	+	0
AT5G60390	5	24288657	24291020	2363	+	22461
AT5G60400	5	24291139	24292162	1023	-	492
AT5G60408	5	24293092	24293298	206	+	1
AT5G60410	5	24294889	24301147	6258	+	2005
AT5G60430	5	24301607	24303068	1461	+	52
AT5G60440	5	24306293	24307716	1423	+	18
AT5G60450	5	24308321	24312698	4377	-	1041
AT5G60460	5	24317436	24317935	499	-	178
AT5G60470	5	24320594	24322790	2196	+	13
AT5G60480	5	24323593	24324169	576	+	0
AT5G60490	5	24325726	24326702	976	-	98
AT5G60500	5	24328756	24329785	1029	+	0
AT5G60510	5	24330337	24331768	1431	+	0
AT5G60520	5	24331669	24333045	1376	-	0
AT5G60530	5	24333906	24335782	1876	-	0
AT5G60540	5	24336622	24338802	2180	-	354
AT5G60548	5	24339228	24342590	3362	+	0
AT5G60550	5	24339228	24342590	3362	+	0
AT5G60553	5	24343204	24343444	240	+	0
AT5G60560	5	24345948	24347172	1224	+	0
AT5G60570	5	24347927	24350117	2190	+	767
AT5G60580	5	24353823	24356962	3139	+	306
AT5G60590	5	24357020	24358750	1730	+	139
AT5G60600	5	24358965	24363485	4520	+	17449
AT5G60610	5	24363590	24365528	1938	+	20
AT5G60615	5	24365952	24366319	367	-	0
AT5G60620	5	24367197	24369790	2593	+	716
AT5G60630	5	24369649	24370404	755	-	12
AT5G60640	5	24371006	24374038	3032	-	2292
AT5G60650	5	24374191	24374798	607	-	23
AT5G60660	5	24375456	24376989	1533	-	67
AT5G60670	5	24380909	24381593	684	-	1012
AT5G60680	5	24386144	24386976	832	+	627
AT5G60690	5	24397022	24402195	5173	+	924
AT5G60700	5	24402128	24404948	2820	-	296
AT5G60710	5	24410717	24415068	4351	-	543
AT5G60720	5	24418228	24422234	4006	-	77
AT5G60730	5	24422734	24425492	2758	+	11
AT5G60740	5	24425809	24430269	4460	-	0
AT5G60750	5	24430890	24433360	2470	+	571
AT5G60760	5	24438270	24442287	4017	+	22
AT5G60770	5	24444395	24447026	2631	+	0
AT5G60780	5	24450838	24452756	1918	+	25
AT5G60790	5	24453257	24455970	2713	-	1895
AT5G60800	5	24460782	24462541	1759	-	266
AT5G60805	5	24465059	24465487	428	-	0
AT5G60810	5	24466530	24467179	649	-	0
AT5G60820	5	24469586	24470895	1309	+	125
AT5G60830	5	24472638	24473319	681	+	2
AT5G60840	5	24473318	24474491	1173	-	470
AT5G60850	5	24480448	24481873	1425	+	859
AT5G60860	5	24484621	24485705	1084	+	326
AT5G60870	5	24485654	24487824	2170	-	83
AT5G60880	5	24488288	24489778	1490	-	90
AT5G60890	5	24494690	24496351	1661	+	1273
AT5G60900	5	24498466	24501494	3028	-	219
AT5G60910	5	24502481	24506143	3662	-	20
AT5G60920	5	24511195	24514129	2934	-	3434
AT5G60930	5	24515397	24522511	7114	-	490
AT5G60940	5	24522977	24525812	2835	+	432
AT5G60945	5	24526297	24526636	339	+	0
AT5G60950	5	24526846	24528084	1238	-	71
AT5G60960	5	24528249	24530011	1762	-	725
AT5G60963	5	24530175	24530248	73	+	0
AT5G60964	5	24530585	24530924	339	+	0
AT5G60966	5	24531666	24531738	72	+	0
AT5G60970	5	24535569	24537047	1478	-	262
AT5G60978	5	24542498	24542855	357	+	1
AT5G60980	5	24543359	24546269	2910	+	1180
AT5G60990	5	24546429	24549339	2910	-	382
AT5G61000	5	24549577	24552723	3146	-	479
AT5G61010	5	24553840	24556749	2909	+	819
AT5G61020	5	24557200	24559879	2679	-	1417
AT5G61030	5	24560450	24562306	1856	+	324
AT5G61040	5	24562332	24564959	2627	-	294
AT5G61050	5	24565481	24566615	1134	-	0
AT5G61060	5	24566782	24571066	4284	-	652
AT5G61070	5	24571170	24574372	3202	-	42
AT5G61090	5	24574901	24577714	2813	-	8
AT5G61100	5	24579169	24580327	1158	-	2
AT5G61110	5	24581077	24582130	1053	-	0
AT5G61120	5	24582302	24585806	3504	-	11
AT5G61130	5	24587212	24589580	2368	-	1181
AT5G61140	5	24589905	24603514	13609	+	1698
AT5G61150	5	24603655	24607725	4070	-	1116
AT5G61160	5	24608723	24610304	1581	+	3
AT5G61170	5	24611085	24612427	1342	+	2641
AT5G61180	5	24612866	24614174	1308	+	0
AT5G61190	5	24615316	24620053	4737	+	449
AT5G61200	5	24620215	24622666	2451	+	132
AT5G61210	5	24623298	24625631	2333	+	918
AT5G61220	5	24625572	24626923	1351	-	272
AT5G61228	5	24627186	24628968	1782	+	0
AT5G61230	5	24627186	24628968	1782	+	0
AT5G61240	5	24629255	24632211	2956	+	1025
AT5G61250	5	24632153	24635303	3150	-	129
AT5G61260	5	24637108	24638599	1491	+	29
AT5G61270	5	24638772	24640600	1828	-	1230
AT5G61280	5	24643624	24644910	1286	-	20
AT5G61290	5	24648557	24650815	2258	+	94
AT5G61300	5	24650703	24652776	2073	-	122
AT5G61310	5	24653351	24654869	1518	-	173
AT5G61320	5	24655097	24656638	1541	-	0
AT5G61330	5	24657147	24661021	3874	-	576
AT5G61340	5	24662003	24663117	1114	-	305
AT5G61345	5	24667281	24667353	72	+	0
AT5G61350	5	24667972	24670501	2529	+	78
AT5G61360	5	24671013	24671868	855	+	20
AT5G61370	5	24671769	24673657	1888	-	27
AT5G61380	5	24675063	24678550	3487	+	235
AT5G61390	5	24678661	24680944	2283	-	109
AT5G61400	5	24681549	24683514	1965	+	33
AT5G61410	5	24683605	24686105	2500	-	23431
AT5G61412	5	24686754	24687042	288	-	17
AT5G61420	5	24689150	24691095	1945	-	3597
AT5G61430	5	24701121	24702761	1640	-	9
AT5G61440	5	24707499	24708893	1394	+	54
AT5G61445	5	24709665	24709738	73	+	0
AT5G61450	5	24710032	24712945	2913	-	361
AT5G61455	5	24713263	24714094	831	-	2
AT5G61460	5	24714075	24721940	7865	-	265
AT5G61470	5	24722869	24723983	1114	+	0
AT5G61480	5	24724540	24727842	3302	-	901
AT5G61490	5	24732641	24733666	1025	+	4
AT5G61495	5	24732767	24733485	718	-	0
AT5G61500	5	24733784	24736853	3069	-	794
AT5G61510	5	24736944	24738998	2054	-	846
AT5G61520	5	24739025	24741273	2248	-	243
AT5G61530	5	24742047	24744784	2737	+	598
AT5G61540	5	24744946	24747524	2578	+	202
AT5G61550	5	24748101	24751871	3770	+	6
AT5G61560	5	24752849	24756718	3869	+	160
AT5G61570	5	24758346	24760652	2306	+	246
AT5G61580	5	24761078	24764014	2936	+	777
AT5G61590	5	24764437	24765324	887	-	351
AT5G61600	5	24766385	24767430	1045	-	42
AT5G61605	5	24768381	24769010	629	-	0
AT5G61610	5	24770098	24771252	1154	+	7
AT5G61620	5	24772382	24773507	1125	+	0
AT5G61630	5	24773656	24774502	846	-	0
AT5G61640	5	24775034	24776390	1356	+	199
AT5G61650	5	24778245	24779098	853	+	5
AT5G61660	5	24779214	24779930	716	-	927
AT5G61670	5	24783503	24785945	2442	+	3505
AT5G61680	5	24786415	24788015	1600	-	2
AT5G61690	5	24789494	24793487	3993	-	1
AT5G61700	5	24793863	24797944	4081	+	0
AT5G61710	5	24799877	24800680	803	+	0
AT5G61720	5	24801553	24803169	1616	+	0
AT5G61730	5	24803582	24807898	4316	-	0
AT5G61740	5	24808483	24812597	4114	+	30
AT5G61750	5	24812803	24813436	633	-	2
AT5G61760	5	24813728	24815443	1715	-	428
AT5G61770	5	24815607	24817706	2099	+	279
AT5G61780	5	24821257	24826969	5712	+	2223
AT5G61790	5	24827101	24829791	2690	-	3402
AT5G61800	5	24829986	24831553	1567	-	14
AT5G61810	5	24831618	24833902	2284	-	640
AT5G61820	5	24834316	24836694	2378	-	1514
AT5G61830	5	24837156	24838970	1814	+	371
AT5G61835	5	24838979	24839016	37	+	0
AT5G61840	5	24839177	24841940	2763	-	521
AT5G61850	5	24844294	24846933	2639	+	2
AT5G61865	5	24847326	24849792	2466	+	46
AT5G61880	5	24850256	24851776	1520	+	116
AT5G61890	5	24852638	24853910	1272	-	3
AT5G61900	5	24855660	24859341	3681	-	2
AT5G61910	5	24855620	24864172	8552	-	382
AT5G61920	5	24864301	24866019	1718	+	36
AT5G61930	5	24865085	24867821	2736	-	117
AT5G61940	5	24868154	24872717	4563	+	21
AT5G61950	5	24873565	24878093	4528	+	132
AT5G61960	5	24878519	24884720	6201	-	1893
AT5G61970	5	24888616	24893328	4712	+	1014
AT5G61980	5	24894471	24899973	5502	+	68
AT5G61990	5	24899605	24903117	3512	-	233
AT5G61997	5	24908264	24908384	120	-	0
AT5G62000	5	24910357	24915210	4853	+	6889
AT5G62020	5	24916088	24917643	1555	+	200
AT5G62030	5	24918478	24920876	2398	+	328
AT5G62040	5	24922809	24923709	900	+	7
AT5G62050	5	24923773	24927314	3541	-	401
AT5G62060	5	24927687	24928698	1011	+	0
AT5G62065	5	24929206	24929647	441	+	0
AT5G62070	5	24929918	24932576	2658	-	535
AT5G62080	5	24933470	24934445	975	-	0
AT5G62090	5	24934962	24939109	4147	-	917
AT5G62100	5	24940395	24941974	1579	+	173
AT5G62110	5	24942168	24946081	3913	-	0
AT5G62120	5	24946954	24948225	1271	-	0
AT5G62130	5	24950263	24953232	2969	-	2827
AT5G62140	5	24954505	24955385	880	-	1365
AT5G62150	5	24958240	24958769	529	+	8
AT5G62160	5	24960106	24961263	1157	+	0
AT5G62162	5	24962484	24962598	114	+	0
AT5G62165	5	24964699	24968520	3821	+	8
AT5G62170	5	24972976	24975549	2573	-	225
AT5G62180	5	24978843	24979849	1006	-	79
AT5G62190	5	24980267	24983973	3706	-	1874
AT5G62200	5	24984235	24985711	1476	-	255
AT5G62210	5	24986326	24987489	1163	-	353
AT5G62220	5	24988455	24990009	1554	-	911
AT5G62230	5	24996128	25002340	6212	+	126
AT5G62240	5	25002357	25004766	2409	-	5
AT5G62250	5	25005755	25008096	2341	+	8
AT5G62260	5	25009026	25011588	2562	+	17
AT5G62270	5	25011978	25014578	2600	+	377
AT5G62280	5	25017072	25018246	1174	+	37
AT5G62290	5	25019486	25021131	1645	+	193
AT5G62300	5	25021199	25022436	1237	-	2470
AT5G62310	5	25023354	25028414	5060	+	1
AT5G62320	5	25028715	25029933	1218	-	2
AT5G62330	5	25031600	25032204	604	+	0
AT5G62340	5	25033517	25034404	887	+	0
AT5G62350	5	25037425	25038362	937	+	1685
AT5G62360	5	25040648	25041462	814	+	16
AT5G62370	5	25041900	25044849	2949	-	35
AT5G62380	5	25050683	25051858	1175	+	32
AT5G62390	5	25051977	25054289	2312	-	2529
AT5G62400	5	25054613	25055606	993	-	3
AT5G62410	5	25056261	25062625	6364	+	521
AT5G62420	5	25064834	25066111	1277	+	5
AT5G62430	5	25069092	25070934	1842	-	1374
AT5G62440	5	25072467	25073991	1524	-	302
AT5G62460	5	25074882	25077294	2412	+	510
AT5G62470	5	25078990	25081101	2111	-	362
AT5G62480	5	25088693	25089620	927	-	6
AT5G62490	5	25090129	25091559	1430	+	2
AT5G62500	5	25092640	25095244	2604	+	178
AT5G62510	5	25095372	25096635	1263	-	0
AT5G62520	5	25097997	25099907	1910	+	3
AT5G62530	5	25099002	25103298	4296	-	1325
AT5G62540	5	25103933	25105619	1686	+	510
AT5G62550	5	25105575	25107951	2376	-	352
AT5G62560	5	25109990	25112001	2011	+	273
AT5G62570	5	25114319	25117295	2976	+	712
AT5G62575	5	25117487	25118892	1405	+	290
AT5G62576	5	25118899	25119103	204	+	0
AT5G62580	5	25119862	25122526	2664	+	500
AT5G62600	5	25123050	25132676	9626	-	555
AT5G62610	5	25132898	25134788	1890	-	647
AT5G62620	5	25136750	25139946	3196	+	210
AT5G62623	5	25140726	25141262	536	+	0
AT5G62627	5	25142310	25142902	592	+	0
AT5G62630	5	25143594	25146459	2865	-	531
AT5G62640	5	25149432	25152541	3109	-	514
AT5G62650	5	25152624	25155935	3311	-	610
AT5G62660	5	25156325	25157465	1140	-	0
AT5G62670	5	25159229	25165209	5980	+	2068
AT5G62680	5	25165136	25167943	2807	-	1249
AT5G62690	5	25181414	25183729	2315	+	2887
AT5G62700	5	25184396	25186711	2315	+	3109
AT5G62710	5	25187302	25190600	3298	+	275
AT5G62720	5	25191841	25195009	3168	+	655
AT5G62730	5	25197493	25200033	2540	+	61
AT5G62740	5	25200946	25202756	1810	+	496
AT5G62750	5	25203448	25204117	669	-	0
AT5G62760	5	25204471	25209571	5100	-	231
AT5G62770	5	25210494	25211607	1113	+	31
AT5G62780	5	25213385	25214137	752	+	1
AT5G62790	5	25214124	25217439	3315	-	7219
AT5G62800	5	25218662	25219967	1305	+	0
AT5G62810	5	25220146	25223789	3643	+	2166
AT5G62820	5	25223726	25225021	1295	-	47
AT5G62830	5	25226167	25226782	615	-	1
AT5G62840	5	25228224	25229683	1459	-	608
AT5G62848	5	25230567	25230667	100	-	0
AT5G62850	5	25229937	25231527	1590	-	18
AT5G62860	5	25232631	25233541	910	+	0
AT5G62865	5	25234063	25234849	786	+	36
AT5G62880	5	25237133	25239174	2041	+	405
AT5G62890	5	25243250	25247377	4127	+	2610
AT5G62900	5	25248796	25249942	1146	+	75
AT5G62910	5	25250255	25252236	1981	+	273
AT5G62920	5	25252385	25254212	1827	-	277
AT5G62930	5	25254887	25256617	1730	+	455
AT5G62940	5	25256918	25258681	1763	-	157
AT5G62950	5	25262178	25263901	1723	-	255
AT5G62960	5	25269281	25271641	2360	+	198
AT5G62970	5	25272032	25273537	1505	+	0
AT5G62980	5	25276033	25277266	1233	+	312
AT5G62990	5	25277437	25279312	1875	+	49
AT5G62998	5	25279881	25279995	114	-	1
AT5G63000	5	25280011	25281537	1526	-	241
AT5G63010	5	25281713	25283176	1463	+	67
AT5G63020	5	25283062	25286002	2940	-	768
AT5G63030	5	25286222	25287694	1472	+	558
AT5G63040	5	25288145	25290420	2275	+	538
AT5G63050	5	25292434	25295020	2586	+	901
AT5G63060	5	25294953	25296849	1896	-	559
AT5G63063	5	25297419	25297650	231	+	0
AT5G63065	5	25297708	25297900	192	+	0
AT5G63070	5	25299177	25299660	483	-	1
AT5G63080	5	25299934	25302444	2510	-	269
AT5G63085	5	25302813	25303315	502	+	0
AT5G63087	5	25304802	25305198	396	+	13
AT5G63090	5	25308571	25310973	2402	-	43
AT5G63100	5	25314136	25315428	1292	-	254
AT5G63110	5	25315623	25318347	2724	-	485
AT5G63120	5	25318751	25322265	3514	-	349
AT5G63130	5	25323101	25324272	1171	+	32
AT5G63135	5	25324978	25326479	1501	-	190
AT5G63140	5	25328118	25329799	1681	+	122
AT5G63145	5	25330035	25330107	72	+	0
AT5G63150	5	25330188	25330844	656	+	372
AT5G63160	5	25333262	25335485	2223	-	298
AT5G63168	5	25338057	25338195	138	-	0
AT5G63170	5	25338698	25340096	1398	-	0
AT5G63180	5	25340953	25343119	2166	-	1923
AT5G63190	5	25345541	25348796	3255	+	448
AT5G63195	5	25346728	25348386	1658	-	1
AT5G63200	5	25349010	25353039	4029	+	449
AT5G63220	5	25353033	25355500	2467	-	407
AT5G63225	5	25356132	25356740	608	-	1
AT5G63230	5	25357359	25357822	463	-	0
AT5G63240	5	25358967	25359565	598	-	0
AT5G63250	5	25360120	25360689	569	-	0
AT5G63260	5	25361746	25364769	3023	+	320
AT5G63270	5	25365497	25365949	452	-	0
AT5G63280	5	25367030	25369297	2267	+	256
AT5G63290	5	25369244	25370921	1677	-	56
AT5G63300	5	25371107	25372017	910	+	7
AT5G63310	5	25371903	25373861	1958	-	3720
AT5G63320	5	25374412	25379297	4885	-	1206
AT5G63340	5	25378893	25379674	781	+	0
AT5G63350	5	25379999	25381183	1184	-	7
AT5G63370	5	25383905	25387252	3347	-	1716
AT5G63380	5	25387410	25390063	2653	-	905
AT5G63390	5	25390511	25392591	2080	-	12
AT5G63400	5	25393000	25394907	1907	-	2043
AT5G63410	5	25394983	25398153	3170	-	948
AT5G63420	5	25400385	25405968	5583	+	473
AT5G63440	5	25406301	25408423	2122	+	253
AT5G63450	5	25408894	25410573	1679	-	6
AT5G63460	5	25413355	25415592	2237	-	413
AT5G63470	5	25415700	25417117	1417	-	748
AT5G63480	5	25417264	25418635	1371	+	104
AT5G63490	5	25418593	25422184	3591	-	517
AT5G63500	5	25423406	25423791	385	+	124
AT5G63510	5	25423966	25425871	1905	+	1108
AT5G63520	5	25426176	25429112	2936	-	358
AT5G63530	5	25433153	25435834	2681	+	2860
AT5G63540	5	25440782	25444438	3656	-	47
AT5G63550	5	25444671	25448172	3501	+	564
AT5G63560	5	25449480	25451414	1934	+	11
AT5G63570	5	25451874	25453841	1967	+	3501
AT5G63580	5	25454729	25456476	1747	+	15
AT5G63590	5	25456992	25458470	1478	-	32
AT5G63595	5	25459086	25460436	1350	-	1
AT5G63600	5	25460683	25462458	1775	-	2
AT5G63610	5	25463436	25465897	2461	-	402
AT5G63620	5	25466127	25468433	2306	-	492
AT5G63630	5	25472597	25476511	3914	-	150
AT5G63640	5	25477677	25481489	3812	+	483
AT5G63650	5	25481516	25483719	2203	-	71
AT5G63660	5	25485691	25486062	371	+	0
AT5G63670	5	25487926	25489428	1502	+	734
AT5G63680	5	25490072	25492752	2680	+	572
AT5G63690	5	25492863	25493283	420	-	21
AT5G63700	5	25493716	25497632	3916	-	726
AT5G63710	5	25499413	25502798	3385	+	764
AT5G63715	5	25504812	25504902	90	+	0
AT5G63720	5	25506348	25508017	1669	+	1
AT5G63730	5	25508099	25509706	1607	-	0
AT5G63740	5	25510775	25511456	681	-	0
AT5G63750	5	25512993	25514941	1948	-	2
AT5G63760	5	25515877	25517833	1956	-	184
AT5G63770	5	25518640	25523621	4981	+	381
AT5G63780	5	25523844	25526593	2749	+	1969
AT5G63790	5	25526508	25528013	1505	-	314
AT5G63800	5	25530054	25535849	5795	+	3384
AT5G63810	5	25537073	25541529	4456	+	259
AT5G63820	5	25541575	25542893	1318	+	7
AT5G63830	5	25543549	25544802	1253	-	87
AT5G63840	5	25545055	25549199	4144	+	2021
AT5G63850	5	25551054	25553520	2466	+	1261
AT5G63860	5	25554507	25559499	4992	-	2193
AT5G63870	5	25561159	25563274	2115	-	650
AT5G63880	5	25563723	25565498	1775	+	107
AT5G63890	5	25565430	25568206	2776	-	1777
AT5G63900	5	25568697	25570371	1674	+	2
AT5G63905	5	25570857	25571586	729	-	72
AT5G63910	5	25571864	25574087	2223	-	562
AT5G63920	5	25574418	25581377	6959	+	227
AT5G63930	5	25583005	25586499	3494	+	277
AT5G63940	5	25588074	25591458	3384	+	613
AT5G63941	5	25591553	25591740	187	+	0
AT5G63950	5	25591955	25598505	6550	-	355
AT5G63952	5	25598792	25598945	153	+	0
AT5G63960	5	25599513	25606841	7328	+	364
AT5G63970	5	25606770	25609247	2477	-	63
AT5G63980	5	25609811	25611933	2122	+	1806
AT5G63990	5	25613257	25615880	2623	+	111
AT5G64000	5	25616637	25618631	1994	+	113
AT5G64010	5	25618605	25620179	1574	-	135
AT5G64020	5	25620307	25622573	2266	-	334
AT5G64030	5	25624036	25628559	4523	+	1497
AT5G64040	5	25628587	25629615	1028	-	73826
AT5G64050	5	25629854	25633209	3355	-	1894
AT5G64060	5	25633535	25635781	2246	-	39
AT5G64070	5	25636975	25644446	7471	-	1957
AT5G64080	5	25645262	25646735	1473	-	269
AT5G64090	5	25648012	25649620	1608	+	387
AT5G64100	5	25650640	25652123	1483	-	0
AT5G64110	5	25654073	25656030	1957	-	91
AT5G64120	5	25659305	25661002	1697	-	56
AT5G64130	5	25664349	25666244	1895	-	1434
AT5G64140	5	25667323	25668292	969	-	1145
AT5G64150	5	25668830	25671218	2388	-	201
AT5G64160	5	25670929	25672463	1534	+	146
AT5G64170	5	25672465	25676746	4281	-	4201
AT5G64180	5	25677079	25678357	1278	+	457
AT5G64190	5	25679431	25681265	1834	+	10
AT5G64200	5	25681201	25683641	2440	-	730
AT5G64210	5	25683964	25685664	1700	-	0
AT5G64220	5	25686207	25692250	6043	+	690
AT5G64230	5	25692452	25694053	1601	+	174
AT5G64240	5	25695619	25697416	1797	+	1355
AT5G64250	5	25697353	25699212	1859	-	682
AT5G64260	5	25703928	25705316	1388	+	475
AT5G64270	5	25706658	25710925	4267	+	2005
AT5G64280	5	25711068	25713473	2405	-	881
AT5G64290	5	25714177	25716758	2581	-	4879
AT5G64300	5	25718403	25721162	2759	+	1520
AT5G64310	5	25721932	25722646	714	+	322
AT5G64320	5	25723242	25725451	2209	-	108
AT5G64330	5	25727336	25730361	3025	+	956
AT5G64340	5	25730334	25733313	2979	-	0
AT5G64341	5	25730334	25733313	2979	-	0
AT5G64342	5	25730334	25733313	2979	-	0
AT5G64343	5	25730334	25733313	2979	-	0
AT5G64350	5	25734597	25736071	1474	-	2572
AT5G64360	5	25736339	25738667	2328	-	394
AT5G64370	5	25739177	25741212	2035	+	831
AT5G64380	5	25741248	25743198	1950	+	597
AT5G64390	5	25743343	25747652	4309	+	586
AT5G64395	5	25748201	25748297	96	-	18
AT5G64400	5	25748839	25750389	1550	+	3482
AT5G64401	5	25750440	25750602	162	-	4
AT5G64410	5	25750844	25755052	4208	-	525
AT5G64420	5	25756331	25761341	5010	+	658
AT5G64430	5	25762269	25764154	1885	-	446
AT5G64440	5	25765749	25770500	4751	+	826
AT5G64450	5	25771948	25772761	813	+	3
AT5G64460	5	25772848	25775568	2720	-	2370
AT5G64470	5	25775975	25777963	1988	+	293
AT5G64480	5	25778168	25778922	754	+	426
AT5G64490	5	25779309	25780308	999	-	15
AT5G64500	5	25780381	25783654	3273	+	1057
AT5G64501	5	25783801	25783999	198	-	0
AT5G64505	5	25784114	25784188	74	+	0
AT5G64510	5	25784403	25786307	1904	+	73
AT5G64520	5	25788033	25790364	2331	+	112
AT5G64530	5	25795232	25796938	1706	+	84
AT5G64540	5	25798696	25801302	2606	-	0
AT5G64541	5	25801313	25801451	138	+	0
AT5G64550	5	25801527	25804980	3453	-	0
AT5G64552	5	25801527	25804980	3453	-	0
AT5G64560	5	25806768	25809641	2873	-	250
AT5G64570	5	25810114	25813335	3221	-	296
AT5G64572	5	25810297	25811733	1436	+	1
AT5G64580	5	25817091	25821530	4439	-	1988
AT5G64590	5	25822331	25823201	870	-	0
AT5G64600	5	25825166	25828185	3019	+	265
AT5G64610	5	25828159	25830524	2365	-	618
AT5G64620	5	25831833	25832502	669	+	445
AT5G64630	5	25833173	25836384	3211	+	165
AT5G64640	5	25836726	25839199	2473	+	174
AT5G64650	5	25839359	25840809	1450	-	167
AT5G64660	5	25841912	25843452	1540	-	81
AT5G64667	5	25850655	25851337	682	+	28
AT5G64670	5	25852266	25853989	1723	-	514
AT5G64680	5	25854139	25855484	1345	+	139
AT5G64685	5	25855346	25857377	2031	-	12
AT5G64690	5	25862868	25864778	1910	+	8
AT5G64700	5	25865171	25866927	1756	-	67
AT5G64710	5	25869259	25872229	2970	+	22
AT5G64720	5	25872345	25872813	468	-	0
AT5G64730	5	25873111	25875267	2156	+	201
AT5G64735	5	25875393	25875465	72	-	0
AT5G64740	5	25881065	25886694	5629	+	6286
AT5G64750	5	25891505	25893888	2383	+	4
AT5G64760	5	25893779	25896582	2803	-	388
AT5G64770	5	25897366	25898124	758	-	2470
AT5G64780	5	25900558	25902127	1569	-	171
AT5G64790	5	25902640	25904701	2061	+	7
AT5G64800	5	25906082	25906403	321	+	19
AT5G64810	5	25908412	25909803	1391	+	6
AT5G64813	5	25910278	25912896	2618	+	556
AT5G64816	5	25912999	25914027	1028	+	233
AT5G64820	5	25913998	25914523	525	-	0
AT5G64830	5	25914637	25916624	1987	-	359
AT5G64840	5	25916722	25919810	3088	-	19579
AT5G64850	5	25921408	25923358	1950	+	849
AT5G64855	5	25925065	25925146	81	+	1
AT5G64860	5	25925172	25928848	3676	-	872
AT5G64870	5	25929537	25931384	1847	-	35
AT5G64880	5	25932289	25934156	1867	+	168
AT5G64890	5	25934567	25935521	954	+	0
AT5G64900	5	25937169	25938093	924	+	36
AT5G64905	5	25939573	25940059	486	+	0
AT5G64910	5	25940710	25944114	3404	+	68
AT5G64920	5	25943887	25945442	1555	-	690
AT5G64930	5	25945711	25948341	2630	-	373
AT5G64940	5	25948972	25953823	4851	+	18696
AT5G64950	5	25953843	25955160	1317	+	47
AT5G64960	5	25955380	25958995	3615	+	915
AT5G64970	5	25958024	25960644	2620	-	77
AT5G64980	5	25960774	25963235	2461	-	97
AT5G64990	5	25963400	25964838	1438	-	14
AT5G65000	5	25964959	25967393	2434	-	252
AT5G65005	5	25967823	25968638	815	+	0
AT5G65010	5	25969188	25972575	3387	+	2398
AT5G65015	5	25972677	25972750	73	+	0
AT5G65020	5	25973814	25975726	1912	+	796
AT5G65030	5	25975696	25976305	609	-	9
AT5G65040	5	25977620	25978417	797	-	18
AT5G65050	5	25982253	25986326	4073	+	575
AT5G65060	5	25987428	25991315	3887	+	219
AT5G65070	5	25992242	25996174	3932	+	126
AT5G65080	5	25997503	26002465	4962	+	219
AT5G65090	5	26004016	26006851	2835	+	15
AT5G65100	5	26006834	26008508	1674	-	0
AT5G65110	5	26009634	26012519	2885	-	811
AT5G65120	5	26012832	26014640	1808	+	127
AT5G65130	5	26017402	26018236	834	+	2
AT5G65140	5	26019587	26022222	2635	-	174
AT5G65158	5	26030099	26031003	904	+	0
AT5G65160	5	26031183	26033889	2706	-	11
AT5G65165	5	26034421	26035927	1506	-	2
AT5G65166	5	26036290	26036494	204	-	0
AT5G65170	5	26041173	26042406	1233	+	37
AT5G65180	5	26045360	26048031	2671	+	221
AT5G65200	5	26048064	26049952	1888	-	93
AT5G65205	5	26050809	26052034	1225	-	84
AT5G65207	5	26052244	26052644	400	-	109
AT5G65210	5	26057622	26061104	3482	+	301
AT5G65220	5	26061228	26062682	1454	+	9745
AT5G65230	5	26068289	26069652	1363	+	24
AT5G65240	5	26074401	26078254	3853	-	276
AT5G65250	5	26078532	26080198	1666	-	464
AT5G65260	5	26080230	26083017	2787	-	816
AT5G65270	5	26083327	26084714	1387	+	502
AT5G65274	5	26085299	26085960	661	+	1
AT5G65280	5	26085972	26088153	2181	-	73
AT5G65290	5	26089555	26094548	4993	+	296
AT5G65300	5	26095146	26095771	625	-	5
AT5G65305	5	26097529	26097567	38	-	0
AT5G65310	5	26101938	26104614	2676	-	1640
AT5G65320	5	26107168	26108726	1558	-	22
AT5G65330	5	26110325	26111351	1026	+	0
AT5G65340	5	26113397	26114489	1092	-	9
AT5G65350	5	26119210	26119825	615	-	40
AT5G65360	5	26119858	26120581	723	-	1779
AT5G65370	5	26121707	26122749	1042	+	0
AT5G65380	5	26122988	26126439	3451	-	1716
AT5G65390	5	26128583	26129338	755	-	83
AT5G65400	5	26131425	26133259	1834	+	210
AT5G65410	5	26136093	26137183	1090	+	546
AT5G65420	5	26141469	26143993	2524	-	56
AT5G65430	5	26148200	26150476	2276	-	2201
AT5G65440	5	26151420	26157099	5679	+	1057
AT5G65445	5	26157188	26157270	82	-	0
AT5G65450	5	26157862	26161096	3234	+	194
AT5G65460	5	26161830	26169001	7171	-	1154
AT5G65470	5	26172130	26175033	2903	+	1456
AT5G65480	5	26176020	26177917	1897	+	2175
AT5G65490	5	26177799	26180316	2517	-	434
AT5G65495	5	26180469	26181069	600	+	106
AT5G65500	5	26181092	26183997	2905	-	1
AT5G65510	5	26185828	26189413	3585	+	21
AT5G65520	5	26189724	26190591	867	-	120
AT5G65530	5	26190591	26193106	2515	-	40
AT5G65533	5	26194667	26194874	207	-	0
AT5G65535	5	26195458	26195531	73	+	0
AT5G65540	5	26195688	26198322	2634	+	290
AT5G65550	5	26198303	26199827	1524	-	8
AT5G65560	5	26200013	26203778	3765	-	169
AT5G65570	5	26203967	26206184	2217	+	39
AT5G65575	5	26206844	26207913	1069	-	81
AT5G65580	5	26207653	26207962	309	+	1
AT5G65590	5	26211745	26213136	1391	-	68
AT5G65600	5	26216125	26218153	2028	-	5
AT5G65609	5	26219162	26219345	183	-	3
AT5G65610	5	26219257	26221028	1771	+	136
AT5G65615	5	26221633	26221707	74	-	0
AT5G65620	5	26221931	26225903	3972	+	4131
AT5G65630	5	26225831	26228449	2618	-	1151
AT5G65640	5	26237054	26239084	2030	+	140
AT5G65650	5	26239501	26241515	2014	+	189
AT5G65660	5	26245248	26246379	1131	-	267
AT5G65670	5	26253657	26256468	2811	+	3625
AT5G65676	5	26258458	26259916	1458	+	0
AT5G65683	5	26261319	26263783	2464	+	664
AT5G65685	5	26273131	26275919	2788	-	1069
AT5G65687	5	26269855	26272899	3044	-	288
AT5G65690	5	26266339	26269616	3277	+	0
AT5G65700	5	26281710	26285413	3703	+	2325
AT5G65710	5	26292371	26295440	3069	+	246
AT5G65720	5	26296252	26298072	1820	+	1583
AT5G65730	5	26299031	26300478	1447	+	2699
AT5G65740	5	26301492	26303471	1979	-	279
AT5G65750	5	26303692	26308189	4497	+	864
AT5G65760	5	26308252	26311025	2773	+	565
AT5G65770	5	26311310	26316025	4715	+	0
AT5G65780	5	26311310	26318812	7502	+	1175
AT5G65790	5	26322947	26324578	1631	+	2
AT5G65800	5	26330745	26332812	2067	-	5
AT5G65810	5	26337664	26339746	2082	-	656
AT5G65820	5	26339875	26341789	1914	-	214
AT5G65830	5	26342115	26343321	1206	-	191
AT5G65840	5	26343729	26346082	2353	-	2929
AT5G65850	5	26346313	26347610	1297	+	23
AT5G65860	5	26347592	26349056	1464	-	273
AT5G65870	5	26351507	26352269	762	+	122
AT5G65880	5	26352994	26353761	767	+	122
AT5G65890	5	26354852	26357866	3014	+	607
AT5G65900	5	26358205	26361443	3238	+	415
AT5G65910	5	26361439	26363460	2021	-	830
AT5G65920	5	26364014	26365998	1984	-	122
AT5G65925	5	26369044	26369751	707	+	31
AT5G65930	5	26369856	26376520	6664	-	1052
AT5G65940	5	26376609	26379235	2626	-	1047
AT5G65950	5	26380122	26385221	5099	+	1235
AT5G65960	5	26385347	26387447	2100	+	662
AT5G65970	5	26387427	26390452	3025	-	60
AT5G65980	5	26392443	26394232	1789	+	0
AT5G65990	5	26394881	26396513	1632	+	674
AT5G66000	5	26396466	26397500	1034	-	81
AT5G66005	5	26397671	26399274	1603	-	257
AT5G66010	5	26399431	26400999	1568	+	232
AT5G66020	5	26401192	26404691	3499	-	1
AT5G66030	5	26404893	26410255	5362	-	1306
AT5G66040	5	26410519	26411355	836	+	2692
AT5G66045	5	26411593	26411657	64	-	0
AT5G66050	5	26412087	26414536	2449	-	456
AT5G66052	5	26416125	26416924	799	+	239
AT5G66053	5	26416660	26416807	147	-	0
AT5G66055	5	26417155	26419264	2109	-	1582
AT5G66060	5	26419480	26421594	2114	+	404
AT5G66070	5	26421854	26423240	1386	+	91
AT5G66080	5	26423418	26425406	1988	-	72
AT5G66090	5	26425735	26427172	1437	+	729
AT5G66100	5	26427488	26430006	2518	+	465
AT5G66110	5	26430201	26430912	711	+	7
AT5G66120	5	26431375	26433778	2403	-	2562
AT5G66130	5	26434063	26437222	3159	+	88
AT5G66140	5	26437169	26438764	1595	-	745
AT5G66150	5	26439012	26444434	5422	-	5
AT5G66160	5	26445085	26447433	2348	+	440
AT5G66170	5	26447641	26448776	1135	+	148
AT5G66180	5	26448937	26451154	2217	+	235
AT5G66190	5	26450963	26453199	2236	-	34941
AT5G66200	5	26453459	26455822	2363	-	796
AT5G66210	5	26456284	26459631	3347	-	357
AT5G66211	5	26459719	26459830	111	-	0
AT5G66220	5	26461176	26462174	998	+	0
AT5G66230	5	26461151	26464131	2980	+	286
AT5G66240	5	26466171	26468448	2277	+	1105
AT5G66250	5	26468532	26470556	2024	+	474
AT5G66260	5	26471268	26471658	390	+	0
AT5G66270	5	26473232	26475783	2551	-	84
AT5G66280	5	26476165	26477754	1589	+	34
AT5G66290	5	26477660	26479441	1781	-	197
AT5G66300	5	26479792	26481334	1542	-	44
AT5G66310	5	26485684	26491382	5698	-	504
AT5G66320	5	26495954	26497855	1901	-	376
AT5G66330	5	26500401	26501955	1554	-	105
AT5G66340	5	26502501	26503153	652	+	0
AT5G66350	5	26504466	26506569	2103	-	51
AT5G66360	5	26510228	26511802	1574	+	157
AT5G66370	5	26512199	26512824	625	-	0
AT5G66380	5	26513523	26515695	2172	-	184
AT5G66390	5	26515915	26517391	1476	-	2
AT5G66400	5	26518276	26519242	966	-	439
AT5G66410	5	26519769	26521696	1927	+	383
AT5G66420	5	26521673	26525081	3408	-	1459
AT5G66430	5	26525409	26526799	1390	-	0
AT5G66440	5	26530234	26531097	863	-	112
AT5G66450	5	26534613	26536045	1432	+	315
AT5G66455	5	26535979	26538011	2032	-	61
AT5G66460	5	26538394	26541036	2642	-	274
AT5G66470	5	26541694	26544359	2665	-	1497
AT5G66480	5	26544540	26546986	2446	-	69
AT5G66490	5	26547226	26547768	542	-	211
AT5G66500	5	26547994	26549677	1683	-	21
AT5G66510	5	26549703	26551630	1927	-	1629
AT5G66520	5	26551878	26553741	1863	+	429
AT5G66530	5	26553743	26555859	2116	-	2072
AT5G66535	5	26556022	26556096	74	-	0
AT5G66540	5	26556332	26559427	3095	-	333
AT5G66550	5	26559583	26561216	1633	-	494
AT5G66558	5	26563963	26566774	2811	-	4
AT5G66560	5	26564187	26566853	2666	+	19
AT5G66562	5	26567369	26567453	84	+	1
AT5G66564	5	26567520	26567604	84	+	0
AT5G66567	5	26567659	26567731	72	+	2
AT5G66568	5	26568396	26568470	74	+	1
AT5G66570	5	26568652	26570278	1626	+	170863
AT5G66580	5	26572630	26573408	778	+	184
AT5G66590	5	26574180	26574874	694	+	555
AT5G66600	5	26574999	26578826	3827	-	175
AT5G66607	5	26583430	26583544	114	-	2
AT5G66610	5	26584773	26587869	3096	+	107
AT5G66620	5	26588584	26592006	3422	+	107
AT5G66630	5	26592647	26595922	3275	+	35
AT5G66631	5	26596206	26598192	1986	+	28
AT5G66640	5	26599383	26601949	2566	+	64
AT5G66650	5	26603002	26604376	1374	-	57
AT5G66658	5	26608315	26608866	551	+	27
AT5G66660	5	26609307	26610504	1197	-	1
AT5G66670	5	26611257	26612891	1634	-	0
AT5G66675	5	26615082	26616990	1908	-	386
AT5G66680	5	26617543	26620667	3124	-	1472
AT5G66690	5	26625079	26626793	1714	+	4
AT5G66700	5	26634319	26635885	1566	+	1
AT5G66710	5	26636608	26638794	2186	+	8
AT5G66720	5	26638789	26640816	2027	-	2017
AT5G66730	5	26641651	26644402	2751	-	1041
AT5G66740	5	26647113	26648558	1445	+	323
AT5G66750	5	26648950	26653073	4123	+	373
AT5G66755	5	26653269	26653341	72	-	0
AT5G66760	5	26653657	26657536	3879	+	2329
AT5G66770	5	26660599	26662894	2295	+	425
AT5G66780	5	26663572	26664403	831	+	2
AT5G66790	5	26665141	26667531	2390	+	65
AT5G66800	5	26671422	26672514	1092	+	30
AT5G66810	5	26672925	26676613	3688	+	623
AT5G66815	5	26677364	26677865	501	+	0
AT5G66816	5	26681494	26681800	306	+	0
AT5G66817	5	26682707	26682778	71	-	0
AT5G66820	5	26689055	26691114	2059	+	455
AT5G66830	5	26691303	26692488	1185	+	4
AT5G66840	5	26692921	26695296	2375	-	22
AT5G66850	5	26695606	26699324	3718	-	796
AT5G66860	5	26701051	26702569	1518	-	385
AT5G66870	5	26705861	26708676	2815	+	4
AT5G66880	5	26710554	26712971	2417	+	496
AT5G66890	5	26712943	26714383	1440	-	2
AT5G66900	5	26714763	26717788	3025	-	533
AT5G66910	5	26718231	26721256	3025	-	321
AT5G66920	5	26722822	26725626	2804	+	375
AT5G66930	5	26725838	26727758	1920	+	308
AT5G66940	5	26727988	26728666	678	-	24
AT5G66950	5	26732888	26736146	3258	+	436
AT5G66960	5	26736208	26739493	3285	-	46
AT5G66970	5	26740444	26741125	681	-	0
AT5G66980	5	26741562	26742826	1264	+	0
AT5G66985	5	26743278	26743808	530	+	0
AT5G66990	5	26744256	26745362	1106	-	0
AT5G67000	5	26746676	26747281	605	-	0
AT5G67010	5	26749057	26749616	559	-	0
AT5G67020	5	26749849	26751249	1400	+	18
AT5G67030	5	26753509	26757236	3727	-	25207
AT5G67040	5	26757895	26758475	580	-	0
AT5G67050	5	26759459	26761197	1738	-	13
AT5G67060	5	26766127	26767250	1123	+	0
AT5G67070	5	26768019	26768846	827	+	1254
AT5G67080	5	26772725	26773760	1035	+	1
AT5G67090	5	26774017	26776391	2374	-	14
AT5G67100	5	26776993	26785104	8111	+	494
AT5G67110	5	26785105	26786383	1278	-	52
AT5G67120	5	26787829	26789737	1908	-	0
AT5G67130	5	26791345	26793882	2537	+	738
AT5G67140	5	26793879	26795303	1424	-	299
AT5G67150	5	26795770	26797312	1542	-	484
AT5G67160	5	26797612	26799041	1429	-	189
AT5G67170	5	26799765	26802067	2302	+	170
AT5G67180	5	26801948	26804249	2301	-	389
AT5G67190	5	26809134	26809689	555	-	111
AT5G67200	5	26813724	26816566	2842	-	329
AT5G67210	5	26818948	26820157	1209	+	50
AT5G67220	5	26820120	26821964	1844	-	832
AT5G67230	5	26822477	26824328	1851	+	157
AT5G67240	5	26824235	26828171	3936	-	642
AT5G67245	5	26829162	26829662	500	-	19
AT5G67250	5	26831372	26833333	1961	-	635
AT5G67260	5	26836147	26837811	1664	+	1536
AT5G67265	5	26839468	26839836	368	-	4
AT5G67270	5	26840069	26842081	2012	-	194
AT5G67280	5	26842269	26845190	2921	-	1276
AT5G67290	5	26848147	26849846	1699	-	497
AT5G67300	5	26854021	26856006	1985	+	742
AT5G67310	5	26855215	26856941	1726	-	0
AT5G67320	5	26857153	26861119	3966	+	748
AT5G67330	5	26861726	26863897	2171	+	1004
AT5G67340	5	26864555	26867602	3047	+	82
AT5G67350	5	26868289	26869486	1197	-	180
AT5G67360	5	26871890	26874579	2689	-	3670
AT5G67370	5	26877552	26879542	1990	-	2891
AT5G67380	5	26880965	26883430	2465	-	956
AT5G67385	5	26884663	26887204	2541	+	3463
AT5G67390	5	26887669	26889238	1569	-	542
AT5G67400	5	26894855	26896488	1633	+	0
AT5G67410	5	26896599	26897463	864	-	14
AT5G67411	5	26898400	26899097	697	-	11
AT5G67420	5	26904288	26906026	1738	-	1367
AT5G67430	5	26910314	26912103	1789	+	0
AT5G67440	5	26912706	26916294	3588	-	434
AT5G67450	5	26918792	26919949	1157	-	15
AT5G67455	5	26921671	26921743	72	+	0
AT5G67460	5	26921583	26923274	1691	-	135
AT5G67470	5	26926712	26930470	3758	+	485
AT5G67480	5	26930938	26933093	2155	-	113
AT5G67488	5	26933949	26934867	918	+	0
AT5G67490	5	26934152	26934952	800	-	28
AT5G67500	5	26935142	26937483	2341	+	2103
AT5G67510	5	26937812	26938451	639	-	743
AT5G67520	5	26939158	26941010	1852	+	120
AT5G67530	5	26941181	26944146	2965	+	562
AT5G67540	5	26944027	26946365	2338	-	232
AT5G67550	5	26946753	26949161	2408	-	45
AT5G67560	5	26950308	26952211	1903	+	1025
AT5G67570	5	26952351	26955543	3192	+	406
AT5G67580	5	26955134	26957743	2609	-	547
AT5G67590	5	26958000	26959557	1557	+	2100
AT5G67600	5	26959568	26960323	755	-	676
AT5G67610	5	26960930	26963638	2708	-	386
AT5G67620	5	26964769	26965996	1227	-	5
AT5G67630	5	26967380	26969394	2014	-	263
AT5G67640	5	26969545	26970641	1096	-	57
ATCG00010	Pt	3	76	73	-	9
ATCG00020	Pt	382	1444	1062	-	857
ATCG00030	Pt	1716	4347	2631	-	1
ATCG00040	Pt	2055	3636	1581	-	38
ATCG00050	Pt	5083	6188	1105	-	2
ATCG00060	Pt	6615	6687	72	-	0
ATCG00065	Pt	69610	69724	114	-	2
ATCG00070	Pt	7016	7202	186	+	44
ATCG00080	Pt	7582	7693	111	+	52
ATCG00090	Pt	7784	7872	88	+	16
ATCG00100	Pt	8645	9431	786	+	6
ATCG00110	Pt	9589	9661	72	+	1
ATCG00120	Pt	9937	11461	1524	-	189
ATCG00130	Pt	11528	12798	1270	-	86
ATCG00140	Pt	13261	13507	246	-	56
ATCG00150	Pt	14020	14770	750	-	38
ATCG00160	Pt	15012	15723	711	-	19
ATCG00170	Pt	15937	20068	4131	-	143
ATCG00180	Pt	20250	23084	2834	-	252
ATCG00190	Pt	23110	26329	3219	-	853
ATCG00200	Pt	27372	27443	71	+	1
ATCG00210	Pt	28088	28178	90	+	3
ATCG00220	Pt	28706	28811	105	-	29
ATCG00230	Pt	29800	29874	74	-	0
ATCG00240	Pt	30322	30406	84	-	0
ATCG00250	Pt	30465	30538	73	-	1
ATCG00260	Pt	31368	31440	72	+	0
ATCG00270	Pt	32710	33772	1062	+	116
ATCG00280	Pt	33719	35141	1422	+	326
ATCG00290	Pt	35311	35403	92	+	8
ATCG00300	Pt	35750	35939	189	+	9
ATCG00310	Pt	36489	36560	71	+	0
ATCG00320	Pt	36703	36777	74	-	0
ATCG00330	Pt	36937	37240	303	-	112
ATCG00340	Pt	37374	39579	2205	-	515
ATCG00350	Pt	39604	41857	2253	-	233
ATCG00360	Pt	42583	43751	1168	-	12
ATCG00370	Pt	44826	44913	87	+	2
ATCG00380	Pt	45222	45828	606	-	8
ATCG00390	Pt	46212	46285	73	-	4
ATCG00400	Pt	46893	47490	597	+	0
ATCG00410	Pt	48174	48247	73	+	2
ATCG00420	Pt	48676	49153	477	-	19
ATCG00430	Pt	49256	49934	678	-	32
ATCG00440	Pt	50000	50363	363	-	13
ATCG00450	Pt	51198	51871	673	-	5
ATCG00460	Pt	52055	52128	73	+	1
ATCG00470	Pt	52264	52663	399	-	233
ATCG00480	Pt	52659	54156	1497	-	893
ATCG00490	Pt	54957	56397	1440	+	457
ATCG00500	Pt	57074	58541	1467	+	5
ATCG00510	Pt	59246	59360	114	+	8
ATCG00520	Pt	59771	60326	555	+	7
ATCG00530	Pt	60740	61430	690	+	86
ATCG00540	Pt	61656	62619	963	+	80
ATCG00550	Pt	63537	63660	123	-	31
ATCG00560	Pt	63803	63920	117	-	13
ATCG00570	Pt	63941	64061	120	-	13
ATCG00580	Pt	64070	64322	252	-	24
ATCG00590	Pt	65711	65807	96	+	13
ATCG00600	Pt	65997	66111	114	+	1
ATCG00610	Pt	66228	66302	74	-	1
ATCG00620	Pt	66489	66563	74	-	3
ATCG00630	Pt	66928	67063	135	+	103
ATCG00640	Pt	67487	67688	201	+	10
ATCG00650	Pt	67916	68222	306	+	10
ATCG00660	Pt	68511	68865	354	-	8
ATCG00670	Pt	69909	71882	1973	-	48
ATCG00680	Pt	72370	73897	1527	+	193
ATCG00690	Pt	74081	74183	102	+	25
ATCG00700	Pt	74248	74380	132	-	19
ATCG00710	Pt	74484	74706	222	+	25
ATCG00720	Pt	74840	76292	1452	+	61
ATCG00730	Pt	76480	77672	1192	+	52
ATCG00740	Pt	77900	78890	990	-	55
ATCG00750	Pt	78959	79376	417	-	30
ATCG00760	Pt	79488	79602	114	-	11
ATCG00770	Pt	80067	80472	405	-	30
ATCG00780	Pt	80695	81064	369	-	77
ATCG00790	Pt	81188	82652	1464	-	107
ATCG00800	Pt	82825	83482	657	-	69
ATCG00810	Pt	83466	83949	483	-	30
ATCG00820	Pt	84004	84283	279	-	34
ATCG00830	Pt	84336	85843	1507	-	0
ATCG00840	Pt	85861	86143	282	-	0
ATCG00850	Pt	86311	86385	74	-	0
ATCG00860	Pt	86473	93358	6885	+	0
ATCG00870	Pt	93494	93728	234	+	0
ATCG00880	Pt	94275	94356	81	-	0
ATCG00890	Pt	94940	96795	1855	-	0
ATCG00900	Pt	97477	97945	468	-	0
ATCG00905	Pt	97998	98793	795	-	0
ATCG00910	Pt	100708	100780	72	+	0
ATCG00920	Pt	101011	102502	1491	+	0
ATCG00930	Pt	102800	103601	801	+	0
ATCG00940	Pt	103664	104538	874	+	0
ATCG00950	Pt	104690	107500	2810	+	0
ATCG00960	Pt	107598	107701	103	+	0
ATCG00970	Pt	107948	108069	121	+	0
ATCG00980	Pt	108301	108375	74	+	0
ATCG00990	Pt	109012	109084	72	-	0
ATCG01000	Pt	109404	110436	1032	+	0
ATCG01010	Pt	110397	112638	2241	-	19
ATCG01020	Pt	113448	113607	159	+	139
ATCG01030	Pt	114269	114349	80	+	0
ATCG01040	Pt	114460	115447	987	+	5
ATCG01050	Pt	115664	117185	1521	-	62
ATCG01060	Pt	117317	117563	246	-	15
ATCG01070	Pt	117803	118109	306	-	3
ATCG01080	Pt	118376	118907	531	-	4
ATCG01090	Pt	119243	119762	519	-	4
ATCG01100	Pt	119846	122009	2163	-	17
ATCG01110	Pt	122010	123192	1182	-	5
ATCG01120	Pt	123295	123562	267	-	1
ATCG01130	Pt	123883	129244	5361	-	16
ATCG01140	Pt	129564	129636	72	+	0
ATCG01150	Pt	130273	130347	74	-	0
ATCG01160	Pt	130579	130700	121	-	0
ATCG01170	Pt	130947	131050	103	-	0
ATCG01180	Pt	131148	133958	2810	-	1
ATCG01190	Pt	134110	134984	874	-	0
ATCG01200	Pt	135047	135848	801	-	0
ATCG01210	Pt	136146	137637	1491	-	0
ATCG01220	Pt	137868	137940	72	-	0
ATCG01230	Pt	139855	140650	795	+	0
ATCG01240	Pt	140703	141171	468	+	0
ATCG01250	Pt	141853	143708	1855	+	0
ATCG01260	Pt	144292	144373	81	+	0
ATCG01270	Pt	144920	145154	234	-	0
ATCG01280	Pt	145290	152175	6885	-	0
ATCG01290	Pt	152263	152337	74	+	0
ATCG01300	Pt	152505	152787	282	+	0
ATCG01310	Pt	152805	154312	1507	+	0
ATMG00010	Mt	272	734	462	-	0
ATMG00020	Mt	8847	11415	2568	-	316
ATMG00030	Mt	11917	12241	324	+	36
ATMG00040	Mt	16843	17791	948	-	0
ATMG00050	Mt	16855	17251	396	+	0
ATMG00060	Mt	20570	22086	1516	-	6
ATMG00070	Mt	23662	24235	573	-	7
ATMG00080	Mt	25075	25615	540	-	11
ATMG00090	Mt	25481	28733	3252	-	16
ATMG00100	Mt	28897	28970	73	-	0
ATMG00110	Mt	30462	31083	621	+	5
ATMG00120	Mt	32040	32472	432	-	0
ATMG00130	Mt	34189	34555	366	+	0
ATMG00140	Mt	34598	35102	504	+	0
ATMG00150	Mt	35781	36132	351	+	0
ATMG00160	Mt	40501	42628	2127	-	11
ATMG00170	Mt	48112	48532	420	+	0
ATMG00180	Mt	51292	53611	2319	-	0
ATMG00190	Mt	53735	53809	74	-	0
ATMG00200	Mt	55766	56090	324	-	0
ATMG00210	Mt	57773	58331	558	+	0
ATMG00220	Mt	60234	61416	1182	+	0
ATMG00230	Mt	62348	62433	85	+	0
ATMG00240	Mt	68917	69253	336	-	0
ATMG00250	Mt	71452	71526	74	+	0
ATMG00260	Mt	76131	76437	306	+	0
ATMG00270	Mt	76641	77259	618	-	0
ATMG00280	Mt	77818	78151	333	-	0
ATMG00285	Mt	79739	81297	1558	-	1
ATMG00290	Mt	82027	83116	1089	-	0
ATMG00300	Mt	89616	90054	438	-	0
ATMG00310	Mt	90882	91347	465	-	0
ATMG00320	Mt	91000	91384	384	+	0
ATMG00330	Mt	103826	103914	88	+	0
ATMG00340	Mt	104220	104295	75	+	0
ATMG00350	Mt	104456	104531	75	+	0
ATMG00360	Mt	104884	104995	111	+	0
ATMG00370	Mt	104953	105553	600	-	0
ATMG00380	Mt	105886	105948	62	+	0
ATMG00390	Mt	106796	106879	83	+	0
ATMG00400	Mt	110929	111403	474	-	0
ATMG00410	Mt	111586	112907	1321	+	0
ATMG00420	Mt	112952	113039	87	+	0
ATMG00430	Mt	115430	115751	321	+	0
ATMG00440	Mt	116295	116754	459	+	0
ATMG00450	Mt	119380	119701	321	-	0
ATMG00460	Mt	127020	127094	74	-	0
ATMG00470	Mt	127474	127843	369	-	0
ATMG00480	Mt	129908	130385	477	+	0
ATMG00490	Mt	130816	131140	324	+	0
ATMG00500	Mt	130967	131393	426	+	0
ATMG00510	Mt	132070	138153	6083	+	2
ATMG00513	Mt	140723	142998	2275	-	1
ATMG00516	Mt	143218	147048	3830	-	0
ATMG00520	Mt	144293	146312	2019	-	0
ATMG00530	Mt	147281	147611	330	-	0
ATMG00540	Mt	150782	151151	369	+	0
ATMG00550	Mt	151264	151747	483	-	0
ATMG00560	Mt	154743	157345	2602	+	0
ATMG00570	Mt	157490	158351	861	+	0
ATMG00580	Mt	161692	169674	7982	+	3
ATMG00590	Mt	169795	170737	942	+	0
ATMG00600	Mt	174204	174525	321	+	0
ATMG00610	Mt	176541	177027	486	-	0
ATMG00620	Mt	182277	182697	420	+	0
ATMG00630	Mt	183110	183443	333	+	1
ATMG00640	Mt	188083	188662	579	-	1
ATMG00650	Mt	188928	189231	303	-	7
ATMG00660	Mt	190103	190553	450	-	12
ATMG00665	Mt	190739	190761	22	-	0
ATMG00670	Mt	191054	191882	828	-	8
ATMG00680	Mt	201728	202097	369	+	0
ATMG00690	Mt	203587	204310	723	-	6
ATMG00700	Mt	204339	204412	73	-	0
ATMG00710	Mt	207552	207915	363	-	0
ATMG00720	Mt	209498	209822	324	+	0
ATMG00730	Mt	217630	219077	1447	+	2
ATMG00740	Mt	220470	220773	303	-	0
ATMG00750	Mt	220829	221189	360	+	0
ATMG00760	Mt	221699	222029	330	-	0
ATMG00770	Mt	222686	222989	303	-	0
ATMG00780	Mt	227108	227196	88	+	0
ATMG00790	Mt	227501	227577	76	+	0
ATMG00800	Mt	227614	227686	72	+	0
ATMG00810	Mt	227708	228431	723	-	0
ATMG00820	Mt	228572	229085	513	-	0
ATMG00830	Mt	231893	233042	1149	-	0
ATMG00840	Mt	234537	234903	366	-	0
ATMG00850	Mt	235337	235661	324	+	0
ATMG00860	Mt	235915	236392	477	+	0
ATMG00870	Mt	236926	237481	555	-	0
ATMG00880	Mt	237052	237616	564	+	0
ATMG00890	Mt	239635	239956	321	-	0
ATMG00900	Mt	239987	240758	771	-	0
ATMG00910	Mt	241305	241953	648	-	0
ATMG00920	Mt	249271	249919	648	-	0
ATMG00930	Mt	250079	250153	74	-	0
ATMG00940	Mt	251402	251897	495	-	0
ATMG00950	Mt	254504	254571	67	-	0
ATMG00960	Mt	256864	257476	612	-	0
ATMG00970	Mt	258044	258398	354	-	0
ATMG00980	Mt	260223	260601	378	-	0
ATMG00990	Mt	260646	261006	360	-	0
ATMG01000	Mt	260962	261307	345	-	3
ATMG01010	Mt	261104	261461	357	-	0
ATMG01020	Mt	261616	262078	462	-	0
ATMG01030	Mt	264112	264433	321	-	0
ATMG01040	Mt	270237	270561	324	-	0
ATMG01050	Mt	272943	273423	480	-	0
ATMG01060	Mt	274898	275222	324	+	0
ATMG01070	Mt	275102	275176	74	+	0
ATMG01080	Mt	278648	279152	504	+	9
ATMG01090	Mt	279462	280251	789	+	1
ATMG01100	Mt	281613	281931	318	+	0
ATMG01110	Mt	283033	283789	756	-	0
ATMG01120	Mt	287916	289083	1167	-	1
ATMG01130	Mt	289196	289517	321	-	1
ATMG01140	Mt	292972	293431	459	-	0
ATMG01150	Mt	293975	294296	321	-	0
ATMG01160	Mt	296687	296784	97	-	0
ATMG01170	Mt	296819	298204	1385	-	2
ATMG01180	Mt	300965	301301	336	-	0
ATMG01190	Mt	302165	303689	1524	-	0
ATMG01200	Mt	303835	304720	885	-	0
ATMG01210	Mt	304778	305084	306	-	0
ATMG01220	Mt	305220	305562	342	-	1
ATMG01230	Mt	308931	309369	438	+	0
ATMG01240	Mt	309337	309640	303	-	0
ATMG01250	Mt	310513	310882	369	+	0
ATMG01260	Mt	312544	313162	618	-	0
ATMG01270	Mt	314626	315073	447	+	0
ATMG01275	Mt	318003	318390	387	-	0
ATMG01280	Mt	318587	319463	876	-	0
ATMG01290	Mt	324258	324594	336	+	0
ATMG01300	Mt	325299	325710	411	+	0
ATMG01310	Mt	326098	326509	411	+	0
ATMG01320	Mt	327889	333105	5216	-	1
ATMG01330	Mt	329081	329465	384	-	3
ATMG01340	Mt	337668	337741	73	+	0
ATMG01350	Mt	346756	347194	438	+	0
ATMG01360	Mt	349829	351413	1584	-	15
ATMG01370	Mt	360716	361052	336	-	9
ATMG01380	Mt	361061	361179	118	-	5
ATMG01390	Mt	361349	363284	1935	-	315
ATMG01400	Mt	363724	364042	318	+	0
ATMG01410	Mt	366085	366700	615	-	1
